,reg,vaccin,jour,n_dose1,n_dose2,n_cum_dose1,n_cum_dose2,datetime,timestamp
0,1,1,2020-12-27,0,0,0,0,2020-12-27,1609023600.0
1,1,1,2020-12-28,0,0,0,0,2020-12-28,1609110000.0
2,1,1,2020-12-29,0,0,0,0,2020-12-29,1609196400.0
3,1,1,2020-12-30,0,0,0,0,2020-12-30,1609282800.0
4,1,1,2020-12-31,0,0,0,0,2020-12-31,1609369200.0
5,1,1,2021-01-01,1,0,1,0,2021-01-01,1609455600.0
6,1,1,2021-01-02,0,0,1,0,2021-01-02,1609542000.0
7,1,1,2021-01-03,0,0,1,0,2021-01-03,1609628400.0
8,1,1,2021-01-04,1,0,2,0,2021-01-04,1609714800.0
9,1,1,2021-01-05,0,0,2,0,2021-01-05,1609801200.0
10,1,1,2021-01-06,1,0,3,0,2021-01-06,1609887600.0
11,1,1,2021-01-07,0,0,3,0,2021-01-07,1609974000.0
12,1,1,2021-01-08,49,0,52,0,2021-01-08,1610060400.0
13,1,1,2021-01-09,18,0,70,0,2021-01-09,1610146800.0
14,1,1,2021-01-10,0,0,70,0,2021-01-10,1610233200.0
15,1,1,2021-01-11,55,0,125,0,2021-01-11,1610319600.0
16,1,1,2021-01-12,44,0,169,0,2021-01-12,1610406000.0
17,1,1,2021-01-13,45,0,214,0,2021-01-13,1610492400.0
18,1,1,2021-01-14,61,0,275,0,2021-01-14,1610578800.0
19,1,1,2021-01-15,76,0,351,0,2021-01-15,1610665200.0
20,1,1,2021-01-16,0,0,351,0,2021-01-16,1610751600.0
21,1,1,2021-01-17,0,0,351,0,2021-01-17,1610838000.0
22,1,1,2021-01-18,75,0,426,0,2021-01-18,1610924400.0
23,1,1,2021-01-19,143,0,569,0,2021-01-19,1611010800.0
24,1,1,2021-01-20,134,0,703,0,2021-01-20,1611097200.0
25,1,1,2021-01-21,150,0,853,0,2021-01-21,1611183600.0
26,1,1,2021-01-22,132,0,985,0,2021-01-22,1611270000.0
27,1,1,2021-01-23,1,0,986,0,2021-01-23,1611356400.0
28,1,1,2021-01-24,0,0,986,0,2021-01-24,1611442800.0
29,1,1,2021-01-25,203,0,1189,0,2021-01-25,1611529200.0
30,1,1,2021-01-26,211,0,1400,0,2021-01-26,1611615600.0
31,1,1,2021-01-27,234,0,1634,0,2021-01-27,1611702000.0
32,1,1,2021-01-28,238,2,1872,2,2021-01-28,1611788400.0
33,1,1,2021-01-29,197,0,2069,2,2021-01-29,1611874800.0
34,1,1,2021-01-30,17,0,2086,2,2021-01-30,1611961200.0
35,1,1,2021-01-31,1,0,2087,2,2021-01-31,1612047600.0
36,1,1,2021-02-01,222,3,2309,5,2021-02-01,1612134000.0
37,1,1,2021-02-02,242,24,2551,29,2021-02-02,1612220400.0
38,1,1,2021-02-03,213,1,2764,30,2021-02-03,1612306800.0
39,1,1,2021-02-04,300,19,3064,49,2021-02-04,1612393200.0
40,1,1,2021-02-05,253,32,3317,81,2021-02-05,1612479600.0
41,1,1,2021-02-06,49,1,3366,82,2021-02-06,1612566000.0
42,1,1,2021-02-07,0,0,3366,82,2021-02-07,1612652400.0
43,1,1,2021-02-08,223,20,3589,102,2021-02-08,1612738800.0
44,1,1,2021-02-09,291,27,3880,129,2021-02-09,1612825200.0
45,1,1,2021-02-10,221,28,4101,157,2021-02-10,1612911600.0
46,1,1,2021-02-11,293,108,4394,265,2021-02-11,1612998000.0
47,1,1,2021-02-12,283,23,4677,288,2021-02-12,1613084400.0
48,1,1,2021-02-13,49,7,4726,295,2021-02-13,1613170800.0
49,1,1,2021-02-14,19,36,4745,331,2021-02-14,1613257200.0
50,1,1,2021-02-15,72,43,4817,374,2021-02-15,1613343600.0
51,1,1,2021-02-16,16,0,4833,374,2021-02-16,1613430000.0
52,1,1,2021-02-17,17,0,4850,374,2021-02-17,1613516400.0
53,1,1,2021-02-18,220,16,5070,390,2021-02-18,1613602800.0
54,1,1,2021-02-19,230,19,5300,409,2021-02-19,1613689200.0
55,1,1,2021-02-20,47,0,5347,409,2021-02-20,1613775600.0
56,1,1,2021-02-21,1,0,5348,409,2021-02-21,1613862000.0
57,1,1,2021-02-22,156,54,5504,463,2021-02-22,1613948400.0
58,1,1,2021-02-23,189,70,5693,533,2021-02-23,1614034800.0
59,1,1,2021-02-24,316,119,6009,652,2021-02-24,1614121200.0
60,1,1,2021-02-25,369,75,6378,727,2021-02-25,1614207600.0
61,1,1,2021-02-26,210,81,6588,808,2021-02-26,1614294000.0
62,1,1,2021-02-27,63,0,6651,808,2021-02-27,1614380400.0
63,1,1,2021-02-28,1,0,6652,808,2021-02-28,1614466800.0
64,1,1,2021-03-01,136,80,6788,888,2021-03-01,1614553200.0
65,1,1,2021-03-02,241,127,7029,1015,2021-03-02,1614639600.0
66,1,1,2021-03-03,211,118,7240,1133,2021-03-03,1614726000.0
67,1,1,2021-03-04,305,80,7545,1213,2021-03-04,1614812400.0
68,1,1,2021-03-05,308,141,7853,1354,2021-03-05,1614898800.0
69,1,1,2021-03-06,90,1,7943,1355,2021-03-06,1614985200.0
70,1,1,2021-03-07,1,0,7944,1355,2021-03-07,1615071600.0
71,1,1,2021-03-08,277,130,8221,1485,2021-03-08,1615158000.0
72,1,1,2021-03-09,348,149,8569,1634,2021-03-09,1615244400.0
73,1,1,2021-03-10,322,153,8891,1787,2021-03-10,1615330800.0
74,1,1,2021-03-11,84,43,8975,1830,2021-03-11,1615417200.0
75,1,1,2021-03-12,372,204,9347,2034,2021-03-12,1615503600.0
76,1,1,2021-03-13,119,1,9466,2035,2021-03-13,1615590000.0
77,1,1,2021-03-14,0,23,9466,2058,2021-03-14,1615676400.0
78,1,1,2021-03-15,409,37,9875,2095,2021-03-15,1615762800.0
79,1,1,2021-03-16,450,73,10325,2168,2021-03-16,1615849200.0
80,1,1,2021-03-17,423,78,10748,2246,2021-03-17,1615935600.0
81,1,1,2021-03-18,540,99,11288,2345,2021-03-18,1616022000.0
82,1,1,2021-03-19,529,92,11817,2437,2021-03-19,1616108400.0
83,1,1,2021-03-20,173,43,11990,2480,2021-03-20,1616194800.0
84,1,1,2021-03-21,0,0,11990,2480,2021-03-21,1616281200.0
85,1,1,2021-03-22,325,79,12315,2559,2021-03-22,1616367600.0
86,1,1,2021-03-23,442,150,12757,2709,2021-03-23,1616454000.0
87,1,1,2021-03-24,417,103,13174,2812,2021-03-24,1616540400.0
88,1,1,2021-03-25,534,170,13708,2982,2021-03-25,1616626800.0
89,1,1,2021-03-26,516,116,14224,3098,2021-03-26,1616713200.0
90,1,1,2021-03-27,198,42,14422,3140,2021-03-27,1616799600.0
91,1,1,2021-03-28,0,0,14422,3140,2021-03-28,1616886000.0
92,1,1,2021-03-29,326,78,14748,3218,2021-03-29,1616972400.0
93,1,1,2021-03-30,429,154,15177,3372,2021-03-30,1617058800.0
94,1,1,2021-03-31,453,118,15630,3490,2021-03-31,1617145200.0
95,1,1,2021-04-01,466,191,16096,3681,2021-04-01,1617231600.0
96,1,1,2021-04-02,23,35,16119,3716,2021-04-02,1617318000.0
97,1,1,2021-04-03,43,1,16162,3717,2021-04-03,1617404400.0
98,1,1,2021-04-04,0,18,16162,3735,2021-04-04,1617490800.0
99,1,1,2021-04-05,1,0,16163,3735,2021-04-05,1617577200.0
100,1,1,2021-04-06,369,179,16532,3914,2021-04-06,1617663600.0
101,1,1,2021-04-07,469,111,17001,4025,2021-04-07,1617750000.0
102,1,1,2021-04-08,415,152,17416,4177,2021-04-08,1617836400.0
103,1,1,2021-04-09,437,197,17853,4374,2021-04-09,1617922800.0
104,1,1,2021-04-10,73,4,17926,4378,2021-04-10,1618009200.0
105,1,1,2021-04-11,1,25,17927,4403,2021-04-11,1618095600.0
106,1,1,2021-04-12,254,250,18181,4653,2021-04-12,1618185600.0
107,1,1,2021-04-13,512,309,18693,4962,2021-04-13,1618272000.0
108,1,1,2021-04-14,399,217,19092,5179,2021-04-14,1618358400.0
109,1,1,2021-04-15,427,307,19519,5486,2021-04-15,1618444800.0
110,1,1,2021-04-16,498,260,20017,5746,2021-04-16,1618531200.0
111,1,1,2021-04-17,164,2,20181,5748,2021-04-17,1618617600.0
112,1,1,2021-04-18,3,14,20184,5762,2021-04-18,1618704000.0
113,1,1,2021-04-19,376,234,20560,5996,2021-04-19,1618790400.0
114,1,1,2021-04-20,664,322,21224,6318,2021-04-20,1618876800.0
115,1,1,2021-04-21,578,305,21802,6623,2021-04-21,1618963200.0
116,1,1,2021-04-22,716,320,22518,6943,2021-04-22,1619049600.0
117,1,1,2021-04-23,791,232,23309,7175,2021-04-23,1619136000.0
118,1,1,2021-04-24,356,68,23665,7243,2021-04-24,1619222400.0
119,1,1,2021-04-25,591,60,24256,7303,2021-04-25,1619308800.0
120,1,1,2021-04-26,915,195,25171,7498,2021-04-26,1619395200.0
121,1,1,2021-04-27,626,211,25797,7709,2021-04-27,1619481600.0
122,1,1,2021-04-28,792,248,26589,7957,2021-04-28,1619568000.0
123,1,1,2021-04-29,1148,152,27737,8109,2021-04-29,1619654400.0
124,1,1,2021-04-30,1185,149,28922,8258,2021-04-30,1619740800.0
125,1,1,2021-05-01,593,37,29515,8295,2021-05-01,1619827200.0
126,1,1,2021-05-02,345,13,29860,8308,2021-05-02,1619913600.0
127,1,1,2021-05-03,908,155,30768,8463,2021-05-03,1620000000.0
128,1,1,2021-05-04,877,182,31645,8645,2021-05-04,1620086400.0
129,1,1,2021-05-05,983,223,32628,8868,2021-05-05,1620172800.0
130,1,1,2021-05-06,1092,129,33720,8997,2021-05-06,1620259200.0
131,1,1,2021-05-07,1194,229,34914,9226,2021-05-07,1620345600.0
132,1,1,2021-05-08,315,21,35229,9247,2021-05-08,1620432000.0
133,1,1,2021-05-09,178,3,35407,9250,2021-05-09,1620518400.0
134,1,1,2021-05-10,819,182,36226,9432,2021-05-10,1620604800.0
135,1,1,2021-05-11,900,278,37126,9710,2021-05-11,1620691200.0
136,1,1,2021-05-12,835,283,37961,9993,2021-05-12,1620777600.0
137,1,1,2021-05-13,199,75,38160,10068,2021-05-13,1620864000.0
138,1,1,2021-05-14,829,243,38989,10311,2021-05-14,1620950400.0
139,1,1,2021-05-15,446,7,39435,10318,2021-05-15,1621036800.0
140,1,1,2021-05-16,180,30,39615,10348,2021-05-16,1621123200.0
141,1,1,2021-05-17,698,242,40313,10590,2021-05-17,1621206000.0
142,1,1,2021-05-18,692,354,41005,10944,2021-05-18,1621292400.0
143,1,1,2021-05-19,660,497,41665,11441,2021-05-19,1621378800.0
144,1,1,2021-05-20,750,335,42415,11776,2021-05-20,1621465200.0
145,1,1,2021-05-21,791,384,43206,12160,2021-05-21,1621551600.0
146,1,1,2021-05-22,462,206,43668,12366,2021-05-22,1621638000.0
147,1,1,2021-05-23,201,109,43869,12475,2021-05-23,1621724400.0
148,1,1,2021-05-24,186,165,44055,12640,2021-05-24,1621810800.0
149,1,1,2021-05-25,513,632,44568,13272,2021-05-25,1621897200.0
150,1,1,2021-05-26,563,481,45131,13753,2021-05-26,1621983600.0
151,1,1,2021-05-27,130,181,45261,13934,2021-05-27,1622070000.0
152,1,1,2021-05-28,480,452,45741,14386,2021-05-28,1622156400.0
153,1,1,2021-05-29,184,122,45925,14508,2021-05-29,1622242800.0
154,1,1,2021-05-30,71,111,45996,14619,2021-05-30,1622329200.0
155,1,1,2021-05-31,416,516,46412,15135,2021-05-31,1622415600.0
156,1,1,2021-06-01,534,650,46946,15785,2021-06-01,1622502000.0
157,1,1,2021-06-02,523,649,47469,16434,2021-06-02,1622588400.0
158,1,1,2021-06-03,427,429,47896,16863,2021-06-03,1622674800.0
159,1,1,2021-06-04,642,720,48538,17583,2021-06-04,1622761200.0
160,1,1,2021-06-05,284,550,48822,18133,2021-06-05,1622847600.0
161,1,1,2021-06-06,121,521,48943,18654,2021-06-06,1622934000.0
162,1,1,2021-06-07,392,736,49335,19390,2021-06-07,1623020400.0
163,1,1,2021-06-08,505,798,49840,20188,2021-06-08,1623106800.0
164,1,1,2021-06-09,402,805,50242,20993,2021-06-09,1623193200.0
165,1,1,2021-06-10,372,723,50614,21716,2021-06-10,1623279600.0
166,1,1,2021-06-11,423,1136,51037,22852,2021-06-11,1623366000.0
167,1,1,2021-06-12,239,622,51276,23474,2021-06-12,1623452400.0
168,1,1,2021-06-13,128,306,51404,23780,2021-06-13,1623538800.0
169,1,1,2021-06-14,336,3758,51740,27538,2021-06-14,1623625200.0
170,1,1,2021-06-15,435,1933,52175,29471,2021-06-15,1623711600.0
171,1,1,2021-06-16,451,1437,52626,30908,2021-06-16,1623798000.0
172,1,1,2021-06-17,345,885,52971,31793,2021-06-17,1623884400.0
173,1,1,2021-06-18,385,900,53356,32693,2021-06-18,1623970800.0
174,1,1,2021-06-19,223,451,53579,33144,2021-06-19,1624057200.0
175,1,1,2021-06-20,108,223,53687,33367,2021-06-20,1624143600.0
176,1,1,2021-06-21,308,642,53995,34009,2021-06-21,1624230000.0
177,1,1,2021-06-22,279,768,54274,34777,2021-06-22,1624316400.0
178,1,1,2021-06-23,296,811,54570,35588,2021-06-23,1624402800.0
179,1,1,2021-06-24,326,620,54896,36208,2021-06-24,1624489200.0
180,1,1,2021-06-25,345,705,55241,36913,2021-06-25,1624575600.0
181,1,1,2021-06-26,261,450,55502,37363,2021-06-26,1624662000.0
182,1,1,2021-06-27,105,158,55607,37521,2021-06-27,1624748400.0
183,1,1,2021-06-28,258,649,55865,38170,2021-06-28,1624834800.0
184,1,1,2021-06-29,326,654,56191,38824,2021-06-29,1624921200.0
185,1,1,2021-06-30,376,812,56567,39636,2021-06-30,1625007600.0
186,1,1,2021-07-01,294,540,56861,40176,2021-07-01,1625094000.0
187,1,1,2021-07-02,380,609,57241,40785,2021-07-02,1625180400.0
188,1,1,2021-07-03,236,417,57477,41202,2021-07-03,1625266800.0
189,1,1,2021-07-04,110,228,57587,41430,2021-07-04,1625353200.0
190,1,1,2021-07-05,299,469,57886,41899,2021-07-05,1625439600.0
191,1,1,2021-07-06,333,666,58219,42565,2021-07-06,1625526000.0
192,1,1,2021-07-07,341,766,58560,43331,2021-07-07,1625612400.0
193,1,1,2021-07-08,308,621,58868,43952,2021-07-08,1625698800.0
194,1,2,2020-12-27,0,0,0,0,2020-12-27,1609023600.0
195,1,2,2020-12-28,0,0,0,0,2020-12-28,1609110000.0
196,1,2,2020-12-29,0,0,0,0,2020-12-29,1609196400.0
197,1,2,2020-12-30,0,0,0,0,2020-12-30,1609282800.0
198,1,2,2020-12-31,0,0,0,0,2020-12-31,1609369200.0
199,1,2,2021-01-01,0,0,0,0,2021-01-01,1609455600.0
200,1,2,2021-01-02,0,0,0,0,2021-01-02,1609542000.0
201,1,2,2021-01-03,0,0,0,0,2021-01-03,1609628400.0
202,1,2,2021-01-04,0,0,0,0,2021-01-04,1609714800.0
203,1,2,2021-01-05,0,0,0,0,2021-01-05,1609801200.0
204,1,2,2021-01-06,0,0,0,0,2021-01-06,1609887600.0
205,1,2,2021-01-07,0,0,0,0,2021-01-07,1609974000.0
206,1,2,2021-01-08,0,0,0,0,2021-01-08,1610060400.0
207,1,2,2021-01-09,0,0,0,0,2021-01-09,1610146800.0
208,1,2,2021-01-10,0,0,0,0,2021-01-10,1610233200.0
209,1,2,2021-01-11,0,0,0,0,2021-01-11,1610319600.0
210,1,2,2021-01-12,0,0,0,0,2021-01-12,1610406000.0
211,1,2,2021-01-13,0,0,0,0,2021-01-13,1610492400.0
212,1,2,2021-01-14,0,0,0,0,2021-01-14,1610578800.0
213,1,2,2021-01-15,0,0,0,0,2021-01-15,1610665200.0
214,1,2,2021-01-16,0,0,0,0,2021-01-16,1610751600.0
215,1,2,2021-01-17,0,0,0,0,2021-01-17,1610838000.0
216,1,2,2021-01-18,0,0,0,0,2021-01-18,1610924400.0
217,1,2,2021-01-19,0,0,0,0,2021-01-19,1611010800.0
218,1,2,2021-01-20,0,0,0,0,2021-01-20,1611097200.0
219,1,2,2021-01-21,0,0,0,0,2021-01-21,1611183600.0
220,1,2,2021-01-22,0,0,0,0,2021-01-22,1611270000.0
221,1,2,2021-01-23,0,0,0,0,2021-01-23,1611356400.0
222,1,2,2021-01-24,0,0,0,0,2021-01-24,1611442800.0
223,1,2,2021-01-25,0,0,0,0,2021-01-25,1611529200.0
224,1,2,2021-01-26,0,0,0,0,2021-01-26,1611615600.0
225,1,2,2021-01-27,0,0,0,0,2021-01-27,1611702000.0
226,1,2,2021-01-28,0,0,0,0,2021-01-28,1611788400.0
227,1,2,2021-01-29,0,0,0,0,2021-01-29,1611874800.0
228,1,2,2021-01-30,0,0,0,0,2021-01-30,1611961200.0
229,1,2,2021-01-31,0,0,0,0,2021-01-31,1612047600.0
230,1,2,2021-02-01,0,0,0,0,2021-02-01,1612134000.0
231,1,2,2021-02-02,0,0,0,0,2021-02-02,1612220400.0
232,1,2,2021-02-03,0,0,0,0,2021-02-03,1612306800.0
233,1,2,2021-02-04,0,0,0,0,2021-02-04,1612393200.0
234,1,2,2021-02-05,0,0,0,0,2021-02-05,1612479600.0
235,1,2,2021-02-06,0,0,0,0,2021-02-06,1612566000.0
236,1,2,2021-02-07,0,0,0,0,2021-02-07,1612652400.0
237,1,2,2021-02-08,0,0,0,0,2021-02-08,1612738800.0
238,1,2,2021-02-09,0,0,0,0,2021-02-09,1612825200.0
239,1,2,2021-02-10,1,0,1,0,2021-02-10,1612911600.0
240,1,2,2021-02-11,0,0,1,0,2021-02-11,1612998000.0
241,1,2,2021-02-12,0,0,1,0,2021-02-12,1613084400.0
242,1,2,2021-02-13,0,0,1,0,2021-02-13,1613170800.0
243,1,2,2021-02-14,0,0,1,0,2021-02-14,1613257200.0
244,1,2,2021-02-15,0,0,1,0,2021-02-15,1613343600.0
245,1,2,2021-02-16,0,0,1,0,2021-02-16,1613430000.0
246,1,2,2021-02-17,0,0,1,0,2021-02-17,1613516400.0
247,1,2,2021-02-18,0,0,1,0,2021-02-18,1613602800.0
248,1,2,2021-02-19,0,0,1,0,2021-02-19,1613689200.0
249,1,2,2021-02-20,0,0,1,0,2021-02-20,1613775600.0
250,1,2,2021-02-21,0,0,1,0,2021-02-21,1613862000.0
251,1,2,2021-02-22,0,0,1,0,2021-02-22,1613948400.0
252,1,2,2021-02-23,0,0,1,0,2021-02-23,1614034800.0
253,1,2,2021-02-24,0,0,1,0,2021-02-24,1614121200.0
254,1,2,2021-02-25,0,0,1,0,2021-02-25,1614207600.0
255,1,2,2021-02-26,0,0,1,0,2021-02-26,1614294000.0
256,1,2,2021-02-27,0,0,1,0,2021-02-27,1614380400.0
257,1,2,2021-02-28,0,0,1,0,2021-02-28,1614466800.0
258,1,2,2021-03-01,0,0,1,0,2021-03-01,1614553200.0
259,1,2,2021-03-02,0,0,1,0,2021-03-02,1614639600.0
260,1,2,2021-03-03,0,0,1,0,2021-03-03,1614726000.0
261,1,2,2021-03-04,0,0,1,0,2021-03-04,1614812400.0
262,1,2,2021-03-05,0,0,1,0,2021-03-05,1614898800.0
263,1,2,2021-03-06,0,0,1,0,2021-03-06,1614985200.0
264,1,2,2021-03-07,0,0,1,0,2021-03-07,1615071600.0
265,1,2,2021-03-08,0,0,1,0,2021-03-08,1615158000.0
266,1,2,2021-03-09,0,0,1,0,2021-03-09,1615244400.0
267,1,2,2021-03-10,0,0,1,0,2021-03-10,1615330800.0
268,1,2,2021-03-11,0,0,1,0,2021-03-11,1615417200.0
269,1,2,2021-03-12,0,1,1,1,2021-03-12,1615503600.0
270,1,2,2021-03-13,0,0,1,1,2021-03-13,1615590000.0
271,1,2,2021-03-14,0,0,1,1,2021-03-14,1615676400.0
272,1,2,2021-03-15,0,0,1,1,2021-03-15,1615762800.0
273,1,2,2021-03-16,0,0,1,1,2021-03-16,1615849200.0
274,1,2,2021-03-17,0,0,1,1,2021-03-17,1615935600.0
275,1,2,2021-03-18,0,0,1,1,2021-03-18,1616022000.0
276,1,2,2021-03-19,0,0,1,1,2021-03-19,1616108400.0
277,1,2,2021-03-20,0,0,1,1,2021-03-20,1616194800.0
278,1,2,2021-03-21,0,0,1,1,2021-03-21,1616281200.0
279,1,2,2021-03-22,0,0,1,1,2021-03-22,1616367600.0
280,1,2,2021-03-23,0,0,1,1,2021-03-23,1616454000.0
281,1,2,2021-03-24,0,0,1,1,2021-03-24,1616540400.0
282,1,2,2021-03-25,0,0,1,1,2021-03-25,1616626800.0
283,1,2,2021-03-26,2,0,3,1,2021-03-26,1616713200.0
284,1,2,2021-03-27,0,0,3,1,2021-03-27,1616799600.0
285,1,2,2021-03-28,0,0,3,1,2021-03-28,1616886000.0
286,1,2,2021-03-29,0,0,3,1,2021-03-29,1616972400.0
287,1,2,2021-03-30,0,0,3,1,2021-03-30,1617058800.0
288,1,2,2021-03-31,0,0,3,1,2021-03-31,1617145200.0
289,1,2,2021-04-01,0,0,3,1,2021-04-01,1617231600.0
290,1,2,2021-04-02,0,0,3,1,2021-04-02,1617318000.0
291,1,2,2021-04-03,0,1,3,2,2021-04-03,1617404400.0
292,1,2,2021-04-04,0,0,3,2,2021-04-04,1617490800.0
293,1,2,2021-04-05,0,0,3,2,2021-04-05,1617577200.0
294,1,2,2021-04-06,0,0,3,2,2021-04-06,1617663600.0
295,1,2,2021-04-07,0,0,3,2,2021-04-07,1617750000.0
296,1,2,2021-04-08,0,0,3,2,2021-04-08,1617836400.0
297,1,2,2021-04-09,0,0,3,2,2021-04-09,1617922800.0
298,1,2,2021-04-10,0,0,3,2,2021-04-10,1618009200.0
299,1,2,2021-04-11,0,0,3,2,2021-04-11,1618095600.0
300,1,2,2021-04-12,0,0,3,2,2021-04-12,1618185600.0
301,1,2,2021-04-13,0,0,3,2,2021-04-13,1618272000.0
302,1,2,2021-04-14,1,0,4,2,2021-04-14,1618358400.0
303,1,2,2021-04-15,0,0,4,2,2021-04-15,1618444800.0
304,1,2,2021-04-16,0,0,4,2,2021-04-16,1618531200.0
305,1,2,2021-04-17,0,0,4,2,2021-04-17,1618617600.0
306,1,2,2021-04-18,1,0,5,2,2021-04-18,1618704000.0
307,1,2,2021-04-19,0,0,5,2,2021-04-19,1618790400.0
308,1,2,2021-04-20,0,0,5,2,2021-04-20,1618876800.0
309,1,2,2021-04-21,0,0,5,2,2021-04-21,1618963200.0
310,1,2,2021-04-22,0,0,5,2,2021-04-22,1619049600.0
311,1,2,2021-04-23,2,0,7,2,2021-04-23,1619136000.0
312,1,2,2021-04-24,0,0,7,2,2021-04-24,1619222400.0
313,1,2,2021-04-25,0,0,7,2,2021-04-25,1619308800.0
314,1,2,2021-04-26,0,0,7,2,2021-04-26,1619395200.0
315,1,2,2021-04-27,0,0,7,2,2021-04-27,1619481600.0
316,1,2,2021-04-28,0,0,7,2,2021-04-28,1619568000.0
317,1,2,2021-04-29,0,0,7,2,2021-04-29,1619654400.0
318,1,2,2021-04-30,0,0,7,2,2021-04-30,1619740800.0
319,1,2,2021-05-01,0,0,7,2,2021-05-01,1619827200.0
320,1,2,2021-05-02,0,0,7,2,2021-05-02,1619913600.0
321,1,2,2021-05-03,0,0,7,2,2021-05-03,1620000000.0
322,1,2,2021-05-04,0,0,7,2,2021-05-04,1620086400.0
323,1,2,2021-05-05,0,0,7,2,2021-05-05,1620172800.0
324,1,2,2021-05-06,0,0,7,2,2021-05-06,1620259200.0
325,1,2,2021-05-07,1,0,8,2,2021-05-07,1620345600.0
326,1,2,2021-05-08,0,0,8,2,2021-05-08,1620432000.0
327,1,2,2021-05-09,0,0,8,2,2021-05-09,1620518400.0
328,1,2,2021-05-10,0,0,8,2,2021-05-10,1620604800.0
329,1,2,2021-05-11,0,0,8,2,2021-05-11,1620691200.0
330,1,2,2021-05-12,0,0,8,2,2021-05-12,1620777600.0
331,1,2,2021-05-13,12,0,20,2,2021-05-13,1620864000.0
332,1,2,2021-05-14,0,0,20,2,2021-05-14,1620950400.0
333,1,2,2021-05-15,12,0,32,2,2021-05-15,1621036800.0
334,1,2,2021-05-16,0,0,32,2,2021-05-16,1621123200.0
335,1,2,2021-05-17,0,0,32,2,2021-05-17,1621206000.0
336,1,2,2021-05-18,0,0,32,2,2021-05-18,1621292400.0
337,1,2,2021-05-19,11,0,43,2,2021-05-19,1621378800.0
338,1,2,2021-05-20,0,0,43,2,2021-05-20,1621465200.0
339,1,2,2021-05-21,0,0,43,2,2021-05-21,1621551600.0
340,1,2,2021-05-22,13,0,56,2,2021-05-22,1621638000.0
341,1,2,2021-05-23,0,0,56,2,2021-05-23,1621724400.0
342,1,2,2021-05-24,11,0,67,2,2021-05-24,1621810800.0
343,1,2,2021-05-25,0,0,67,2,2021-05-25,1621897200.0
344,1,2,2021-05-26,12,0,79,2,2021-05-26,1621983600.0
345,1,2,2021-05-27,0,0,79,2,2021-05-27,1622070000.0
346,1,2,2021-05-28,2,0,81,2,2021-05-28,1622156400.0
347,1,2,2021-05-29,30,0,111,2,2021-05-29,1622242800.0
348,1,2,2021-05-30,0,0,111,2,2021-05-30,1622329200.0
349,1,2,2021-05-31,8,0,119,2,2021-05-31,1622415600.0
350,1,2,2021-06-01,22,3,141,5,2021-06-01,1622502000.0
351,1,2,2021-06-02,32,8,173,13,2021-06-02,1622588400.0
352,1,2,2021-06-03,59,6,232,19,2021-06-03,1622674800.0
353,1,2,2021-06-04,93,3,325,22,2021-06-04,1622761200.0
354,1,2,2021-06-05,25,1,350,23,2021-06-05,1622847600.0
355,1,2,2021-06-06,1,0,351,23,2021-06-06,1622934000.0
356,1,2,2021-06-07,21,1,372,24,2021-06-07,1623020400.0
357,1,2,2021-06-08,16,0,388,24,2021-06-08,1623106800.0
358,1,2,2021-06-09,53,1,441,25,2021-06-09,1623193200.0
359,1,2,2021-06-10,113,10,554,35,2021-06-10,1623279600.0
360,1,2,2021-06-11,24,9,578,44,2021-06-11,1623366000.0
361,1,2,2021-06-12,50,15,628,59,2021-06-12,1623452400.0
362,1,2,2021-06-13,0,0,628,59,2021-06-13,1623538800.0
363,1,2,2021-06-14,16,4,644,63,2021-06-14,1623625200.0
364,1,2,2021-06-15,21,1,665,64,2021-06-15,1623711600.0
365,1,2,2021-06-16,2,10,667,74,2021-06-16,1623798000.0
366,1,2,2021-06-17,65,9,732,83,2021-06-17,1623884400.0
367,1,2,2021-06-18,64,4,796,87,2021-06-18,1623970800.0
368,1,2,2021-06-19,57,19,853,106,2021-06-19,1624057200.0
369,1,2,2021-06-20,0,1,853,107,2021-06-20,1624143600.0
370,1,2,2021-06-21,7,10,860,117,2021-06-21,1624230000.0
371,1,2,2021-06-22,30,1,890,118,2021-06-22,1624316400.0
372,1,2,2021-06-23,43,12,933,130,2021-06-23,1624402800.0
373,1,2,2021-06-24,50,20,983,150,2021-06-24,1624489200.0
374,1,2,2021-06-25,90,18,1073,168,2021-06-25,1624575600.0
375,1,2,2021-06-26,28,16,1101,184,2021-06-26,1624662000.0
376,1,2,2021-06-27,1,10,1102,194,2021-06-27,1624748400.0
377,1,2,2021-06-28,26,19,1128,213,2021-06-28,1624834800.0
378,1,2,2021-06-29,28,12,1156,225,2021-06-29,1624921200.0
379,1,2,2021-06-30,22,49,1178,274,2021-06-30,1625007600.0
380,1,2,2021-07-01,42,36,1220,310,2021-07-01,1625094000.0
381,1,2,2021-07-02,33,12,1253,322,2021-07-02,1625180400.0
382,1,2,2021-07-03,30,19,1283,341,2021-07-03,1625266800.0
383,1,2,2021-07-04,0,0,1283,341,2021-07-04,1625353200.0
384,1,2,2021-07-05,9,9,1292,350,2021-07-05,1625439600.0
385,1,2,2021-07-06,7,26,1299,376,2021-07-06,1625526000.0
386,1,2,2021-07-07,22,20,1321,396,2021-07-07,1625612400.0
387,1,2,2021-07-08,35,82,1356,478,2021-07-08,1625698800.0
388,1,3,2020-12-27,0,0,0,0,2020-12-27,1609023600.0
389,1,3,2020-12-28,0,0,0,0,2020-12-28,1609110000.0
390,1,3,2020-12-29,0,0,0,0,2020-12-29,1609196400.0
391,1,3,2020-12-30,0,0,0,0,2020-12-30,1609282800.0
392,1,3,2020-12-31,0,0,0,0,2020-12-31,1609369200.0
393,1,3,2021-01-01,0,0,0,0,2021-01-01,1609455600.0
394,1,3,2021-01-02,0,0,0,0,2021-01-02,1609542000.0
395,1,3,2021-01-03,0,0,0,0,2021-01-03,1609628400.0
396,1,3,2021-01-04,0,0,0,0,2021-01-04,1609714800.0
397,1,3,2021-01-05,0,0,0,0,2021-01-05,1609801200.0
398,1,3,2021-01-06,0,0,0,0,2021-01-06,1609887600.0
399,1,3,2021-01-07,0,0,0,0,2021-01-07,1609974000.0
400,1,3,2021-01-08,0,0,0,0,2021-01-08,1610060400.0
401,1,3,2021-01-09,0,0,0,0,2021-01-09,1610146800.0
402,1,3,2021-01-10,0,0,0,0,2021-01-10,1610233200.0
403,1,3,2021-01-11,0,0,0,0,2021-01-11,1610319600.0
404,1,3,2021-01-12,0,0,0,0,2021-01-12,1610406000.0
405,1,3,2021-01-13,0,0,0,0,2021-01-13,1610492400.0
406,1,3,2021-01-14,0,0,0,0,2021-01-14,1610578800.0
407,1,3,2021-01-15,0,0,0,0,2021-01-15,1610665200.0
408,1,3,2021-01-16,0,0,0,0,2021-01-16,1610751600.0
409,1,3,2021-01-17,0,0,0,0,2021-01-17,1610838000.0
410,1,3,2021-01-18,0,0,0,0,2021-01-18,1610924400.0
411,1,3,2021-01-19,0,0,0,0,2021-01-19,1611010800.0
412,1,3,2021-01-20,0,0,0,0,2021-01-20,1611097200.0
413,1,3,2021-01-21,0,0,0,0,2021-01-21,1611183600.0
414,1,3,2021-01-22,0,0,0,0,2021-01-22,1611270000.0
415,1,3,2021-01-23,0,0,0,0,2021-01-23,1611356400.0
416,1,3,2021-01-24,0,0,0,0,2021-01-24,1611442800.0
417,1,3,2021-01-25,0,0,0,0,2021-01-25,1611529200.0
418,1,3,2021-01-26,0,0,0,0,2021-01-26,1611615600.0
419,1,3,2021-01-27,0,0,0,0,2021-01-27,1611702000.0
420,1,3,2021-01-28,0,0,0,0,2021-01-28,1611788400.0
421,1,3,2021-01-29,0,0,0,0,2021-01-29,1611874800.0
422,1,3,2021-01-30,0,0,0,0,2021-01-30,1611961200.0
423,1,3,2021-01-31,0,0,0,0,2021-01-31,1612047600.0
424,1,3,2021-02-01,0,0,0,0,2021-02-01,1612134000.0
425,1,3,2021-02-02,0,0,0,0,2021-02-02,1612220400.0
426,1,3,2021-02-03,0,0,0,0,2021-02-03,1612306800.0
427,1,3,2021-02-04,0,0,0,0,2021-02-04,1612393200.0
428,1,3,2021-02-05,0,0,0,0,2021-02-05,1612479600.0
429,1,3,2021-02-06,0,0,0,0,2021-02-06,1612566000.0
430,1,3,2021-02-07,0,0,0,0,2021-02-07,1612652400.0
431,1,3,2021-02-08,0,0,0,0,2021-02-08,1612738800.0
432,1,3,2021-02-09,0,0,0,0,2021-02-09,1612825200.0
433,1,3,2021-02-10,0,0,0,0,2021-02-10,1612911600.0
434,1,3,2021-02-11,0,0,0,0,2021-02-11,1612998000.0
435,1,3,2021-02-12,0,0,0,0,2021-02-12,1613084400.0
436,1,3,2021-02-13,1,0,1,0,2021-02-13,1613170800.0
437,1,3,2021-02-14,0,0,1,0,2021-02-14,1613257200.0
438,1,3,2021-02-15,0,0,1,0,2021-02-15,1613343600.0
439,1,3,2021-02-16,0,0,1,0,2021-02-16,1613430000.0
440,1,3,2021-02-17,0,0,1,0,2021-02-17,1613516400.0
441,1,3,2021-02-18,0,0,1,0,2021-02-18,1613602800.0
442,1,3,2021-02-19,0,0,1,0,2021-02-19,1613689200.0
443,1,3,2021-02-20,0,0,1,0,2021-02-20,1613775600.0
444,1,3,2021-02-21,0,0,1,0,2021-02-21,1613862000.0
445,1,3,2021-02-22,1,0,2,0,2021-02-22,1613948400.0
446,1,3,2021-02-23,0,0,2,0,2021-02-23,1614034800.0
447,1,3,2021-02-24,0,0,2,0,2021-02-24,1614121200.0
448,1,3,2021-02-25,0,0,2,0,2021-02-25,1614207600.0
449,1,3,2021-02-26,0,0,2,0,2021-02-26,1614294000.0
450,1,3,2021-02-27,0,0,2,0,2021-02-27,1614380400.0
451,1,3,2021-02-28,0,0,2,0,2021-02-28,1614466800.0
452,1,3,2021-03-01,4,0,6,0,2021-03-01,1614553200.0
453,1,3,2021-03-02,0,0,6,0,2021-03-02,1614639600.0
454,1,3,2021-03-03,0,0,6,0,2021-03-03,1614726000.0
455,1,3,2021-03-04,0,0,6,0,2021-03-04,1614812400.0
456,1,3,2021-03-05,23,0,29,0,2021-03-05,1614898800.0
457,1,3,2021-03-06,496,0,525,0,2021-03-06,1614985200.0
458,1,3,2021-03-07,0,0,525,0,2021-03-07,1615071600.0
459,1,3,2021-03-08,5,0,530,0,2021-03-08,1615158000.0
460,1,3,2021-03-09,10,0,540,0,2021-03-09,1615244400.0
461,1,3,2021-03-10,50,0,590,0,2021-03-10,1615330800.0
462,1,3,2021-03-11,36,0,626,0,2021-03-11,1615417200.0
463,1,3,2021-03-12,44,0,670,0,2021-03-12,1615503600.0
464,1,3,2021-03-13,13,0,683,0,2021-03-13,1615590000.0
465,1,3,2021-03-14,13,0,696,0,2021-03-14,1615676400.0
466,1,3,2021-03-15,1,0,697,0,2021-03-15,1615762800.0
467,1,3,2021-03-16,1,0,698,0,2021-03-16,1615849200.0
468,1,3,2021-03-17,0,0,698,0,2021-03-17,1615935600.0
469,1,3,2021-03-18,1,0,699,0,2021-03-18,1616022000.0
470,1,3,2021-03-19,0,0,699,0,2021-03-19,1616108400.0
471,1,3,2021-03-20,1,0,700,0,2021-03-20,1616194800.0
472,1,3,2021-03-21,8,0,708,0,2021-03-21,1616281200.0
473,1,3,2021-03-22,10,0,718,0,2021-03-22,1616367600.0
474,1,3,2021-03-23,41,0,759,0,2021-03-23,1616454000.0
475,1,3,2021-03-24,40,0,799,0,2021-03-24,1616540400.0
476,1,3,2021-03-25,197,0,996,0,2021-03-25,1616626800.0
477,1,3,2021-03-26,117,0,1113,0,2021-03-26,1616713200.0
478,1,3,2021-03-27,71,0,1184,0,2021-03-27,1616799600.0
479,1,3,2021-03-28,7,0,1191,0,2021-03-28,1616886000.0
480,1,3,2021-03-29,34,0,1225,0,2021-03-29,1616972400.0
481,1,3,2021-03-30,188,0,1413,0,2021-03-30,1617058800.0
482,1,3,2021-03-31,73,0,1486,0,2021-03-31,1617145200.0
483,1,3,2021-04-01,156,0,1642,0,2021-04-01,1617231600.0
484,1,3,2021-04-02,15,0,1657,0,2021-04-02,1617318000.0
485,1,3,2021-04-03,1,0,1658,0,2021-04-03,1617404400.0
486,1,3,2021-04-04,4,0,1662,0,2021-04-04,1617490800.0
487,1,3,2021-04-05,10,0,1672,0,2021-04-05,1617577200.0
488,1,3,2021-04-06,69,0,1741,0,2021-04-06,1617663600.0
489,1,3,2021-04-07,99,0,1840,0,2021-04-07,1617750000.0
490,1,3,2021-04-08,72,0,1912,0,2021-04-08,1617836400.0
491,1,3,2021-04-09,44,0,1956,0,2021-04-09,1617922800.0
492,1,3,2021-04-10,23,0,1979,0,2021-04-10,1618009200.0
493,1,3,2021-04-11,1,0,1980,0,2021-04-11,1618095600.0
494,1,3,2021-04-12,28,0,2008,0,2021-04-12,1618185600.0
495,1,3,2021-04-13,39,0,2047,0,2021-04-13,1618272000.0
496,1,3,2021-04-14,28,0,2075,0,2021-04-14,1618358400.0
497,1,3,2021-04-15,123,0,2198,0,2021-04-15,1618444800.0
498,1,3,2021-04-16,53,0,2251,0,2021-04-16,1618531200.0
499,1,3,2021-04-17,28,0,2279,0,2021-04-17,1618617600.0
500,1,3,2021-04-18,0,0,2279,0,2021-04-18,1618704000.0
501,1,3,2021-04-19,12,0,2291,0,2021-04-19,1618790400.0
502,1,3,2021-04-20,58,3,2349,3,2021-04-20,1618876800.0
503,1,3,2021-04-21,40,0,2389,3,2021-04-21,1618963200.0
504,1,3,2021-04-22,88,0,2477,3,2021-04-22,1619049600.0
505,1,3,2021-04-23,49,0,2526,3,2021-04-23,1619136000.0
506,1,3,2021-04-24,20,0,2546,3,2021-04-24,1619222400.0
507,1,3,2021-04-25,0,0,2546,3,2021-04-25,1619308800.0
508,1,3,2021-04-26,27,0,2573,3,2021-04-26,1619395200.0
509,1,3,2021-04-27,26,0,2599,3,2021-04-27,1619481600.0
510,1,3,2021-04-28,45,0,2644,3,2021-04-28,1619568000.0
511,1,3,2021-04-29,45,17,2689,20,2021-04-29,1619654400.0
512,1,3,2021-04-30,73,3,2762,23,2021-04-30,1619740800.0
513,1,3,2021-05-01,1,0,2763,23,2021-05-01,1619827200.0
514,1,3,2021-05-02,0,0,2763,23,2021-05-02,1619913600.0
515,1,3,2021-05-03,9,3,2772,26,2021-05-03,1620000000.0
516,1,3,2021-05-04,77,1,2849,27,2021-05-04,1620086400.0
517,1,3,2021-05-05,19,1,2868,28,2021-05-05,1620172800.0
518,1,3,2021-05-06,51,14,2919,42,2021-05-06,1620259200.0
519,1,3,2021-05-07,40,5,2959,47,2021-05-07,1620345600.0
520,1,3,2021-05-08,1,0,2960,47,2021-05-08,1620432000.0
521,1,3,2021-05-09,0,0,2960,47,2021-05-09,1620518400.0
522,1,3,2021-05-10,13,6,2973,53,2021-05-10,1620604800.0
523,1,3,2021-05-11,56,3,3029,56,2021-05-11,1620691200.0
524,1,3,2021-05-12,59,12,3088,68,2021-05-12,1620777600.0
525,1,3,2021-05-13,0,0,3088,68,2021-05-13,1620864000.0
526,1,3,2021-05-14,30,14,3118,82,2021-05-14,1620950400.0
527,1,3,2021-05-15,17,2,3135,84,2021-05-15,1621036800.0
528,1,3,2021-05-16,2,0,3137,84,2021-05-16,1621123200.0
529,1,3,2021-05-17,9,1,3146,85,2021-05-17,1621206000.0
530,1,3,2021-05-18,31,5,3177,90,2021-05-18,1621292400.0
531,1,3,2021-05-19,23,7,3200,97,2021-05-19,1621378800.0
532,1,3,2021-05-20,25,11,3225,108,2021-05-20,1621465200.0
533,1,3,2021-05-21,22,6,3247,114,2021-05-21,1621551600.0
534,1,3,2021-05-22,18,5,3265,119,2021-05-22,1621638000.0
535,1,3,2021-05-23,0,0,3265,119,2021-05-23,1621724400.0
536,1,3,2021-05-24,2,9,3267,128,2021-05-24,1621810800.0
537,1,3,2021-05-25,21,22,3288,150,2021-05-25,1621897200.0
538,1,3,2021-05-26,9,2,3297,152,2021-05-26,1621983600.0
539,1,3,2021-05-27,0,0,3297,152,2021-05-27,1622070000.0
540,1,3,2021-05-28,34,53,3331,205,2021-05-28,1622156400.0
541,1,3,2021-05-29,13,12,3344,217,2021-05-29,1622242800.0
542,1,3,2021-05-30,0,0,3344,217,2021-05-30,1622329200.0
543,1,3,2021-05-31,10,12,3354,229,2021-05-31,1622415600.0
544,1,3,2021-06-01,6,46,3360,275,2021-06-01,1622502000.0
545,1,3,2021-06-02,10,25,3370,300,2021-06-02,1622588400.0
546,1,3,2021-06-03,9,112,3379,412,2021-06-03,1622674800.0
547,1,3,2021-06-04,7,55,3386,467,2021-06-04,1622761200.0
548,1,3,2021-06-05,4,81,3390,548,2021-06-05,1622847600.0
549,1,3,2021-06-06,0,1,3390,549,2021-06-06,1622934000.0
550,1,3,2021-06-07,7,25,3397,574,2021-06-07,1623020400.0
551,1,3,2021-06-08,3,70,3400,644,2021-06-08,1623106800.0
552,1,3,2021-06-09,9,41,3409,685,2021-06-09,1623193200.0
553,1,3,2021-06-10,12,92,3421,777,2021-06-10,1623279600.0
554,1,3,2021-06-11,3,65,3424,842,2021-06-11,1623366000.0
555,1,3,2021-06-12,0,15,3424,857,2021-06-12,1623452400.0
556,1,3,2021-06-13,0,5,3424,862,2021-06-13,1623538800.0
557,1,3,2021-06-14,0,27,3424,889,2021-06-14,1623625200.0
558,1,3,2021-06-15,5,53,3429,942,2021-06-15,1623711600.0
559,1,3,2021-06-16,9,14,3438,956,2021-06-16,1623798000.0
560,1,3,2021-06-17,7,97,3445,1053,2021-06-17,1623884400.0
561,1,3,2021-06-18,4,97,3449,1150,2021-06-18,1623970800.0
562,1,3,2021-06-19,14,25,3463,1175,2021-06-19,1624057200.0
563,1,3,2021-06-20,0,0,3463,1175,2021-06-20,1624143600.0
564,1,3,2021-06-21,2,10,3465,1185,2021-06-21,1624230000.0
565,1,3,2021-06-22,2,84,3467,1269,2021-06-22,1624316400.0
566,1,3,2021-06-23,9,44,3476,1313,2021-06-23,1624402800.0
567,1,3,2021-06-24,1,64,3477,1377,2021-06-24,1624489200.0
568,1,3,2021-06-25,3,19,3480,1396,2021-06-25,1624575600.0
569,1,3,2021-06-26,3,38,3483,1434,2021-06-26,1624662000.0
570,1,3,2021-06-27,0,0,3483,1434,2021-06-27,1624748400.0
571,1,3,2021-06-28,1,4,3484,1438,2021-06-28,1624834800.0
572,1,3,2021-06-29,1,78,3485,1516,2021-06-29,1624921200.0
573,1,3,2021-06-30,4,30,3489,1546,2021-06-30,1625007600.0
574,1,3,2021-07-01,0,49,3489,1595,2021-07-01,1625094000.0
575,1,3,2021-07-02,0,32,3489,1627,2021-07-02,1625180400.0
576,1,3,2021-07-03,0,7,3489,1634,2021-07-03,1625266800.0
577,1,3,2021-07-04,0,0,3489,1634,2021-07-04,1625353200.0
578,1,3,2021-07-05,6,9,3495,1643,2021-07-05,1625439600.0
579,1,3,2021-07-06,20,50,3515,1693,2021-07-06,1625526000.0
580,1,3,2021-07-07,6,37,3521,1730,2021-07-07,1625612400.0
581,1,3,2021-07-08,2,57,3523,1787,2021-07-08,1625698800.0
582,1,4,2020-12-27,0,0,0,0,2020-12-27,1609023600.0
583,1,4,2020-12-28,0,0,0,0,2020-12-28,1609110000.0
584,1,4,2020-12-29,0,0,0,0,2020-12-29,1609196400.0
585,1,4,2020-12-30,0,0,0,0,2020-12-30,1609282800.0
586,1,4,2020-12-31,0,0,0,0,2020-12-31,1609369200.0
587,1,4,2021-01-01,0,0,0,0,2021-01-01,1609455600.0
588,1,4,2021-01-02,0,0,0,0,2021-01-02,1609542000.0
589,1,4,2021-01-03,0,0,0,0,2021-01-03,1609628400.0
590,1,4,2021-01-04,0,0,0,0,2021-01-04,1609714800.0
591,1,4,2021-01-05,0,0,0,0,2021-01-05,1609801200.0
592,1,4,2021-01-06,0,0,0,0,2021-01-06,1609887600.0
593,1,4,2021-01-07,0,0,0,0,2021-01-07,1609974000.0
594,1,4,2021-01-08,0,0,0,0,2021-01-08,1610060400.0
595,1,4,2021-01-09,0,0,0,0,2021-01-09,1610146800.0
596,1,4,2021-01-10,0,0,0,0,2021-01-10,1610233200.0
597,1,4,2021-01-11,0,0,0,0,2021-01-11,1610319600.0
598,1,4,2021-01-12,0,0,0,0,2021-01-12,1610406000.0
599,1,4,2021-01-13,0,0,0,0,2021-01-13,1610492400.0
600,1,4,2021-01-14,0,0,0,0,2021-01-14,1610578800.0
601,1,4,2021-01-15,0,0,0,0,2021-01-15,1610665200.0
602,1,4,2021-01-16,0,0,0,0,2021-01-16,1610751600.0
603,1,4,2021-01-17,0,0,0,0,2021-01-17,1610838000.0
604,1,4,2021-01-18,0,0,0,0,2021-01-18,1610924400.0
605,1,4,2021-01-19,0,0,0,0,2021-01-19,1611010800.0
606,1,4,2021-01-20,0,0,0,0,2021-01-20,1611097200.0
607,1,4,2021-01-21,0,0,0,0,2021-01-21,1611183600.0
608,1,4,2021-01-22,0,0,0,0,2021-01-22,1611270000.0
609,1,4,2021-01-23,0,0,0,0,2021-01-23,1611356400.0
610,1,4,2021-01-24,0,0,0,0,2021-01-24,1611442800.0
611,1,4,2021-01-25,0,0,0,0,2021-01-25,1611529200.0
612,1,4,2021-01-26,0,0,0,0,2021-01-26,1611615600.0
613,1,4,2021-01-27,0,0,0,0,2021-01-27,1611702000.0
614,1,4,2021-01-28,0,0,0,0,2021-01-28,1611788400.0
615,1,4,2021-01-29,0,0,0,0,2021-01-29,1611874800.0
616,1,4,2021-01-30,0,0,0,0,2021-01-30,1611961200.0
617,1,4,2021-01-31,0,0,0,0,2021-01-31,1612047600.0
618,1,4,2021-02-01,0,0,0,0,2021-02-01,1612134000.0
619,1,4,2021-02-02,0,0,0,0,2021-02-02,1612220400.0
620,1,4,2021-02-03,0,0,0,0,2021-02-03,1612306800.0
621,1,4,2021-02-04,0,0,0,0,2021-02-04,1612393200.0
622,1,4,2021-02-05,0,0,0,0,2021-02-05,1612479600.0
623,1,4,2021-02-06,0,0,0,0,2021-02-06,1612566000.0
624,1,4,2021-02-07,0,0,0,0,2021-02-07,1612652400.0
625,1,4,2021-02-08,0,0,0,0,2021-02-08,1612738800.0
626,1,4,2021-02-09,0,0,0,0,2021-02-09,1612825200.0
627,1,4,2021-02-10,0,0,0,0,2021-02-10,1612911600.0
628,1,4,2021-02-11,0,0,0,0,2021-02-11,1612998000.0
629,1,4,2021-02-12,0,0,0,0,2021-02-12,1613084400.0
630,1,4,2021-02-13,0,0,0,0,2021-02-13,1613170800.0
631,1,4,2021-02-14,0,0,0,0,2021-02-14,1613257200.0
632,1,4,2021-02-15,0,0,0,0,2021-02-15,1613343600.0
633,1,4,2021-02-16,0,0,0,0,2021-02-16,1613430000.0
634,1,4,2021-02-17,0,0,0,0,2021-02-17,1613516400.0
635,1,4,2021-02-18,0,0,0,0,2021-02-18,1613602800.0
636,1,4,2021-02-19,0,0,0,0,2021-02-19,1613689200.0
637,1,4,2021-02-20,0,0,0,0,2021-02-20,1613775600.0
638,1,4,2021-02-21,0,0,0,0,2021-02-21,1613862000.0
639,1,4,2021-02-22,0,0,0,0,2021-02-22,1613948400.0
640,1,4,2021-02-23,0,0,0,0,2021-02-23,1614034800.0
641,1,4,2021-02-24,0,0,0,0,2021-02-24,1614121200.0
642,1,4,2021-02-25,0,0,0,0,2021-02-25,1614207600.0
643,1,4,2021-02-26,0,0,0,0,2021-02-26,1614294000.0
644,1,4,2021-02-27,0,0,0,0,2021-02-27,1614380400.0
645,1,4,2021-02-28,0,0,0,0,2021-02-28,1614466800.0
646,1,4,2021-03-01,0,0,0,0,2021-03-01,1614553200.0
647,1,4,2021-03-02,0,0,0,0,2021-03-02,1614639600.0
648,1,4,2021-03-03,0,0,0,0,2021-03-03,1614726000.0
649,1,4,2021-03-04,0,0,0,0,2021-03-04,1614812400.0
650,1,4,2021-03-05,0,0,0,0,2021-03-05,1614898800.0
651,1,4,2021-03-06,0,0,0,0,2021-03-06,1614985200.0
652,1,4,2021-03-07,0,0,0,0,2021-03-07,1615071600.0
653,1,4,2021-03-08,0,0,0,0,2021-03-08,1615158000.0
654,1,4,2021-03-09,0,0,0,0,2021-03-09,1615244400.0
655,1,4,2021-03-10,0,0,0,0,2021-03-10,1615330800.0
656,1,4,2021-03-11,0,0,0,0,2021-03-11,1615417200.0
657,1,4,2021-03-12,0,0,0,0,2021-03-12,1615503600.0
658,1,4,2021-03-13,0,0,0,0,2021-03-13,1615590000.0
659,1,4,2021-03-14,0,0,0,0,2021-03-14,1615676400.0
660,1,4,2021-03-15,0,0,0,0,2021-03-15,1615762800.0
661,1,4,2021-03-16,0,0,0,0,2021-03-16,1615849200.0
662,1,4,2021-03-17,0,0,0,0,2021-03-17,1615935600.0
663,1,4,2021-03-18,0,0,0,0,2021-03-18,1616022000.0
664,1,4,2021-03-19,0,0,0,0,2021-03-19,1616108400.0
665,1,4,2021-03-20,0,0,0,0,2021-03-20,1616194800.0
666,1,4,2021-03-21,0,0,0,0,2021-03-21,1616281200.0
667,1,4,2021-03-22,0,0,0,0,2021-03-22,1616367600.0
668,1,4,2021-03-23,0,0,0,0,2021-03-23,1616454000.0
669,1,4,2021-03-24,0,0,0,0,2021-03-24,1616540400.0
670,1,4,2021-03-25,0,0,0,0,2021-03-25,1616626800.0
671,1,4,2021-03-26,0,0,0,0,2021-03-26,1616713200.0
672,1,4,2021-03-27,0,0,0,0,2021-03-27,1616799600.0
673,1,4,2021-03-28,0,0,0,0,2021-03-28,1616886000.0
674,1,4,2021-03-29,0,0,0,0,2021-03-29,1616972400.0
675,1,4,2021-03-30,0,0,0,0,2021-03-30,1617058800.0
676,1,4,2021-03-31,0,0,0,0,2021-03-31,1617145200.0
677,1,4,2021-04-01,0,0,0,0,2021-04-01,1617231600.0
678,1,4,2021-04-02,0,0,0,0,2021-04-02,1617318000.0
679,1,4,2021-04-03,0,0,0,0,2021-04-03,1617404400.0
680,1,4,2021-04-04,0,0,0,0,2021-04-04,1617490800.0
681,1,4,2021-04-05,0,0,0,0,2021-04-05,1617577200.0
682,1,4,2021-04-06,0,0,0,0,2021-04-06,1617663600.0
683,1,4,2021-04-07,0,0,0,0,2021-04-07,1617750000.0
684,1,4,2021-04-08,0,0,0,0,2021-04-08,1617836400.0
685,1,4,2021-04-09,0,0,0,0,2021-04-09,1617922800.0
686,1,4,2021-04-10,0,0,0,0,2021-04-10,1618009200.0
687,1,4,2021-04-11,0,0,0,0,2021-04-11,1618095600.0
688,1,4,2021-04-12,0,0,0,0,2021-04-12,1618185600.0
689,1,4,2021-04-13,0,0,0,0,2021-04-13,1618272000.0
690,1,4,2021-04-14,0,0,0,0,2021-04-14,1618358400.0
691,1,4,2021-04-15,0,0,0,0,2021-04-15,1618444800.0
692,1,4,2021-04-16,0,0,0,0,2021-04-16,1618531200.0
693,1,4,2021-04-17,0,0,0,0,2021-04-17,1618617600.0
694,1,4,2021-04-18,0,0,0,0,2021-04-18,1618704000.0
695,1,4,2021-04-19,0,0,0,0,2021-04-19,1618790400.0
696,1,4,2021-04-20,0,0,0,0,2021-04-20,1618876800.0
697,1,4,2021-04-21,0,0,0,0,2021-04-21,1618963200.0
698,1,4,2021-04-22,0,0,0,0,2021-04-22,1619049600.0
699,1,4,2021-04-23,0,0,0,0,2021-04-23,1619136000.0
700,1,4,2021-04-24,0,0,0,0,2021-04-24,1619222400.0
701,1,4,2021-04-25,0,0,0,0,2021-04-25,1619308800.0
702,1,4,2021-04-26,0,0,0,0,2021-04-26,1619395200.0
703,1,4,2021-04-27,0,0,0,0,2021-04-27,1619481600.0
704,1,4,2021-04-28,0,0,0,0,2021-04-28,1619568000.0
705,1,4,2021-04-29,0,0,0,0,2021-04-29,1619654400.0
706,1,4,2021-04-30,0,0,0,0,2021-04-30,1619740800.0
707,1,4,2021-05-01,0,0,0,0,2021-05-01,1619827200.0
708,1,4,2021-05-02,0,0,0,0,2021-05-02,1619913600.0
709,1,4,2021-05-03,0,0,0,0,2021-05-03,1620000000.0
710,1,4,2021-05-04,0,0,0,0,2021-05-04,1620086400.0
711,1,4,2021-05-05,0,0,0,0,2021-05-05,1620172800.0
712,1,4,2021-05-06,0,0,0,0,2021-05-06,1620259200.0
713,1,4,2021-05-07,0,0,0,0,2021-05-07,1620345600.0
714,1,4,2021-05-08,0,0,0,0,2021-05-08,1620432000.0
715,1,4,2021-05-09,0,0,0,0,2021-05-09,1620518400.0
716,1,4,2021-05-10,0,0,0,0,2021-05-10,1620604800.0
717,1,4,2021-05-11,0,0,0,0,2021-05-11,1620691200.0
718,1,4,2021-05-12,0,0,0,0,2021-05-12,1620777600.0
719,1,4,2021-05-13,0,0,0,0,2021-05-13,1620864000.0
720,1,4,2021-05-14,0,0,0,0,2021-05-14,1620950400.0
721,1,4,2021-05-15,0,0,0,0,2021-05-15,1621036800.0
722,1,4,2021-05-16,0,0,0,0,2021-05-16,1621123200.0
723,1,4,2021-05-17,0,0,0,0,2021-05-17,1621206000.0
724,1,4,2021-05-18,0,0,0,0,2021-05-18,1621292400.0
725,1,4,2021-05-19,0,0,0,0,2021-05-19,1621378800.0
726,1,4,2021-05-20,0,0,0,0,2021-05-20,1621465200.0
727,1,4,2021-05-21,0,0,0,0,2021-05-21,1621551600.0
728,1,4,2021-05-22,0,0,0,0,2021-05-22,1621638000.0
729,1,4,2021-05-23,0,0,0,0,2021-05-23,1621724400.0
730,1,4,2021-05-24,0,0,0,0,2021-05-24,1621810800.0
731,1,4,2021-05-25,0,0,0,0,2021-05-25,1621897200.0
732,1,4,2021-05-26,0,0,0,0,2021-05-26,1621983600.0
733,1,4,2021-05-27,0,0,0,0,2021-05-27,1622070000.0
734,1,4,2021-05-28,0,0,0,0,2021-05-28,1622156400.0
735,1,4,2021-05-29,0,0,0,0,2021-05-29,1622242800.0
736,1,4,2021-05-30,0,0,0,0,2021-05-30,1622329200.0
737,1,4,2021-05-31,0,0,0,0,2021-05-31,1622415600.0
738,1,4,2021-06-01,0,0,0,0,2021-06-01,1622502000.0
739,1,4,2021-06-02,0,0,0,0,2021-06-02,1622588400.0
740,1,4,2021-06-03,0,0,0,0,2021-06-03,1622674800.0
741,1,4,2021-06-04,0,0,0,0,2021-06-04,1622761200.0
742,1,4,2021-06-05,0,0,0,0,2021-06-05,1622847600.0
743,1,4,2021-06-06,0,0,0,0,2021-06-06,1622934000.0
744,1,4,2021-06-07,0,0,0,0,2021-06-07,1623020400.0
745,1,4,2021-06-08,0,0,0,0,2021-06-08,1623106800.0
746,1,4,2021-06-09,0,0,0,0,2021-06-09,1623193200.0
747,1,4,2021-06-10,0,0,0,0,2021-06-10,1623279600.0
748,1,4,2021-06-11,0,0,0,0,2021-06-11,1623366000.0
749,1,4,2021-06-12,0,0,0,0,2021-06-12,1623452400.0
750,1,4,2021-06-13,0,0,0,0,2021-06-13,1623538800.0
751,1,4,2021-06-14,0,0,0,0,2021-06-14,1623625200.0
752,1,4,2021-06-15,0,0,0,0,2021-06-15,1623711600.0
753,1,4,2021-06-16,0,0,0,0,2021-06-16,1623798000.0
754,1,4,2021-06-17,0,0,0,0,2021-06-17,1623884400.0
755,1,4,2021-06-18,0,0,0,0,2021-06-18,1623970800.0
756,1,4,2021-06-19,0,0,0,0,2021-06-19,1624057200.0
757,1,4,2021-06-20,0,0,0,0,2021-06-20,1624143600.0
758,1,4,2021-06-21,0,0,0,0,2021-06-21,1624230000.0
759,1,4,2021-06-22,0,0,0,0,2021-06-22,1624316400.0
760,1,4,2021-06-23,0,0,0,0,2021-06-23,1624402800.0
761,1,4,2021-06-24,0,0,0,0,2021-06-24,1624489200.0
762,1,4,2021-06-25,0,0,0,0,2021-06-25,1624575600.0
763,1,4,2021-06-26,0,0,0,0,2021-06-26,1624662000.0
764,1,4,2021-06-27,0,0,0,0,2021-06-27,1624748400.0
765,1,4,2021-06-28,0,0,0,0,2021-06-28,1624834800.0
766,1,4,2021-06-29,0,0,0,0,2021-06-29,1624921200.0
767,1,4,2021-06-30,0,0,0,0,2021-06-30,1625007600.0
768,1,4,2021-07-01,0,0,0,0,2021-07-01,1625094000.0
769,1,4,2021-07-02,0,0,0,0,2021-07-02,1625180400.0
770,1,4,2021-07-03,0,0,0,0,2021-07-03,1625266800.0
771,1,4,2021-07-04,0,0,0,0,2021-07-04,1625353200.0
772,1,4,2021-07-05,0,0,0,0,2021-07-05,1625439600.0
773,1,4,2021-07-06,0,0,0,0,2021-07-06,1625526000.0
774,1,4,2021-07-07,0,0,0,0,2021-07-07,1625612400.0
775,1,4,2021-07-08,0,0,0,0,2021-07-08,1625698800.0
776,2,1,2020-12-27,0,0,0,0,2020-12-27,1609023600.0
777,2,1,2020-12-28,0,0,0,0,2020-12-28,1609110000.0
778,2,1,2020-12-29,0,0,0,0,2020-12-29,1609196400.0
779,2,1,2020-12-30,0,0,0,0,2020-12-30,1609282800.0
780,2,1,2020-12-31,0,0,0,0,2020-12-31,1609369200.0
781,2,1,2021-01-01,0,0,0,0,2021-01-01,1609455600.0
782,2,1,2021-01-02,0,0,0,0,2021-01-02,1609542000.0
783,2,1,2021-01-03,0,0,0,0,2021-01-03,1609628400.0
784,2,1,2021-01-04,0,0,0,0,2021-01-04,1609714800.0
785,2,1,2021-01-05,0,0,0,0,2021-01-05,1609801200.0
786,2,1,2021-01-06,5,0,5,0,2021-01-06,1609887600.0
787,2,1,2021-01-07,31,0,36,0,2021-01-07,1609974000.0
788,2,1,2021-01-08,81,0,117,0,2021-01-08,1610060400.0
789,2,1,2021-01-09,20,0,137,0,2021-01-09,1610146800.0
790,2,1,2021-01-10,0,0,137,0,2021-01-10,1610233200.0
791,2,1,2021-01-11,122,0,259,0,2021-01-11,1610319600.0
792,2,1,2021-01-12,78,0,337,0,2021-01-12,1610406000.0
793,2,1,2021-01-13,64,0,401,0,2021-01-13,1610492400.0
794,2,1,2021-01-14,88,0,489,0,2021-01-14,1610578800.0
795,2,1,2021-01-15,136,0,625,0,2021-01-15,1610665200.0
796,2,1,2021-01-16,51,0,676,0,2021-01-16,1610751600.0
797,2,1,2021-01-17,0,0,676,0,2021-01-17,1610838000.0
798,2,1,2021-01-18,157,0,833,0,2021-01-18,1610924400.0
799,2,1,2021-01-19,168,0,1001,0,2021-01-19,1611010800.0
800,2,1,2021-01-20,164,0,1165,0,2021-01-20,1611097200.0
801,2,1,2021-01-21,181,0,1346,0,2021-01-21,1611183600.0
802,2,1,2021-01-22,156,0,1502,0,2021-01-22,1611270000.0
803,2,1,2021-01-23,58,0,1560,0,2021-01-23,1611356400.0
804,2,1,2021-01-24,0,0,1560,0,2021-01-24,1611442800.0
805,2,1,2021-01-25,160,0,1720,0,2021-01-25,1611529200.0
806,2,1,2021-01-26,137,0,1857,0,2021-01-26,1611615600.0
807,2,1,2021-01-27,162,5,2019,5,2021-01-27,1611702000.0
808,2,1,2021-01-28,143,12,2162,17,2021-01-28,1611788400.0
809,2,1,2021-01-29,143,41,2305,58,2021-01-29,1611874800.0
810,2,1,2021-01-30,96,16,2401,74,2021-01-30,1611961200.0
811,2,1,2021-01-31,0,0,2401,74,2021-01-31,1612047600.0
812,2,1,2021-02-01,119,73,2520,147,2021-02-01,1612134000.0
813,2,1,2021-02-02,184,95,2704,242,2021-02-02,1612220400.0
814,2,1,2021-02-03,131,80,2835,322,2021-02-03,1612306800.0
815,2,1,2021-02-04,158,73,2993,395,2021-02-04,1612393200.0
816,2,1,2021-02-05,120,97,3113,492,2021-02-05,1612479600.0
817,2,1,2021-02-06,62,26,3175,518,2021-02-06,1612566000.0
818,2,1,2021-02-07,1,0,3176,518,2021-02-07,1612652400.0
819,2,1,2021-02-08,137,78,3313,596,2021-02-08,1612738800.0
820,2,1,2021-02-09,176,78,3489,674,2021-02-09,1612825200.0
821,2,1,2021-02-10,138,90,3627,764,2021-02-10,1612911600.0
822,2,1,2021-02-11,150,103,3777,867,2021-02-11,1612998000.0
823,2,1,2021-02-12,124,128,3901,995,2021-02-12,1613084400.0
824,2,1,2021-02-13,38,37,3939,1032,2021-02-13,1613170800.0
825,2,1,2021-02-14,0,0,3939,1032,2021-02-14,1613257200.0
826,2,1,2021-02-15,51,67,3990,1099,2021-02-15,1613343600.0
827,2,1,2021-02-16,0,1,3990,1100,2021-02-16,1613430000.0
828,2,1,2021-02-17,0,3,3990,1103,2021-02-17,1613516400.0
829,2,1,2021-02-18,68,127,4058,1230,2021-02-18,1613602800.0
830,2,1,2021-02-19,69,131,4127,1361,2021-02-19,1613689200.0
831,2,1,2021-02-20,48,69,4175,1430,2021-02-20,1613775600.0
832,2,1,2021-02-21,0,0,4175,1430,2021-02-21,1613862000.0
833,2,1,2021-02-22,102,60,4277,1490,2021-02-22,1613948400.0
834,2,1,2021-02-23,113,238,4390,1728,2021-02-23,1614034800.0
835,2,1,2021-02-24,106,223,4496,1951,2021-02-24,1614121200.0
836,2,1,2021-02-25,89,148,4585,2099,2021-02-25,1614207600.0
837,2,1,2021-02-26,127,168,4712,2267,2021-02-26,1614294000.0
838,2,1,2021-02-27,69,52,4781,2319,2021-02-27,1614380400.0
839,2,1,2021-02-28,0,0,4781,2319,2021-02-28,1614466800.0
840,2,1,2021-03-01,138,143,4919,2462,2021-03-01,1614553200.0
841,2,1,2021-03-02,142,78,5061,2540,2021-03-02,1614639600.0
842,2,1,2021-03-03,168,142,5229,2682,2021-03-03,1614726000.0
843,2,1,2021-03-04,112,133,5341,2815,2021-03-04,1614812400.0
844,2,1,2021-03-05,230,127,5571,2942,2021-03-05,1614898800.0
845,2,1,2021-03-06,71,58,5642,3000,2021-03-06,1614985200.0
846,2,1,2021-03-07,48,0,5690,3000,2021-03-07,1615071600.0
847,2,1,2021-03-08,169,129,5859,3129,2021-03-08,1615158000.0
848,2,1,2021-03-09,213,102,6072,3231,2021-03-09,1615244400.0
849,2,1,2021-03-10,220,133,6292,3364,2021-03-10,1615330800.0
850,2,1,2021-03-11,217,77,6509,3441,2021-03-11,1615417200.0
851,2,1,2021-03-12,335,49,6844,3490,2021-03-12,1615503600.0
852,2,1,2021-03-13,103,21,6947,3511,2021-03-13,1615590000.0
853,2,1,2021-03-14,0,1,6947,3512,2021-03-14,1615676400.0
854,2,1,2021-03-15,270,92,7217,3604,2021-03-15,1615762800.0
855,2,1,2021-03-16,305,52,7522,3656,2021-03-16,1615849200.0
856,2,1,2021-03-17,387,41,7909,3697,2021-03-17,1615935600.0
857,2,1,2021-03-18,425,39,8334,3736,2021-03-18,1616022000.0
858,2,1,2021-03-19,396,56,8730,3792,2021-03-19,1616108400.0
859,2,1,2021-03-20,149,47,8879,3839,2021-03-20,1616194800.0
860,2,1,2021-03-21,25,1,8904,3840,2021-03-21,1616281200.0
861,2,1,2021-03-22,338,113,9242,3953,2021-03-22,1616367600.0
862,2,1,2021-03-23,369,116,9611,4069,2021-03-23,1616454000.0
863,2,1,2021-03-24,361,97,9972,4166,2021-03-24,1616540400.0
864,2,1,2021-03-25,393,87,10365,4253,2021-03-25,1616626800.0
865,2,1,2021-03-26,580,86,10945,4339,2021-03-26,1616713200.0
866,2,1,2021-03-27,99,68,11044,4407,2021-03-27,1616799600.0
867,2,1,2021-03-28,81,2,11125,4409,2021-03-28,1616886000.0
868,2,1,2021-03-29,362,157,11487,4566,2021-03-29,1616972400.0
869,2,1,2021-03-30,409,234,11896,4800,2021-03-30,1617058800.0
870,2,1,2021-03-31,987,174,12883,4974,2021-03-31,1617145200.0
871,2,1,2021-04-01,846,163,13729,5137,2021-04-01,1617231600.0
872,2,1,2021-04-02,894,3,14623,5140,2021-04-02,1617318000.0
873,2,1,2021-04-03,750,37,15373,5177,2021-04-03,1617404400.0
874,2,1,2021-04-04,750,2,16123,5179,2021-04-04,1617490800.0
875,2,1,2021-04-05,828,9,16951,5188,2021-04-05,1617577200.0
876,2,1,2021-04-06,873,108,17824,5296,2021-04-06,1617663600.0
877,2,1,2021-04-07,1361,288,19185,5584,2021-04-07,1617750000.0
878,2,1,2021-04-08,1280,237,20465,5821,2021-04-08,1617836400.0
879,2,1,2021-04-09,1186,300,21651,6121,2021-04-09,1617922800.0
880,2,1,2021-04-10,810,141,22461,6262,2021-04-10,1618009200.0
881,2,1,2021-04-11,621,4,23082,6266,2021-04-11,1618095600.0
882,2,1,2021-04-12,840,282,23922,6548,2021-04-12,1618185600.0
883,2,1,2021-04-13,843,310,24765,6858,2021-04-13,1618272000.0
884,2,1,2021-04-14,931,314,25696,7172,2021-04-14,1618358400.0
885,2,1,2021-04-15,889,278,26585,7450,2021-04-15,1618444800.0
886,2,1,2021-04-16,980,281,27565,7731,2021-04-16,1618531200.0
887,2,1,2021-04-17,512,149,28077,7880,2021-04-17,1618617600.0
888,2,1,2021-04-18,339,49,28416,7929,2021-04-18,1618704000.0
889,2,1,2021-04-19,668,327,29084,8256,2021-04-19,1618790400.0
890,2,1,2021-04-20,857,294,29941,8550,2021-04-20,1618876800.0
891,2,1,2021-04-21,972,339,30913,8889,2021-04-21,1618963200.0
892,2,1,2021-04-22,568,290,31481,9179,2021-04-22,1619049600.0
893,2,1,2021-04-23,591,447,32072,9626,2021-04-23,1619136000.0
894,2,1,2021-04-24,351,184,32423,9810,2021-04-24,1619222400.0
895,2,1,2021-04-25,168,198,32591,10008,2021-04-25,1619308800.0
896,2,1,2021-04-26,500,530,33091,10538,2021-04-26,1619395200.0
897,2,1,2021-04-27,539,602,33630,11140,2021-04-27,1619481600.0
898,2,1,2021-04-28,439,681,34069,11821,2021-04-28,1619568000.0
899,2,1,2021-04-29,629,622,34698,12443,2021-04-29,1619654400.0
900,2,1,2021-04-30,761,665,35459,13108,2021-04-30,1619740800.0
901,2,1,2021-05-01,235,244,35694,13352,2021-05-01,1619827200.0
902,2,1,2021-05-02,223,504,35917,13856,2021-05-02,1619913600.0
903,2,1,2021-05-03,552,759,36469,14615,2021-05-03,1620000000.0
904,2,1,2021-05-04,513,659,36982,15274,2021-05-04,1620086400.0
905,2,1,2021-05-05,519,887,37501,16161,2021-05-05,1620172800.0
906,2,1,2021-05-06,529,754,38030,16915,2021-05-06,1620259200.0
907,2,1,2021-05-07,616,998,38646,17913,2021-05-07,1620345600.0
908,2,1,2021-05-08,224,516,38870,18429,2021-05-08,1620432000.0
909,2,1,2021-05-09,171,505,39041,18934,2021-05-09,1620518400.0
910,2,1,2021-05-10,503,822,39544,19756,2021-05-10,1620604800.0
911,2,1,2021-05-11,460,863,40004,20619,2021-05-11,1620691200.0
912,2,1,2021-05-12,536,869,40540,21488,2021-05-12,1620777600.0
913,2,1,2021-05-13,272,506,40812,21994,2021-05-13,1620864000.0
914,2,1,2021-05-14,371,720,41183,22714,2021-05-14,1620950400.0
915,2,1,2021-05-15,233,572,41416,23286,2021-05-15,1621036800.0
916,2,1,2021-05-16,155,437,41571,23723,2021-05-16,1621123200.0
917,2,1,2021-05-17,470,741,42041,24464,2021-05-17,1621206000.0
918,2,1,2021-05-18,444,665,42485,25129,2021-05-18,1621292400.0
919,2,1,2021-05-19,437,708,42922,25837,2021-05-19,1621378800.0
920,2,1,2021-05-20,572,469,43494,26306,2021-05-20,1621465200.0
921,2,1,2021-05-21,539,679,44033,26985,2021-05-21,1621551600.0
922,2,1,2021-05-22,185,359,44218,27344,2021-05-22,1621638000.0
923,2,1,2021-05-23,109,179,44327,27523,2021-05-23,1621724400.0
924,2,1,2021-05-24,135,234,44462,27757,2021-05-24,1621810800.0
925,2,1,2021-05-25,346,677,44808,28434,2021-05-25,1621897200.0
926,2,1,2021-05-26,360,671,45168,29105,2021-05-26,1621983600.0
927,2,1,2021-05-27,263,619,45431,29724,2021-05-27,1622070000.0
928,2,1,2021-05-28,266,766,45697,30490,2021-05-28,1622156400.0
929,2,1,2021-05-29,142,480,45839,30970,2021-05-29,1622242800.0
930,2,1,2021-05-30,17,26,45856,30996,2021-05-30,1622329200.0
931,2,1,2021-05-31,314,609,46170,31605,2021-05-31,1622415600.0
932,2,1,2021-06-01,280,504,46450,32109,2021-06-01,1622502000.0
933,2,1,2021-06-02,298,504,46748,32613,2021-06-02,1622588400.0
934,2,1,2021-06-03,243,378,46991,32991,2021-06-03,1622674800.0
935,2,1,2021-06-04,333,609,47324,33600,2021-06-04,1622761200.0
936,2,1,2021-06-05,220,291,47544,33891,2021-06-05,1622847600.0
937,2,1,2021-06-06,22,31,47566,33922,2021-06-06,1622934000.0
938,2,1,2021-06-07,249,694,47815,34616,2021-06-07,1623020400.0
939,2,1,2021-06-08,244,540,48059,35156,2021-06-08,1623106800.0
940,2,1,2021-06-09,269,632,48328,35788,2021-06-09,1623193200.0
941,2,1,2021-06-10,293,377,48621,36165,2021-06-10,1623279600.0
942,2,1,2021-06-11,329,500,48950,36665,2021-06-11,1623366000.0
943,2,1,2021-06-12,238,286,49188,36951,2021-06-12,1623452400.0
944,2,1,2021-06-13,32,28,49220,36979,2021-06-13,1623538800.0
945,2,1,2021-06-14,353,495,49573,37474,2021-06-14,1623625200.0
946,2,1,2021-06-15,371,420,49944,37894,2021-06-15,1623711600.0
947,2,1,2021-06-16,408,377,50352,38271,2021-06-16,1623798000.0
948,2,1,2021-06-17,329,497,50681,38768,2021-06-17,1623884400.0
949,2,1,2021-06-18,413,496,51094,39264,2021-06-18,1623970800.0
950,2,1,2021-06-19,217,156,51311,39420,2021-06-19,1624057200.0
951,2,1,2021-06-20,25,17,51336,39437,2021-06-20,1624143600.0
952,2,1,2021-06-21,316,561,51652,39998,2021-06-21,1624230000.0
953,2,1,2021-06-22,271,408,51923,40406,2021-06-22,1624316400.0
954,2,1,2021-06-23,393,476,52316,40882,2021-06-23,1624402800.0
955,2,1,2021-06-24,307,359,52623,41241,2021-06-24,1624489200.0
956,2,1,2021-06-25,283,349,52906,41590,2021-06-25,1624575600.0
957,2,1,2021-06-26,213,187,53119,41777,2021-06-26,1624662000.0
958,2,1,2021-06-27,12,20,53131,41797,2021-06-27,1624748400.0
959,2,1,2021-06-28,296,377,53427,42174,2021-06-28,1624834800.0
960,2,1,2021-06-29,299,359,53726,42533,2021-06-29,1624921200.0
961,2,1,2021-06-30,409,353,54135,42886,2021-06-30,1625007600.0
962,2,1,2021-07-01,326,349,54461,43235,2021-07-01,1625094000.0
963,2,1,2021-07-02,116,161,54577,43396,2021-07-02,1625180400.0
964,2,1,2021-07-03,99,105,54676,43501,2021-07-03,1625266800.0
965,2,1,2021-07-04,24,34,54700,43535,2021-07-04,1625353200.0
966,2,1,2021-07-05,472,527,55172,44062,2021-07-05,1625439600.0
967,2,1,2021-07-06,442,356,55614,44418,2021-07-06,1625526000.0
968,2,1,2021-07-07,553,416,56167,44834,2021-07-07,1625612400.0
969,2,1,2021-07-08,457,357,56624,45191,2021-07-08,1625698800.0
970,2,2,2020-12-27,0,0,0,0,2020-12-27,1609023600.0
971,2,2,2020-12-28,0,0,0,0,2020-12-28,1609110000.0
972,2,2,2020-12-29,0,0,0,0,2020-12-29,1609196400.0
973,2,2,2020-12-30,0,0,0,0,2020-12-30,1609282800.0
974,2,2,2020-12-31,0,0,0,0,2020-12-31,1609369200.0
975,2,2,2021-01-01,0,0,0,0,2021-01-01,1609455600.0
976,2,2,2021-01-02,0,0,0,0,2021-01-02,1609542000.0
977,2,2,2021-01-03,0,0,0,0,2021-01-03,1609628400.0
978,2,2,2021-01-04,0,0,0,0,2021-01-04,1609714800.0
979,2,2,2021-01-05,0,0,0,0,2021-01-05,1609801200.0
980,2,2,2021-01-06,0,0,0,0,2021-01-06,1609887600.0
981,2,2,2021-01-07,0,0,0,0,2021-01-07,1609974000.0
982,2,2,2021-01-08,0,0,0,0,2021-01-08,1610060400.0
983,2,2,2021-01-09,0,0,0,0,2021-01-09,1610146800.0
984,2,2,2021-01-10,0,0,0,0,2021-01-10,1610233200.0
985,2,2,2021-01-11,0,0,0,0,2021-01-11,1610319600.0
986,2,2,2021-01-12,0,0,0,0,2021-01-12,1610406000.0
987,2,2,2021-01-13,0,0,0,0,2021-01-13,1610492400.0
988,2,2,2021-01-14,0,0,0,0,2021-01-14,1610578800.0
989,2,2,2021-01-15,0,0,0,0,2021-01-15,1610665200.0
990,2,2,2021-01-16,0,0,0,0,2021-01-16,1610751600.0
991,2,2,2021-01-17,0,0,0,0,2021-01-17,1610838000.0
992,2,2,2021-01-18,0,0,0,0,2021-01-18,1610924400.0
993,2,2,2021-01-19,0,0,0,0,2021-01-19,1611010800.0
994,2,2,2021-01-20,0,0,0,0,2021-01-20,1611097200.0
995,2,2,2021-01-21,0,0,0,0,2021-01-21,1611183600.0
996,2,2,2021-01-22,0,0,0,0,2021-01-22,1611270000.0
997,2,2,2021-01-23,0,0,0,0,2021-01-23,1611356400.0
998,2,2,2021-01-24,0,0,0,0,2021-01-24,1611442800.0
999,2,2,2021-01-25,0,0,0,0,2021-01-25,1611529200.0
1000,2,2,2021-01-26,0,0,0,0,2021-01-26,1611615600.0
1001,2,2,2021-01-27,0,0,0,0,2021-01-27,1611702000.0
1002,2,2,2021-01-28,0,0,0,0,2021-01-28,1611788400.0
1003,2,2,2021-01-29,0,0,0,0,2021-01-29,1611874800.0
1004,2,2,2021-01-30,0,0,0,0,2021-01-30,1611961200.0
1005,2,2,2021-01-31,0,0,0,0,2021-01-31,1612047600.0
1006,2,2,2021-02-01,0,0,0,0,2021-02-01,1612134000.0
1007,2,2,2021-02-02,0,0,0,0,2021-02-02,1612220400.0
1008,2,2,2021-02-03,0,0,0,0,2021-02-03,1612306800.0
1009,2,2,2021-02-04,0,0,0,0,2021-02-04,1612393200.0
1010,2,2,2021-02-05,0,0,0,0,2021-02-05,1612479600.0
1011,2,2,2021-02-06,0,0,0,0,2021-02-06,1612566000.0
1012,2,2,2021-02-07,0,0,0,0,2021-02-07,1612652400.0
1013,2,2,2021-02-08,0,0,0,0,2021-02-08,1612738800.0
1014,2,2,2021-02-09,0,0,0,0,2021-02-09,1612825200.0
1015,2,2,2021-02-10,0,0,0,0,2021-02-10,1612911600.0
1016,2,2,2021-02-11,0,0,0,0,2021-02-11,1612998000.0
1017,2,2,2021-02-12,0,0,0,0,2021-02-12,1613084400.0
1018,2,2,2021-02-13,0,0,0,0,2021-02-13,1613170800.0
1019,2,2,2021-02-14,0,0,0,0,2021-02-14,1613257200.0
1020,2,2,2021-02-15,0,0,0,0,2021-02-15,1613343600.0
1021,2,2,2021-02-16,0,0,0,0,2021-02-16,1613430000.0
1022,2,2,2021-02-17,0,0,0,0,2021-02-17,1613516400.0
1023,2,2,2021-02-18,0,0,0,0,2021-02-18,1613602800.0
1024,2,2,2021-02-19,0,0,0,0,2021-02-19,1613689200.0
1025,2,2,2021-02-20,0,0,0,0,2021-02-20,1613775600.0
1026,2,2,2021-02-21,0,0,0,0,2021-02-21,1613862000.0
1027,2,2,2021-02-22,0,0,0,0,2021-02-22,1613948400.0
1028,2,2,2021-02-23,0,0,0,0,2021-02-23,1614034800.0
1029,2,2,2021-02-24,0,0,0,0,2021-02-24,1614121200.0
1030,2,2,2021-02-25,0,0,0,0,2021-02-25,1614207600.0
1031,2,2,2021-02-26,0,0,0,0,2021-02-26,1614294000.0
1032,2,2,2021-02-27,0,0,0,0,2021-02-27,1614380400.0
1033,2,2,2021-02-28,0,0,0,0,2021-02-28,1614466800.0
1034,2,2,2021-03-01,0,0,0,0,2021-03-01,1614553200.0
1035,2,2,2021-03-02,0,0,0,0,2021-03-02,1614639600.0
1036,2,2,2021-03-03,0,0,0,0,2021-03-03,1614726000.0
1037,2,2,2021-03-04,0,0,0,0,2021-03-04,1614812400.0
1038,2,2,2021-03-05,0,0,0,0,2021-03-05,1614898800.0
1039,2,2,2021-03-06,0,0,0,0,2021-03-06,1614985200.0
1040,2,2,2021-03-07,0,0,0,0,2021-03-07,1615071600.0
1041,2,2,2021-03-08,0,0,0,0,2021-03-08,1615158000.0
1042,2,2,2021-03-09,0,0,0,0,2021-03-09,1615244400.0
1043,2,2,2021-03-10,0,0,0,0,2021-03-10,1615330800.0
1044,2,2,2021-03-11,0,0,0,0,2021-03-11,1615417200.0
1045,2,2,2021-03-12,0,0,0,0,2021-03-12,1615503600.0
1046,2,2,2021-03-13,0,0,0,0,2021-03-13,1615590000.0
1047,2,2,2021-03-14,0,0,0,0,2021-03-14,1615676400.0
1048,2,2,2021-03-15,0,0,0,0,2021-03-15,1615762800.0
1049,2,2,2021-03-16,0,0,0,0,2021-03-16,1615849200.0
1050,2,2,2021-03-17,0,0,0,0,2021-03-17,1615935600.0
1051,2,2,2021-03-18,0,0,0,0,2021-03-18,1616022000.0
1052,2,2,2021-03-19,0,0,0,0,2021-03-19,1616108400.0
1053,2,2,2021-03-20,0,0,0,0,2021-03-20,1616194800.0
1054,2,2,2021-03-21,0,0,0,0,2021-03-21,1616281200.0
1055,2,2,2021-03-22,0,0,0,0,2021-03-22,1616367600.0
1056,2,2,2021-03-23,0,0,0,0,2021-03-23,1616454000.0
1057,2,2,2021-03-24,0,0,0,0,2021-03-24,1616540400.0
1058,2,2,2021-03-25,0,0,0,0,2021-03-25,1616626800.0
1059,2,2,2021-03-26,0,0,0,0,2021-03-26,1616713200.0
1060,2,2,2021-03-27,0,0,0,0,2021-03-27,1616799600.0
1061,2,2,2021-03-28,0,0,0,0,2021-03-28,1616886000.0
1062,2,2,2021-03-29,0,0,0,0,2021-03-29,1616972400.0
1063,2,2,2021-03-30,0,0,0,0,2021-03-30,1617058800.0
1064,2,2,2021-03-31,0,0,0,0,2021-03-31,1617145200.0
1065,2,2,2021-04-01,0,0,0,0,2021-04-01,1617231600.0
1066,2,2,2021-04-02,0,0,0,0,2021-04-02,1617318000.0
1067,2,2,2021-04-03,0,0,0,0,2021-04-03,1617404400.0
1068,2,2,2021-04-04,0,0,0,0,2021-04-04,1617490800.0
1069,2,2,2021-04-05,0,0,0,0,2021-04-05,1617577200.0
1070,2,2,2021-04-06,0,0,0,0,2021-04-06,1617663600.0
1071,2,2,2021-04-07,0,0,0,0,2021-04-07,1617750000.0
1072,2,2,2021-04-08,0,0,0,0,2021-04-08,1617836400.0
1073,2,2,2021-04-09,0,0,0,0,2021-04-09,1617922800.0
1074,2,2,2021-04-10,0,0,0,0,2021-04-10,1618009200.0
1075,2,2,2021-04-11,0,0,0,0,2021-04-11,1618095600.0
1076,2,2,2021-04-12,0,0,0,0,2021-04-12,1618185600.0
1077,2,2,2021-04-13,0,0,0,0,2021-04-13,1618272000.0
1078,2,2,2021-04-14,0,0,0,0,2021-04-14,1618358400.0
1079,2,2,2021-04-15,0,0,0,0,2021-04-15,1618444800.0
1080,2,2,2021-04-16,0,0,0,0,2021-04-16,1618531200.0
1081,2,2,2021-04-17,0,0,0,0,2021-04-17,1618617600.0
1082,2,2,2021-04-18,0,0,0,0,2021-04-18,1618704000.0
1083,2,2,2021-04-19,0,0,0,0,2021-04-19,1618790400.0
1084,2,2,2021-04-20,0,0,0,0,2021-04-20,1618876800.0
1085,2,2,2021-04-21,0,0,0,0,2021-04-21,1618963200.0
1086,2,2,2021-04-22,0,0,0,0,2021-04-22,1619049600.0
1087,2,2,2021-04-23,0,0,0,0,2021-04-23,1619136000.0
1088,2,2,2021-04-24,0,0,0,0,2021-04-24,1619222400.0
1089,2,2,2021-04-25,0,0,0,0,2021-04-25,1619308800.0
1090,2,2,2021-04-26,0,0,0,0,2021-04-26,1619395200.0
1091,2,2,2021-04-27,0,0,0,0,2021-04-27,1619481600.0
1092,2,2,2021-04-28,0,0,0,0,2021-04-28,1619568000.0
1093,2,2,2021-04-29,0,0,0,0,2021-04-29,1619654400.0
1094,2,2,2021-04-30,0,0,0,0,2021-04-30,1619740800.0
1095,2,2,2021-05-01,0,0,0,0,2021-05-01,1619827200.0
1096,2,2,2021-05-02,0,0,0,0,2021-05-02,1619913600.0
1097,2,2,2021-05-03,0,0,0,0,2021-05-03,1620000000.0
1098,2,2,2021-05-04,0,0,0,0,2021-05-04,1620086400.0
1099,2,2,2021-05-05,0,0,0,0,2021-05-05,1620172800.0
1100,2,2,2021-05-06,0,0,0,0,2021-05-06,1620259200.0
1101,2,2,2021-05-07,0,0,0,0,2021-05-07,1620345600.0
1102,2,2,2021-05-08,0,0,0,0,2021-05-08,1620432000.0
1103,2,2,2021-05-09,0,0,0,0,2021-05-09,1620518400.0
1104,2,2,2021-05-10,0,0,0,0,2021-05-10,1620604800.0
1105,2,2,2021-05-11,0,0,0,0,2021-05-11,1620691200.0
1106,2,2,2021-05-12,0,0,0,0,2021-05-12,1620777600.0
1107,2,2,2021-05-13,0,0,0,0,2021-05-13,1620864000.0
1108,2,2,2021-05-14,0,0,0,0,2021-05-14,1620950400.0
1109,2,2,2021-05-15,0,0,0,0,2021-05-15,1621036800.0
1110,2,2,2021-05-16,0,0,0,0,2021-05-16,1621123200.0
1111,2,2,2021-05-17,0,0,0,0,2021-05-17,1621206000.0
1112,2,2,2021-05-18,0,0,0,0,2021-05-18,1621292400.0
1113,2,2,2021-05-19,0,0,0,0,2021-05-19,1621378800.0
1114,2,2,2021-05-20,0,0,0,0,2021-05-20,1621465200.0
1115,2,2,2021-05-21,0,0,0,0,2021-05-21,1621551600.0
1116,2,2,2021-05-22,0,0,0,0,2021-05-22,1621638000.0
1117,2,2,2021-05-23,0,0,0,0,2021-05-23,1621724400.0
1118,2,2,2021-05-24,0,0,0,0,2021-05-24,1621810800.0
1119,2,2,2021-05-25,0,0,0,0,2021-05-25,1621897200.0
1120,2,2,2021-05-26,0,0,0,0,2021-05-26,1621983600.0
1121,2,2,2021-05-27,0,0,0,0,2021-05-27,1622070000.0
1122,2,2,2021-05-28,0,0,0,0,2021-05-28,1622156400.0
1123,2,2,2021-05-29,0,0,0,0,2021-05-29,1622242800.0
1124,2,2,2021-05-30,0,0,0,0,2021-05-30,1622329200.0
1125,2,2,2021-05-31,0,0,0,0,2021-05-31,1622415600.0
1126,2,2,2021-06-01,0,0,0,0,2021-06-01,1622502000.0
1127,2,2,2021-06-02,0,0,0,0,2021-06-02,1622588400.0
1128,2,2,2021-06-03,0,0,0,0,2021-06-03,1622674800.0
1129,2,2,2021-06-04,0,0,0,0,2021-06-04,1622761200.0
1130,2,2,2021-06-05,0,0,0,0,2021-06-05,1622847600.0
1131,2,2,2021-06-06,0,0,0,0,2021-06-06,1622934000.0
1132,2,2,2021-06-07,0,0,0,0,2021-06-07,1623020400.0
1133,2,2,2021-06-08,0,0,0,0,2021-06-08,1623106800.0
1134,2,2,2021-06-09,1,0,1,0,2021-06-09,1623193200.0
1135,2,2,2021-06-10,0,0,1,0,2021-06-10,1623279600.0
1136,2,2,2021-06-11,0,0,1,0,2021-06-11,1623366000.0
1137,2,2,2021-06-12,0,0,1,0,2021-06-12,1623452400.0
1138,2,2,2021-06-13,0,0,1,0,2021-06-13,1623538800.0
1139,2,2,2021-06-14,0,0,1,0,2021-06-14,1623625200.0
1140,2,2,2021-06-15,0,0,1,0,2021-06-15,1623711600.0
1141,2,2,2021-06-16,0,0,1,0,2021-06-16,1623798000.0
1142,2,2,2021-06-17,0,0,1,0,2021-06-17,1623884400.0
1143,2,2,2021-06-18,0,0,1,0,2021-06-18,1623970800.0
1144,2,2,2021-06-19,0,0,1,0,2021-06-19,1624057200.0
1145,2,2,2021-06-20,0,0,1,0,2021-06-20,1624143600.0
1146,2,2,2021-06-21,0,0,1,0,2021-06-21,1624230000.0
1147,2,2,2021-06-22,0,0,1,0,2021-06-22,1624316400.0
1148,2,2,2021-06-23,0,0,1,0,2021-06-23,1624402800.0
1149,2,2,2021-06-24,0,0,1,0,2021-06-24,1624489200.0
1150,2,2,2021-06-25,0,0,1,0,2021-06-25,1624575600.0
1151,2,2,2021-06-26,0,0,1,0,2021-06-26,1624662000.0
1152,2,2,2021-06-27,0,0,1,0,2021-06-27,1624748400.0
1153,2,2,2021-06-28,0,0,1,0,2021-06-28,1624834800.0
1154,2,2,2021-06-29,0,0,1,0,2021-06-29,1624921200.0
1155,2,2,2021-06-30,0,0,1,0,2021-06-30,1625007600.0
1156,2,2,2021-07-01,0,0,1,0,2021-07-01,1625094000.0
1157,2,2,2021-07-02,0,0,1,0,2021-07-02,1625180400.0
1158,2,2,2021-07-03,0,0,1,0,2021-07-03,1625266800.0
1159,2,2,2021-07-04,0,0,1,0,2021-07-04,1625353200.0
1160,2,2,2021-07-05,0,0,1,0,2021-07-05,1625439600.0
1161,2,2,2021-07-06,0,0,1,0,2021-07-06,1625526000.0
1162,2,2,2021-07-07,0,0,1,0,2021-07-07,1625612400.0
1163,2,2,2021-07-08,0,0,1,0,2021-07-08,1625698800.0
1164,2,3,2020-12-27,0,0,0,0,2020-12-27,1609023600.0
1165,2,3,2020-12-28,0,0,0,0,2020-12-28,1609110000.0
1166,2,3,2020-12-29,0,0,0,0,2020-12-29,1609196400.0
1167,2,3,2020-12-30,0,0,0,0,2020-12-30,1609282800.0
1168,2,3,2020-12-31,0,0,0,0,2020-12-31,1609369200.0
1169,2,3,2021-01-01,0,0,0,0,2021-01-01,1609455600.0
1170,2,3,2021-01-02,0,0,0,0,2021-01-02,1609542000.0
1171,2,3,2021-01-03,0,0,0,0,2021-01-03,1609628400.0
1172,2,3,2021-01-04,0,0,0,0,2021-01-04,1609714800.0
1173,2,3,2021-01-05,0,0,0,0,2021-01-05,1609801200.0
1174,2,3,2021-01-06,0,0,0,0,2021-01-06,1609887600.0
1175,2,3,2021-01-07,0,0,0,0,2021-01-07,1609974000.0
1176,2,3,2021-01-08,0,0,0,0,2021-01-08,1610060400.0
1177,2,3,2021-01-09,0,0,0,0,2021-01-09,1610146800.0
1178,2,3,2021-01-10,0,0,0,0,2021-01-10,1610233200.0
1179,2,3,2021-01-11,0,0,0,0,2021-01-11,1610319600.0
1180,2,3,2021-01-12,0,0,0,0,2021-01-12,1610406000.0
1181,2,3,2021-01-13,0,0,0,0,2021-01-13,1610492400.0
1182,2,3,2021-01-14,0,0,0,0,2021-01-14,1610578800.0
1183,2,3,2021-01-15,0,0,0,0,2021-01-15,1610665200.0
1184,2,3,2021-01-16,0,0,0,0,2021-01-16,1610751600.0
1185,2,3,2021-01-17,0,0,0,0,2021-01-17,1610838000.0
1186,2,3,2021-01-18,0,0,0,0,2021-01-18,1610924400.0
1187,2,3,2021-01-19,0,0,0,0,2021-01-19,1611010800.0
1188,2,3,2021-01-20,0,0,0,0,2021-01-20,1611097200.0
1189,2,3,2021-01-21,0,0,0,0,2021-01-21,1611183600.0
1190,2,3,2021-01-22,0,0,0,0,2021-01-22,1611270000.0
1191,2,3,2021-01-23,0,0,0,0,2021-01-23,1611356400.0
1192,2,3,2021-01-24,0,0,0,0,2021-01-24,1611442800.0
1193,2,3,2021-01-25,0,0,0,0,2021-01-25,1611529200.0
1194,2,3,2021-01-26,0,0,0,0,2021-01-26,1611615600.0
1195,2,3,2021-01-27,0,0,0,0,2021-01-27,1611702000.0
1196,2,3,2021-01-28,0,0,0,0,2021-01-28,1611788400.0
1197,2,3,2021-01-29,0,0,0,0,2021-01-29,1611874800.0
1198,2,3,2021-01-30,0,0,0,0,2021-01-30,1611961200.0
1199,2,3,2021-01-31,0,0,0,0,2021-01-31,1612047600.0
1200,2,3,2021-02-01,0,0,0,0,2021-02-01,1612134000.0
1201,2,3,2021-02-02,0,0,0,0,2021-02-02,1612220400.0
1202,2,3,2021-02-03,0,0,0,0,2021-02-03,1612306800.0
1203,2,3,2021-02-04,0,0,0,0,2021-02-04,1612393200.0
1204,2,3,2021-02-05,0,0,0,0,2021-02-05,1612479600.0
1205,2,3,2021-02-06,0,0,0,0,2021-02-06,1612566000.0
1206,2,3,2021-02-07,0,0,0,0,2021-02-07,1612652400.0
1207,2,3,2021-02-08,0,0,0,0,2021-02-08,1612738800.0
1208,2,3,2021-02-09,0,0,0,0,2021-02-09,1612825200.0
1209,2,3,2021-02-10,0,0,0,0,2021-02-10,1612911600.0
1210,2,3,2021-02-11,0,0,0,0,2021-02-11,1612998000.0
1211,2,3,2021-02-12,0,0,0,0,2021-02-12,1613084400.0
1212,2,3,2021-02-13,0,0,0,0,2021-02-13,1613170800.0
1213,2,3,2021-02-14,0,0,0,0,2021-02-14,1613257200.0
1214,2,3,2021-02-15,0,0,0,0,2021-02-15,1613343600.0
1215,2,3,2021-02-16,0,0,0,0,2021-02-16,1613430000.0
1216,2,3,2021-02-17,1,0,1,0,2021-02-17,1613516400.0
1217,2,3,2021-02-18,0,0,1,0,2021-02-18,1613602800.0
1218,2,3,2021-02-19,0,0,1,0,2021-02-19,1613689200.0
1219,2,3,2021-02-20,0,0,1,0,2021-02-20,1613775600.0
1220,2,3,2021-02-21,0,0,1,0,2021-02-21,1613862000.0
1221,2,3,2021-02-22,0,0,1,0,2021-02-22,1613948400.0
1222,2,3,2021-02-23,0,0,1,0,2021-02-23,1614034800.0
1223,2,3,2021-02-24,0,0,1,0,2021-02-24,1614121200.0
1224,2,3,2021-02-25,0,0,1,0,2021-02-25,1614207600.0
1225,2,3,2021-02-26,0,0,1,0,2021-02-26,1614294000.0
1226,2,3,2021-02-27,0,0,1,0,2021-02-27,1614380400.0
1227,2,3,2021-02-28,0,0,1,0,2021-02-28,1614466800.0
1228,2,3,2021-03-01,0,0,1,0,2021-03-01,1614553200.0
1229,2,3,2021-03-02,16,0,17,0,2021-03-02,1614639600.0
1230,2,3,2021-03-03,11,0,28,0,2021-03-03,1614726000.0
1231,2,3,2021-03-04,33,0,61,0,2021-03-04,1614812400.0
1232,2,3,2021-03-05,8,0,69,0,2021-03-05,1614898800.0
1233,2,3,2021-03-06,48,0,117,0,2021-03-06,1614985200.0
1234,2,3,2021-03-07,52,0,169,0,2021-03-07,1615071600.0
1235,2,3,2021-03-08,27,0,196,0,2021-03-08,1615158000.0
1236,2,3,2021-03-09,56,0,252,0,2021-03-09,1615244400.0
1237,2,3,2021-03-10,103,0,355,0,2021-03-10,1615330800.0
1238,2,3,2021-03-11,117,0,472,0,2021-03-11,1615417200.0
1239,2,3,2021-03-12,63,0,535,0,2021-03-12,1615503600.0
1240,2,3,2021-03-13,52,0,587,0,2021-03-13,1615590000.0
1241,2,3,2021-03-14,4,0,591,0,2021-03-14,1615676400.0
1242,2,3,2021-03-15,6,0,597,0,2021-03-15,1615762800.0
1243,2,3,2021-03-16,0,0,597,0,2021-03-16,1615849200.0
1244,2,3,2021-03-17,0,0,597,0,2021-03-17,1615935600.0
1245,2,3,2021-03-18,10,0,607,0,2021-03-18,1616022000.0
1246,2,3,2021-03-19,0,0,607,0,2021-03-19,1616108400.0
1247,2,3,2021-03-20,0,0,607,0,2021-03-20,1616194800.0
1248,2,3,2021-03-21,0,0,607,0,2021-03-21,1616281200.0
1249,2,3,2021-03-22,24,0,631,0,2021-03-22,1616367600.0
1250,2,3,2021-03-23,32,0,663,0,2021-03-23,1616454000.0
1251,2,3,2021-03-24,66,0,729,0,2021-03-24,1616540400.0
1252,2,3,2021-03-25,81,0,810,0,2021-03-25,1616626800.0
1253,2,3,2021-03-26,52,0,862,0,2021-03-26,1616713200.0
1254,2,3,2021-03-27,53,0,915,0,2021-03-27,1616799600.0
1255,2,3,2021-03-28,0,0,915,0,2021-03-28,1616886000.0
1256,2,3,2021-03-29,59,0,974,0,2021-03-29,1616972400.0
1257,2,3,2021-03-30,60,0,1034,0,2021-03-30,1617058800.0
1258,2,3,2021-03-31,156,0,1190,0,2021-03-31,1617145200.0
1259,2,3,2021-04-01,105,0,1295,0,2021-04-01,1617231600.0
1260,2,3,2021-04-02,1,0,1296,0,2021-04-02,1617318000.0
1261,2,3,2021-04-03,38,0,1334,0,2021-04-03,1617404400.0
1262,2,3,2021-04-04,0,0,1334,0,2021-04-04,1617490800.0
1263,2,3,2021-04-05,0,0,1334,0,2021-04-05,1617577200.0
1264,2,3,2021-04-06,10,0,1344,0,2021-04-06,1617663600.0
1265,2,3,2021-04-07,74,0,1418,0,2021-04-07,1617750000.0
1266,2,3,2021-04-08,26,0,1444,0,2021-04-08,1617836400.0
1267,2,3,2021-04-09,53,0,1497,0,2021-04-09,1617922800.0
1268,2,3,2021-04-10,28,2,1525,2,2021-04-10,1618009200.0
1269,2,3,2021-04-11,0,0,1525,2,2021-04-11,1618095600.0
1270,2,3,2021-04-12,28,0,1553,2,2021-04-12,1618185600.0
1271,2,3,2021-04-13,24,0,1577,2,2021-04-13,1618272000.0
1272,2,3,2021-04-14,26,0,1603,2,2021-04-14,1618358400.0
1273,2,3,2021-04-15,69,1,1672,3,2021-04-15,1618444800.0
1274,2,3,2021-04-16,11,0,1683,3,2021-04-16,1618531200.0
1275,2,3,2021-04-17,16,0,1699,3,2021-04-17,1618617600.0
1276,2,3,2021-04-18,0,0,1699,3,2021-04-18,1618704000.0
1277,2,3,2021-04-19,0,0,1699,3,2021-04-19,1618790400.0
1278,2,3,2021-04-20,12,0,1711,3,2021-04-20,1618876800.0
1279,2,3,2021-04-21,27,0,1738,3,2021-04-21,1618963200.0
1280,2,3,2021-04-22,34,3,1772,6,2021-04-22,1619049600.0
1281,2,3,2021-04-23,15,0,1787,6,2021-04-23,1619136000.0
1282,2,3,2021-04-24,9,5,1796,11,2021-04-24,1619222400.0
1283,2,3,2021-04-25,0,0,1796,11,2021-04-25,1619308800.0
1284,2,3,2021-04-26,15,0,1811,11,2021-04-26,1619395200.0
1285,2,3,2021-04-27,25,0,1836,11,2021-04-27,1619481600.0
1286,2,3,2021-04-28,10,2,1846,13,2021-04-28,1619568000.0
1287,2,3,2021-04-29,23,0,1869,13,2021-04-29,1619654400.0
1288,2,3,2021-04-30,10,1,1879,14,2021-04-30,1619740800.0
1289,2,3,2021-05-01,8,0,1887,14,2021-05-01,1619827200.0
1290,2,3,2021-05-02,3,0,1890,14,2021-05-02,1619913600.0
1291,2,3,2021-05-03,17,0,1907,14,2021-05-03,1620000000.0
1292,2,3,2021-05-04,11,1,1918,15,2021-05-04,1620086400.0
1293,2,3,2021-05-05,22,0,1940,15,2021-05-05,1620172800.0
1294,2,3,2021-05-06,17,15,1957,30,2021-05-06,1620259200.0
1295,2,3,2021-05-07,8,0,1965,30,2021-05-07,1620345600.0
1296,2,3,2021-05-08,0,0,1965,30,2021-05-08,1620432000.0
1297,2,3,2021-05-09,2,0,1967,30,2021-05-09,1620518400.0
1298,2,3,2021-05-10,6,17,1973,47,2021-05-10,1620604800.0
1299,2,3,2021-05-11,12,3,1985,50,2021-05-11,1620691200.0
1300,2,3,2021-05-12,2,11,1987,61,2021-05-12,1620777600.0
1301,2,3,2021-05-13,1,14,1988,75,2021-05-13,1620864000.0
1302,2,3,2021-05-14,12,17,2000,92,2021-05-14,1620950400.0
1303,2,3,2021-05-15,0,4,2000,96,2021-05-15,1621036800.0
1304,2,3,2021-05-16,0,0,2000,96,2021-05-16,1621123200.0
1305,2,3,2021-05-17,2,0,2002,96,2021-05-17,1621206000.0
1306,2,3,2021-05-18,2,0,2004,96,2021-05-18,1621292400.0
1307,2,3,2021-05-19,5,9,2009,105,2021-05-19,1621378800.0
1308,2,3,2021-05-20,5,8,2014,113,2021-05-20,1621465200.0
1309,2,3,2021-05-21,2,10,2016,123,2021-05-21,1621551600.0
1310,2,3,2021-05-22,0,2,2016,125,2021-05-22,1621638000.0
1311,2,3,2021-05-23,0,0,2016,125,2021-05-23,1621724400.0
1312,2,3,2021-05-24,0,0,2016,125,2021-05-24,1621810800.0
1313,2,3,2021-05-25,4,16,2020,141,2021-05-25,1621897200.0
1314,2,3,2021-05-26,5,19,2025,160,2021-05-26,1621983600.0
1315,2,3,2021-05-27,2,22,2027,182,2021-05-27,1622070000.0
1316,2,3,2021-05-28,2,40,2029,222,2021-05-28,1622156400.0
1317,2,3,2021-05-29,7,27,2036,249,2021-05-29,1622242800.0
1318,2,3,2021-05-30,0,4,2036,253,2021-05-30,1622329200.0
1319,2,3,2021-05-31,10,48,2046,301,2021-05-31,1622415600.0
1320,2,3,2021-06-01,2,19,2048,320,2021-06-01,1622502000.0
1321,2,3,2021-06-02,6,40,2054,360,2021-06-02,1622588400.0
1322,2,3,2021-06-03,3,47,2057,407,2021-06-03,1622674800.0
1323,2,3,2021-06-04,0,12,2057,419,2021-06-04,1622761200.0
1324,2,3,2021-06-05,2,37,2059,456,2021-06-05,1622847600.0
1325,2,3,2021-06-06,0,0,2059,456,2021-06-06,1622934000.0
1326,2,3,2021-06-07,9,35,2068,491,2021-06-07,1623020400.0
1327,2,3,2021-06-08,3,33,2071,524,2021-06-08,1623106800.0
1328,2,3,2021-06-09,13,44,2084,568,2021-06-09,1623193200.0
1329,2,3,2021-06-10,3,59,2087,627,2021-06-10,1623279600.0
1330,2,3,2021-06-11,1,21,2088,648,2021-06-11,1623366000.0
1331,2,3,2021-06-12,0,21,2088,669,2021-06-12,1623452400.0
1332,2,3,2021-06-13,0,0,2088,669,2021-06-13,1623538800.0
1333,2,3,2021-06-14,1,22,2089,691,2021-06-14,1623625200.0
1334,2,3,2021-06-15,0,16,2089,707,2021-06-15,1623711600.0
1335,2,3,2021-06-16,0,26,2089,733,2021-06-16,1623798000.0
1336,2,3,2021-06-17,8,51,2097,784,2021-06-17,1623884400.0
1337,2,3,2021-06-18,0,22,2097,806,2021-06-18,1623970800.0
1338,2,3,2021-06-19,0,22,2097,828,2021-06-19,1624057200.0
1339,2,3,2021-06-20,0,0,2097,828,2021-06-20,1624143600.0
1340,2,3,2021-06-21,0,2,2097,830,2021-06-21,1624230000.0
1341,2,3,2021-06-22,0,26,2097,856,2021-06-22,1624316400.0
1342,2,3,2021-06-23,0,49,2097,905,2021-06-23,1624402800.0
1343,2,3,2021-06-24,0,46,2097,951,2021-06-24,1624489200.0
1344,2,3,2021-06-25,0,3,2097,954,2021-06-25,1624575600.0
1345,2,3,2021-06-26,0,1,2097,955,2021-06-26,1624662000.0
1346,2,3,2021-06-27,0,0,2097,955,2021-06-27,1624748400.0
1347,2,3,2021-06-28,0,11,2097,966,2021-06-28,1624834800.0
1348,2,3,2021-06-29,1,28,2098,994,2021-06-29,1624921200.0
1349,2,3,2021-06-30,0,23,2098,1017,2021-06-30,1625007600.0
1350,2,3,2021-07-01,0,6,2098,1023,2021-07-01,1625094000.0
1351,2,3,2021-07-02,0,20,2098,1043,2021-07-02,1625180400.0
1352,2,3,2021-07-03,0,9,2098,1052,2021-07-03,1625266800.0
1353,2,3,2021-07-04,0,0,2098,1052,2021-07-04,1625353200.0
1354,2,3,2021-07-05,0,11,2098,1063,2021-07-05,1625439600.0
1355,2,3,2021-07-06,3,9,2101,1072,2021-07-06,1625526000.0
1356,2,3,2021-07-07,0,15,2101,1087,2021-07-07,1625612400.0
1357,2,3,2021-07-08,2,7,2103,1094,2021-07-08,1625698800.0
1358,2,4,2020-12-27,0,0,0,0,2020-12-27,1609023600.0
1359,2,4,2020-12-28,0,0,0,0,2020-12-28,1609110000.0
1360,2,4,2020-12-29,0,0,0,0,2020-12-29,1609196400.0
1361,2,4,2020-12-30,0,0,0,0,2020-12-30,1609282800.0
1362,2,4,2020-12-31,0,0,0,0,2020-12-31,1609369200.0
1363,2,4,2021-01-01,0,0,0,0,2021-01-01,1609455600.0
1364,2,4,2021-01-02,0,0,0,0,2021-01-02,1609542000.0
1365,2,4,2021-01-03,0,0,0,0,2021-01-03,1609628400.0
1366,2,4,2021-01-04,0,0,0,0,2021-01-04,1609714800.0
1367,2,4,2021-01-05,0,0,0,0,2021-01-05,1609801200.0
1368,2,4,2021-01-06,0,0,0,0,2021-01-06,1609887600.0
1369,2,4,2021-01-07,0,0,0,0,2021-01-07,1609974000.0
1370,2,4,2021-01-08,0,0,0,0,2021-01-08,1610060400.0
1371,2,4,2021-01-09,0,0,0,0,2021-01-09,1610146800.0
1372,2,4,2021-01-10,0,0,0,0,2021-01-10,1610233200.0
1373,2,4,2021-01-11,0,0,0,0,2021-01-11,1610319600.0
1374,2,4,2021-01-12,0,0,0,0,2021-01-12,1610406000.0
1375,2,4,2021-01-13,0,0,0,0,2021-01-13,1610492400.0
1376,2,4,2021-01-14,0,0,0,0,2021-01-14,1610578800.0
1377,2,4,2021-01-15,0,0,0,0,2021-01-15,1610665200.0
1378,2,4,2021-01-16,0,0,0,0,2021-01-16,1610751600.0
1379,2,4,2021-01-17,0,0,0,0,2021-01-17,1610838000.0
1380,2,4,2021-01-18,0,0,0,0,2021-01-18,1610924400.0
1381,2,4,2021-01-19,0,0,0,0,2021-01-19,1611010800.0
1382,2,4,2021-01-20,0,0,0,0,2021-01-20,1611097200.0
1383,2,4,2021-01-21,0,0,0,0,2021-01-21,1611183600.0
1384,2,4,2021-01-22,0,0,0,0,2021-01-22,1611270000.0
1385,2,4,2021-01-23,0,0,0,0,2021-01-23,1611356400.0
1386,2,4,2021-01-24,0,0,0,0,2021-01-24,1611442800.0
1387,2,4,2021-01-25,0,0,0,0,2021-01-25,1611529200.0
1388,2,4,2021-01-26,0,0,0,0,2021-01-26,1611615600.0
1389,2,4,2021-01-27,0,0,0,0,2021-01-27,1611702000.0
1390,2,4,2021-01-28,0,0,0,0,2021-01-28,1611788400.0
1391,2,4,2021-01-29,0,0,0,0,2021-01-29,1611874800.0
1392,2,4,2021-01-30,0,0,0,0,2021-01-30,1611961200.0
1393,2,4,2021-01-31,0,0,0,0,2021-01-31,1612047600.0
1394,2,4,2021-02-01,0,0,0,0,2021-02-01,1612134000.0
1395,2,4,2021-02-02,0,0,0,0,2021-02-02,1612220400.0
1396,2,4,2021-02-03,0,0,0,0,2021-02-03,1612306800.0
1397,2,4,2021-02-04,0,0,0,0,2021-02-04,1612393200.0
1398,2,4,2021-02-05,0,0,0,0,2021-02-05,1612479600.0
1399,2,4,2021-02-06,0,0,0,0,2021-02-06,1612566000.0
1400,2,4,2021-02-07,0,0,0,0,2021-02-07,1612652400.0
1401,2,4,2021-02-08,0,0,0,0,2021-02-08,1612738800.0
1402,2,4,2021-02-09,0,0,0,0,2021-02-09,1612825200.0
1403,2,4,2021-02-10,0,0,0,0,2021-02-10,1612911600.0
1404,2,4,2021-02-11,0,0,0,0,2021-02-11,1612998000.0
1405,2,4,2021-02-12,0,0,0,0,2021-02-12,1613084400.0
1406,2,4,2021-02-13,0,0,0,0,2021-02-13,1613170800.0
1407,2,4,2021-02-14,0,0,0,0,2021-02-14,1613257200.0
1408,2,4,2021-02-15,0,0,0,0,2021-02-15,1613343600.0
1409,2,4,2021-02-16,0,0,0,0,2021-02-16,1613430000.0
1410,2,4,2021-02-17,0,0,0,0,2021-02-17,1613516400.0
1411,2,4,2021-02-18,0,0,0,0,2021-02-18,1613602800.0
1412,2,4,2021-02-19,0,0,0,0,2021-02-19,1613689200.0
1413,2,4,2021-02-20,0,0,0,0,2021-02-20,1613775600.0
1414,2,4,2021-02-21,0,0,0,0,2021-02-21,1613862000.0
1415,2,4,2021-02-22,0,0,0,0,2021-02-22,1613948400.0
1416,2,4,2021-02-23,0,0,0,0,2021-02-23,1614034800.0
1417,2,4,2021-02-24,0,0,0,0,2021-02-24,1614121200.0
1418,2,4,2021-02-25,0,0,0,0,2021-02-25,1614207600.0
1419,2,4,2021-02-26,0,0,0,0,2021-02-26,1614294000.0
1420,2,4,2021-02-27,0,0,0,0,2021-02-27,1614380400.0
1421,2,4,2021-02-28,0,0,0,0,2021-02-28,1614466800.0
1422,2,4,2021-03-01,0,0,0,0,2021-03-01,1614553200.0
1423,2,4,2021-03-02,0,0,0,0,2021-03-02,1614639600.0
1424,2,4,2021-03-03,0,0,0,0,2021-03-03,1614726000.0
1425,2,4,2021-03-04,0,0,0,0,2021-03-04,1614812400.0
1426,2,4,2021-03-05,0,0,0,0,2021-03-05,1614898800.0
1427,2,4,2021-03-06,0,0,0,0,2021-03-06,1614985200.0
1428,2,4,2021-03-07,0,0,0,0,2021-03-07,1615071600.0
1429,2,4,2021-03-08,0,0,0,0,2021-03-08,1615158000.0
1430,2,4,2021-03-09,0,0,0,0,2021-03-09,1615244400.0
1431,2,4,2021-03-10,0,0,0,0,2021-03-10,1615330800.0
1432,2,4,2021-03-11,0,0,0,0,2021-03-11,1615417200.0
1433,2,4,2021-03-12,0,0,0,0,2021-03-12,1615503600.0
1434,2,4,2021-03-13,0,0,0,0,2021-03-13,1615590000.0
1435,2,4,2021-03-14,0,0,0,0,2021-03-14,1615676400.0
1436,2,4,2021-03-15,0,0,0,0,2021-03-15,1615762800.0
1437,2,4,2021-03-16,0,0,0,0,2021-03-16,1615849200.0
1438,2,4,2021-03-17,0,0,0,0,2021-03-17,1615935600.0
1439,2,4,2021-03-18,0,0,0,0,2021-03-18,1616022000.0
1440,2,4,2021-03-19,0,0,0,0,2021-03-19,1616108400.0
1441,2,4,2021-03-20,0,0,0,0,2021-03-20,1616194800.0
1442,2,4,2021-03-21,0,0,0,0,2021-03-21,1616281200.0
1443,2,4,2021-03-22,0,0,0,0,2021-03-22,1616367600.0
1444,2,4,2021-03-23,0,0,0,0,2021-03-23,1616454000.0
1445,2,4,2021-03-24,0,0,0,0,2021-03-24,1616540400.0
1446,2,4,2021-03-25,0,0,0,0,2021-03-25,1616626800.0
1447,2,4,2021-03-26,0,0,0,0,2021-03-26,1616713200.0
1448,2,4,2021-03-27,0,0,0,0,2021-03-27,1616799600.0
1449,2,4,2021-03-28,0,0,0,0,2021-03-28,1616886000.0
1450,2,4,2021-03-29,0,0,0,0,2021-03-29,1616972400.0
1451,2,4,2021-03-30,0,0,0,0,2021-03-30,1617058800.0
1452,2,4,2021-03-31,0,0,0,0,2021-03-31,1617145200.0
1453,2,4,2021-04-01,0,0,0,0,2021-04-01,1617231600.0
1454,2,4,2021-04-02,0,0,0,0,2021-04-02,1617318000.0
1455,2,4,2021-04-03,0,0,0,0,2021-04-03,1617404400.0
1456,2,4,2021-04-04,0,0,0,0,2021-04-04,1617490800.0
1457,2,4,2021-04-05,0,0,0,0,2021-04-05,1617577200.0
1458,2,4,2021-04-06,0,0,0,0,2021-04-06,1617663600.0
1459,2,4,2021-04-07,0,0,0,0,2021-04-07,1617750000.0
1460,2,4,2021-04-08,0,0,0,0,2021-04-08,1617836400.0
1461,2,4,2021-04-09,0,0,0,0,2021-04-09,1617922800.0
1462,2,4,2021-04-10,0,0,0,0,2021-04-10,1618009200.0
1463,2,4,2021-04-11,0,0,0,0,2021-04-11,1618095600.0
1464,2,4,2021-04-12,0,0,0,0,2021-04-12,1618185600.0
1465,2,4,2021-04-13,0,0,0,0,2021-04-13,1618272000.0
1466,2,4,2021-04-14,0,0,0,0,2021-04-14,1618358400.0
1467,2,4,2021-04-15,0,0,0,0,2021-04-15,1618444800.0
1468,2,4,2021-04-16,0,0,0,0,2021-04-16,1618531200.0
1469,2,4,2021-04-17,0,0,0,0,2021-04-17,1618617600.0
1470,2,4,2021-04-18,0,0,0,0,2021-04-18,1618704000.0
1471,2,4,2021-04-19,0,0,0,0,2021-04-19,1618790400.0
1472,2,4,2021-04-20,0,0,0,0,2021-04-20,1618876800.0
1473,2,4,2021-04-21,0,0,0,0,2021-04-21,1618963200.0
1474,2,4,2021-04-22,0,0,0,0,2021-04-22,1619049600.0
1475,2,4,2021-04-23,0,0,0,0,2021-04-23,1619136000.0
1476,2,4,2021-04-24,0,0,0,0,2021-04-24,1619222400.0
1477,2,4,2021-04-25,0,0,0,0,2021-04-25,1619308800.0
1478,2,4,2021-04-26,0,0,0,0,2021-04-26,1619395200.0
1479,2,4,2021-04-27,0,0,0,0,2021-04-27,1619481600.0
1480,2,4,2021-04-28,0,0,0,0,2021-04-28,1619568000.0
1481,2,4,2021-04-29,0,0,0,0,2021-04-29,1619654400.0
1482,2,4,2021-04-30,0,0,0,0,2021-04-30,1619740800.0
1483,2,4,2021-05-01,0,0,0,0,2021-05-01,1619827200.0
1484,2,4,2021-05-02,0,0,0,0,2021-05-02,1619913600.0
1485,2,4,2021-05-03,0,0,0,0,2021-05-03,1620000000.0
1486,2,4,2021-05-04,0,0,0,0,2021-05-04,1620086400.0
1487,2,4,2021-05-05,0,0,0,0,2021-05-05,1620172800.0
1488,2,4,2021-05-06,0,0,0,0,2021-05-06,1620259200.0
1489,2,4,2021-05-07,5,0,5,0,2021-05-07,1620345600.0
1490,2,4,2021-05-08,0,0,5,0,2021-05-08,1620432000.0
1491,2,4,2021-05-09,0,0,5,0,2021-05-09,1620518400.0
1492,2,4,2021-05-10,10,0,15,0,2021-05-10,1620604800.0
1493,2,4,2021-05-11,5,0,20,0,2021-05-11,1620691200.0
1494,2,4,2021-05-12,18,0,38,0,2021-05-12,1620777600.0
1495,2,4,2021-05-13,0,0,38,0,2021-05-13,1620864000.0
1496,2,4,2021-05-14,5,0,43,0,2021-05-14,1620950400.0
1497,2,4,2021-05-15,0,0,43,0,2021-05-15,1621036800.0
1498,2,4,2021-05-16,0,0,43,0,2021-05-16,1621123200.0
1499,2,4,2021-05-17,0,0,43,0,2021-05-17,1621206000.0
1500,2,4,2021-05-18,0,0,43,0,2021-05-18,1621292400.0
1501,2,4,2021-05-19,9,0,52,0,2021-05-19,1621378800.0
1502,2,4,2021-05-20,16,0,68,0,2021-05-20,1621465200.0
1503,2,4,2021-05-21,4,0,72,0,2021-05-21,1621551600.0
1504,2,4,2021-05-22,0,0,72,0,2021-05-22,1621638000.0
1505,2,4,2021-05-23,1,0,73,0,2021-05-23,1621724400.0
1506,2,4,2021-05-24,0,0,73,0,2021-05-24,1621810800.0
1507,2,4,2021-05-25,0,0,73,0,2021-05-25,1621897200.0
1508,2,4,2021-05-26,16,0,89,0,2021-05-26,1621983600.0
1509,2,4,2021-05-27,0,0,89,0,2021-05-27,1622070000.0
1510,2,4,2021-05-28,7,0,96,0,2021-05-28,1622156400.0
1511,2,4,2021-05-29,3,0,99,0,2021-05-29,1622242800.0
1512,2,4,2021-05-30,0,0,99,0,2021-05-30,1622329200.0
1513,2,4,2021-05-31,18,0,117,0,2021-05-31,1622415600.0
1514,2,4,2021-06-01,14,0,131,0,2021-06-01,1622502000.0
1515,2,4,2021-06-02,15,0,146,0,2021-06-02,1622588400.0
1516,2,4,2021-06-03,0,0,146,0,2021-06-03,1622674800.0
1517,2,4,2021-06-04,16,0,162,0,2021-06-04,1622761200.0
1518,2,4,2021-06-05,35,0,197,0,2021-06-05,1622847600.0
1519,2,4,2021-06-06,0,0,197,0,2021-06-06,1622934000.0
1520,2,4,2021-06-07,1,0,198,0,2021-06-07,1623020400.0
1521,2,4,2021-06-08,7,0,205,0,2021-06-08,1623106800.0
1522,2,4,2021-06-09,14,0,219,0,2021-06-09,1623193200.0
1523,2,4,2021-06-10,7,0,226,0,2021-06-10,1623279600.0
1524,2,4,2021-06-11,6,0,232,0,2021-06-11,1623366000.0
1525,2,4,2021-06-12,5,0,237,0,2021-06-12,1623452400.0
1526,2,4,2021-06-13,0,0,237,0,2021-06-13,1623538800.0
1527,2,4,2021-06-14,9,0,246,0,2021-06-14,1623625200.0
1528,2,4,2021-06-15,36,0,282,0,2021-06-15,1623711600.0
1529,2,4,2021-06-16,17,0,299,0,2021-06-16,1623798000.0
1530,2,4,2021-06-17,11,0,310,0,2021-06-17,1623884400.0
1531,2,4,2021-06-18,8,0,318,0,2021-06-18,1623970800.0
1532,2,4,2021-06-19,8,0,326,0,2021-06-19,1624057200.0
1533,2,4,2021-06-20,0,0,326,0,2021-06-20,1624143600.0
1534,2,4,2021-06-21,1,0,327,0,2021-06-21,1624230000.0
1535,2,4,2021-06-22,17,0,344,0,2021-06-22,1624316400.0
1536,2,4,2021-06-23,13,0,357,0,2021-06-23,1624402800.0
1537,2,4,2021-06-24,6,0,363,0,2021-06-24,1624489200.0
1538,2,4,2021-06-25,23,0,386,0,2021-06-25,1624575600.0
1539,2,4,2021-06-26,2,0,388,0,2021-06-26,1624662000.0
1540,2,4,2021-06-27,3,0,391,0,2021-06-27,1624748400.0
1541,2,4,2021-06-28,21,0,412,0,2021-06-28,1624834800.0
1542,2,4,2021-06-29,17,0,429,0,2021-06-29,1624921200.0
1543,2,4,2021-06-30,18,0,447,0,2021-06-30,1625007600.0
1544,2,4,2021-07-01,9,0,456,0,2021-07-01,1625094000.0
1545,2,4,2021-07-02,5,0,461,0,2021-07-02,1625180400.0
1546,2,4,2021-07-03,0,0,461,0,2021-07-03,1625266800.0
1547,2,4,2021-07-04,0,0,461,0,2021-07-04,1625353200.0
1548,2,4,2021-07-05,9,0,470,0,2021-07-05,1625439600.0
1549,2,4,2021-07-06,24,0,494,0,2021-07-06,1625526000.0
1550,2,4,2021-07-07,17,0,511,0,2021-07-07,1625612400.0
1551,2,4,2021-07-08,1,0,512,0,2021-07-08,1625698800.0
1552,3,1,2020-12-27,0,0,0,0,2020-12-27,1609023600.0
1553,3,1,2020-12-28,0,0,0,0,2020-12-28,1609110000.0
1554,3,1,2020-12-29,0,0,0,0,2020-12-29,1609196400.0
1555,3,1,2020-12-30,0,0,0,0,2020-12-30,1609282800.0
1556,3,1,2020-12-31,0,0,0,0,2020-12-31,1609369200.0
1557,3,1,2021-01-01,0,0,0,0,2021-01-01,1609455600.0
1558,3,1,2021-01-02,2,0,2,0,2021-01-02,1609542000.0
1559,3,1,2021-01-03,0,0,2,0,2021-01-03,1609628400.0
1560,3,1,2021-01-04,0,0,2,0,2021-01-04,1609714800.0
1561,3,1,2021-01-05,0,0,2,0,2021-01-05,1609801200.0
1562,3,1,2021-01-06,0,0,2,0,2021-01-06,1609887600.0
1563,3,1,2021-01-07,0,0,2,0,2021-01-07,1609974000.0
1564,3,1,2021-01-08,0,0,2,0,2021-01-08,1610060400.0
1565,3,1,2021-01-09,0,0,2,0,2021-01-09,1610146800.0
1566,3,1,2021-01-10,0,0,2,0,2021-01-10,1610233200.0
1567,3,1,2021-01-11,0,0,2,0,2021-01-11,1610319600.0
1568,3,1,2021-01-12,0,0,2,0,2021-01-12,1610406000.0
1569,3,1,2021-01-13,30,0,32,0,2021-01-13,1610492400.0
1570,3,1,2021-01-14,46,0,78,0,2021-01-14,1610578800.0
1571,3,1,2021-01-15,35,0,113,0,2021-01-15,1610665200.0
1572,3,1,2021-01-16,18,0,131,0,2021-01-16,1610751600.0
1573,3,1,2021-01-17,0,0,131,0,2021-01-17,1610838000.0
1574,3,1,2021-01-18,63,0,194,0,2021-01-18,1610924400.0
1575,3,1,2021-01-19,149,0,343,0,2021-01-19,1611010800.0
1576,3,1,2021-01-20,133,0,476,0,2021-01-20,1611097200.0
1577,3,1,2021-01-21,118,0,594,0,2021-01-21,1611183600.0
1578,3,1,2021-01-22,76,0,670,0,2021-01-22,1611270000.0
1579,3,1,2021-01-23,0,0,670,0,2021-01-23,1611356400.0
1580,3,1,2021-01-24,0,0,670,0,2021-01-24,1611442800.0
1581,3,1,2021-01-25,56,0,726,0,2021-01-25,1611529200.0
1582,3,1,2021-01-26,100,0,826,0,2021-01-26,1611615600.0
1583,3,1,2021-01-27,109,0,935,0,2021-01-27,1611702000.0
1584,3,1,2021-01-28,96,2,1031,2,2021-01-28,1611788400.0
1585,3,1,2021-01-29,104,2,1135,4,2021-01-29,1611874800.0
1586,3,1,2021-01-30,0,0,1135,4,2021-01-30,1611961200.0
1587,3,1,2021-01-31,0,0,1135,4,2021-01-31,1612047600.0
1588,3,1,2021-02-01,54,0,1189,4,2021-02-01,1612134000.0
1589,3,1,2021-02-02,122,4,1311,8,2021-02-02,1612220400.0
1590,3,1,2021-02-03,116,7,1427,15,2021-02-03,1612306800.0
1591,3,1,2021-02-04,79,26,1506,41,2021-02-04,1612393200.0
1592,3,1,2021-02-05,65,7,1571,48,2021-02-05,1612479600.0
1593,3,1,2021-02-06,0,0,1571,48,2021-02-06,1612566000.0
1594,3,1,2021-02-07,0,0,1571,48,2021-02-07,1612652400.0
1595,3,1,2021-02-08,51,13,1622,61,2021-02-08,1612738800.0
1596,3,1,2021-02-09,92,38,1714,99,2021-02-09,1612825200.0
1597,3,1,2021-02-10,101,41,1815,140,2021-02-10,1612911600.0
1598,3,1,2021-02-11,105,93,1920,233,2021-02-11,1612998000.0
1599,3,1,2021-02-12,87,62,2007,295,2021-02-12,1613084400.0
1600,3,1,2021-02-13,0,0,2007,295,2021-02-13,1613170800.0
1601,3,1,2021-02-14,0,0,2007,295,2021-02-14,1613257200.0
1602,3,1,2021-02-15,27,65,2034,360,2021-02-15,1613343600.0
1603,3,1,2021-02-16,123,51,2157,411,2021-02-16,1613430000.0
1604,3,1,2021-02-17,145,115,2302,526,2021-02-17,1613516400.0
1605,3,1,2021-02-18,103,141,2405,667,2021-02-18,1613602800.0
1606,3,1,2021-02-19,122,72,2527,739,2021-02-19,1613689200.0
1607,3,1,2021-02-20,0,0,2527,739,2021-02-20,1613775600.0
1608,3,1,2021-02-21,0,0,2527,739,2021-02-21,1613862000.0
1609,3,1,2021-02-22,78,48,2605,787,2021-02-22,1613948400.0
1610,3,1,2021-02-23,158,98,2763,885,2021-02-23,1614034800.0
1611,3,1,2021-02-24,190,119,2953,1004,2021-02-24,1614121200.0
1612,3,1,2021-02-25,258,86,3211,1090,2021-02-25,1614207600.0
1613,3,1,2021-02-26,264,67,3475,1157,2021-02-26,1614294000.0
1614,3,1,2021-02-27,121,1,3596,1158,2021-02-27,1614380400.0
1615,3,1,2021-02-28,0,0,3596,1158,2021-02-28,1614466800.0
1616,3,1,2021-03-01,179,84,3775,1242,2021-03-01,1614553200.0
1617,3,1,2021-03-02,255,106,4030,1348,2021-03-02,1614639600.0
1618,3,1,2021-03-03,255,124,4285,1472,2021-03-03,1614726000.0
1619,3,1,2021-03-04,281,75,4566,1547,2021-03-04,1614812400.0
1620,3,1,2021-03-05,272,40,4838,1587,2021-03-05,1614898800.0
1621,3,1,2021-03-06,117,0,4955,1587,2021-03-06,1614985200.0
1622,3,1,2021-03-07,0,0,4955,1587,2021-03-07,1615071600.0
1623,3,1,2021-03-08,186,37,5141,1624,2021-03-08,1615158000.0
1624,3,1,2021-03-09,350,86,5491,1710,2021-03-09,1615244400.0
1625,3,1,2021-03-10,357,95,5848,1805,2021-03-10,1615330800.0
1626,3,1,2021-03-11,270,114,6118,1919,2021-03-11,1615417200.0
1627,3,1,2021-03-12,287,90,6405,2009,2021-03-12,1615503600.0
1628,3,1,2021-03-13,110,2,6515,2011,2021-03-13,1615590000.0
1629,3,1,2021-03-14,0,0,6515,2011,2021-03-14,1615676400.0
1630,3,1,2021-03-15,180,23,6695,2034,2021-03-15,1615762800.0
1631,3,1,2021-03-16,241,135,6936,2169,2021-03-16,1615849200.0
1632,3,1,2021-03-17,273,121,7209,2290,2021-03-17,1615935600.0
1633,3,1,2021-03-18,249,145,7458,2435,2021-03-18,1616022000.0
1634,3,1,2021-03-19,284,110,7742,2545,2021-03-19,1616108400.0
1635,3,1,2021-03-20,255,12,7997,2557,2021-03-20,1616194800.0
1636,3,1,2021-03-21,119,0,8116,2557,2021-03-21,1616281200.0
1637,3,1,2021-03-22,219,102,8335,2659,2021-03-22,1616367600.0
1638,3,1,2021-03-23,274,177,8609,2836,2021-03-23,1616454000.0
1639,3,1,2021-03-24,234,195,8843,3031,2021-03-24,1616540400.0
1640,3,1,2021-03-25,167,169,9010,3200,2021-03-25,1616626800.0
1641,3,1,2021-03-26,188,294,9198,3494,2021-03-26,1616713200.0
1642,3,1,2021-03-27,56,88,9254,3582,2021-03-27,1616799600.0
1643,3,1,2021-03-28,0,0,9254,3582,2021-03-28,1616886000.0
1644,3,1,2021-03-29,175,232,9429,3814,2021-03-29,1616972400.0
1645,3,1,2021-03-30,445,212,9874,4026,2021-03-30,1617058800.0
1646,3,1,2021-03-31,318,270,10192,4296,2021-03-31,1617145200.0
1647,3,1,2021-04-01,444,239,10636,4535,2021-04-01,1617231600.0
1648,3,1,2021-04-02,306,265,10942,4800,2021-04-02,1617318000.0
1649,3,1,2021-04-03,152,113,11094,4913,2021-04-03,1617404400.0
1650,3,1,2021-04-04,0,0,11094,4913,2021-04-04,1617490800.0
1651,3,1,2021-04-05,118,8,11212,4921,2021-04-05,1617577200.0
1652,3,1,2021-04-06,438,302,11650,5223,2021-04-06,1617663600.0
1653,3,1,2021-04-07,501,316,12151,5539,2021-04-07,1617750000.0
1654,3,1,2021-04-08,510,233,12661,5772,2021-04-08,1617836400.0
1655,3,1,2021-04-09,496,206,13157,5978,2021-04-09,1617922800.0
1656,3,1,2021-04-10,146,86,13303,6064,2021-04-10,1618009200.0
1657,3,1,2021-04-11,1,0,13304,6064,2021-04-11,1618095600.0
1658,3,1,2021-04-12,552,237,13856,6301,2021-04-12,1618185600.0
1659,3,1,2021-04-13,672,204,14528,6505,2021-04-13,1618272000.0
1660,3,1,2021-04-14,720,256,15248,6761,2021-04-14,1618358400.0
1661,3,1,2021-04-15,774,201,16022,6962,2021-04-15,1618444800.0
1662,3,1,2021-04-16,755,245,16777,7207,2021-04-16,1618531200.0
1663,3,1,2021-04-17,499,98,17276,7305,2021-04-17,1618617600.0
1664,3,1,2021-04-18,499,8,17775,7313,2021-04-18,1618704000.0
1665,3,1,2021-04-19,713,195,18488,7508,2021-04-19,1618790400.0
1666,3,1,2021-04-20,604,235,19092,7743,2021-04-20,1618876800.0
1667,3,1,2021-04-21,866,165,19958,7908,2021-04-21,1618963200.0
1668,3,1,2021-04-22,723,173,20681,8081,2021-04-22,1619049600.0
1669,3,1,2021-04-23,705,173,21386,8254,2021-04-23,1619136000.0
1670,3,1,2021-04-24,525,57,21911,8311,2021-04-24,1619222400.0
1671,3,1,2021-04-25,612,4,22523,8315,2021-04-25,1619308800.0
1672,3,1,2021-04-26,777,170,23300,8485,2021-04-26,1619395200.0
1673,3,1,2021-04-27,784,244,24084,8729,2021-04-27,1619481600.0
1674,3,1,2021-04-28,694,258,24778,8987,2021-04-28,1619568000.0
1675,3,1,2021-04-29,621,233,25399,9220,2021-04-29,1619654400.0
1676,3,1,2021-04-30,673,214,26072,9434,2021-04-30,1619740800.0
1677,3,1,2021-05-01,210,6,26282,9440,2021-05-01,1619827200.0
1678,3,1,2021-05-02,602,28,26884,9468,2021-05-02,1619913600.0
1679,3,1,2021-05-03,553,343,27437,9811,2021-05-03,1620000000.0
1680,3,1,2021-05-04,617,279,28054,10090,2021-05-04,1620086400.0
1681,3,1,2021-05-05,657,408,28711,10498,2021-05-05,1620172800.0
1682,3,1,2021-05-06,650,419,29361,10917,2021-05-06,1620259200.0
1683,3,1,2021-05-07,547,419,29908,11336,2021-05-07,1620345600.0
1684,3,1,2021-05-08,341,43,30249,11379,2021-05-08,1620432000.0
1685,3,1,2021-05-09,262,58,30511,11437,2021-05-09,1620518400.0
1686,3,1,2021-05-10,419,579,30930,12016,2021-05-10,1620604800.0
1687,3,1,2021-05-11,392,460,31322,12476,2021-05-11,1620691200.0
1688,3,1,2021-05-12,503,592,31825,13068,2021-05-12,1620777600.0
1689,3,1,2021-05-13,333,62,32158,13130,2021-05-13,1620864000.0
1690,3,1,2021-05-14,474,505,32632,13635,2021-05-14,1620950400.0
1691,3,1,2021-05-15,255,325,32887,13960,2021-05-15,1621036800.0
1692,3,1,2021-05-16,207,200,33094,14160,2021-05-16,1621123200.0
1693,3,1,2021-05-17,444,546,33538,14706,2021-05-17,1621206000.0
1694,3,1,2021-05-18,559,504,34097,15210,2021-05-18,1621292400.0
1695,3,1,2021-05-19,525,507,34622,15717,2021-05-19,1621378800.0
1696,3,1,2021-05-20,636,396,35258,16113,2021-05-20,1621465200.0
1697,3,1,2021-05-21,494,573,35752,16686,2021-05-21,1621551600.0
1698,3,1,2021-05-22,168,486,35920,17172,2021-05-22,1621638000.0
1699,3,1,2021-05-23,269,454,36189,17626,2021-05-23,1621724400.0
1700,3,1,2021-05-24,560,209,36749,17835,2021-05-24,1621810800.0
1701,3,1,2021-05-25,495,681,37244,18516,2021-05-25,1621897200.0
1702,3,1,2021-05-26,435,655,37679,19171,2021-05-26,1621983600.0
1703,3,1,2021-05-27,694,451,38373,19622,2021-05-27,1622070000.0
1704,3,1,2021-05-28,551,517,38924,20139,2021-05-28,1622156400.0
1705,3,1,2021-05-29,239,341,39163,20480,2021-05-29,1622242800.0
1706,3,1,2021-05-30,151,394,39314,20874,2021-05-30,1622329200.0
1707,3,1,2021-05-31,341,550,39655,21424,2021-05-31,1622415600.0
1708,3,1,2021-06-01,394,416,40049,21840,2021-06-01,1622502000.0
1709,3,1,2021-06-02,525,518,40574,22358,2021-06-02,1622588400.0
1710,3,1,2021-06-03,482,424,41056,22782,2021-06-03,1622674800.0
1711,3,1,2021-06-04,550,450,41606,23232,2021-06-04,1622761200.0
1712,3,1,2021-06-05,272,270,41878,23502,2021-06-05,1622847600.0
1713,3,1,2021-06-06,211,285,42089,23787,2021-06-06,1622934000.0
1714,3,1,2021-06-07,465,407,42554,24194,2021-06-07,1623020400.0
1715,3,1,2021-06-08,521,271,43075,24465,2021-06-08,1623106800.0
1716,3,1,2021-06-09,498,339,43573,24804,2021-06-09,1623193200.0
1717,3,1,2021-06-10,346,251,43919,25055,2021-06-10,1623279600.0
1718,3,1,2021-06-11,408,434,44327,25489,2021-06-11,1623366000.0
1719,3,1,2021-06-12,166,269,44493,25758,2021-06-12,1623452400.0
1720,3,1,2021-06-13,200,247,44693,26005,2021-06-13,1623538800.0
1721,3,1,2021-06-14,352,519,45045,26524,2021-06-14,1623625200.0
1722,3,1,2021-06-15,355,405,45400,26929,2021-06-15,1623711600.0
1723,3,1,2021-06-16,394,407,45794,27336,2021-06-16,1623798000.0
1724,3,1,2021-06-17,365,539,46159,27875,2021-06-17,1623884400.0
1725,3,1,2021-06-18,339,536,46498,28411,2021-06-18,1623970800.0
1726,3,1,2021-06-19,230,237,46728,28648,2021-06-19,1624057200.0
1727,3,1,2021-06-20,123,263,46851,28911,2021-06-20,1624143600.0
1728,3,1,2021-06-21,264,556,47115,29467,2021-06-21,1624230000.0
1729,3,1,2021-06-22,306,427,47421,29894,2021-06-22,1624316400.0
1730,3,1,2021-06-23,277,494,47698,30388,2021-06-23,1624402800.0
1731,3,1,2021-06-24,387,460,48085,30848,2021-06-24,1624489200.0
1732,3,1,2021-06-25,377,505,48462,31353,2021-06-25,1624575600.0
1733,3,1,2021-06-26,164,309,48626,31662,2021-06-26,1624662000.0
1734,3,1,2021-06-27,117,161,48743,31823,2021-06-27,1624748400.0
1735,3,1,2021-06-28,281,551,49024,32374,2021-06-28,1624834800.0
1736,3,1,2021-06-29,325,463,49349,32837,2021-06-29,1624921200.0
1737,3,1,2021-06-30,306,627,49655,33464,2021-06-30,1625007600.0
1738,3,1,2021-07-01,319,368,49974,33832,2021-07-01,1625094000.0
1739,3,1,2021-07-02,388,471,50362,34303,2021-07-02,1625180400.0
1740,3,1,2021-07-03,203,244,50565,34547,2021-07-03,1625266800.0
1741,3,1,2021-07-04,85,226,50650,34773,2021-07-04,1625353200.0
1742,3,1,2021-07-05,291,505,50941,35278,2021-07-05,1625439600.0
1743,3,1,2021-07-06,292,423,51233,35701,2021-07-06,1625526000.0
1744,3,1,2021-07-07,305,364,51538,36065,2021-07-07,1625612400.0
1745,3,1,2021-07-08,254,294,51792,36359,2021-07-08,1625698800.0
1746,3,2,2020-12-27,0,0,0,0,2020-12-27,1609023600.0
1747,3,2,2020-12-28,0,0,0,0,2020-12-28,1609110000.0
1748,3,2,2020-12-29,0,0,0,0,2020-12-29,1609196400.0
1749,3,2,2020-12-30,0,0,0,0,2020-12-30,1609282800.0
1750,3,2,2020-12-31,0,0,0,0,2020-12-31,1609369200.0
1751,3,2,2021-01-01,0,0,0,0,2021-01-01,1609455600.0
1752,3,2,2021-01-02,0,0,0,0,2021-01-02,1609542000.0
1753,3,2,2021-01-03,0,0,0,0,2021-01-03,1609628400.0
1754,3,2,2021-01-04,0,0,0,0,2021-01-04,1609714800.0
1755,3,2,2021-01-05,0,0,0,0,2021-01-05,1609801200.0
1756,3,2,2021-01-06,0,0,0,0,2021-01-06,1609887600.0
1757,3,2,2021-01-07,0,0,0,0,2021-01-07,1609974000.0
1758,3,2,2021-01-08,0,0,0,0,2021-01-08,1610060400.0
1759,3,2,2021-01-09,0,0,0,0,2021-01-09,1610146800.0
1760,3,2,2021-01-10,0,0,0,0,2021-01-10,1610233200.0
1761,3,2,2021-01-11,0,0,0,0,2021-01-11,1610319600.0
1762,3,2,2021-01-12,0,0,0,0,2021-01-12,1610406000.0
1763,3,2,2021-01-13,0,0,0,0,2021-01-13,1610492400.0
1764,3,2,2021-01-14,0,0,0,0,2021-01-14,1610578800.0
1765,3,2,2021-01-15,0,0,0,0,2021-01-15,1610665200.0
1766,3,2,2021-01-16,0,0,0,0,2021-01-16,1610751600.0
1767,3,2,2021-01-17,0,0,0,0,2021-01-17,1610838000.0
1768,3,2,2021-01-18,0,0,0,0,2021-01-18,1610924400.0
1769,3,2,2021-01-19,0,0,0,0,2021-01-19,1611010800.0
1770,3,2,2021-01-20,0,0,0,0,2021-01-20,1611097200.0
1771,3,2,2021-01-21,0,0,0,0,2021-01-21,1611183600.0
1772,3,2,2021-01-22,0,0,0,0,2021-01-22,1611270000.0
1773,3,2,2021-01-23,0,0,0,0,2021-01-23,1611356400.0
1774,3,2,2021-01-24,0,0,0,0,2021-01-24,1611442800.0
1775,3,2,2021-01-25,0,0,0,0,2021-01-25,1611529200.0
1776,3,2,2021-01-26,0,0,0,0,2021-01-26,1611615600.0
1777,3,2,2021-01-27,0,0,0,0,2021-01-27,1611702000.0
1778,3,2,2021-01-28,0,0,0,0,2021-01-28,1611788400.0
1779,3,2,2021-01-29,0,0,0,0,2021-01-29,1611874800.0
1780,3,2,2021-01-30,0,0,0,0,2021-01-30,1611961200.0
1781,3,2,2021-01-31,0,0,0,0,2021-01-31,1612047600.0
1782,3,2,2021-02-01,0,0,0,0,2021-02-01,1612134000.0
1783,3,2,2021-02-02,0,0,0,0,2021-02-02,1612220400.0
1784,3,2,2021-02-03,0,0,0,0,2021-02-03,1612306800.0
1785,3,2,2021-02-04,0,0,0,0,2021-02-04,1612393200.0
1786,3,2,2021-02-05,0,0,0,0,2021-02-05,1612479600.0
1787,3,2,2021-02-06,0,0,0,0,2021-02-06,1612566000.0
1788,3,2,2021-02-07,0,0,0,0,2021-02-07,1612652400.0
1789,3,2,2021-02-08,1,0,1,0,2021-02-08,1612738800.0
1790,3,2,2021-02-09,0,0,1,0,2021-02-09,1612825200.0
1791,3,2,2021-02-10,0,0,1,0,2021-02-10,1612911600.0
1792,3,2,2021-02-11,0,0,1,0,2021-02-11,1612998000.0
1793,3,2,2021-02-12,0,0,1,0,2021-02-12,1613084400.0
1794,3,2,2021-02-13,0,0,1,0,2021-02-13,1613170800.0
1795,3,2,2021-02-14,0,0,1,0,2021-02-14,1613257200.0
1796,3,2,2021-02-15,0,0,1,0,2021-02-15,1613343600.0
1797,3,2,2021-02-16,0,0,1,0,2021-02-16,1613430000.0
1798,3,2,2021-02-17,0,0,1,0,2021-02-17,1613516400.0
1799,3,2,2021-02-18,0,0,1,0,2021-02-18,1613602800.0
1800,3,2,2021-02-19,0,0,1,0,2021-02-19,1613689200.0
1801,3,2,2021-02-20,0,0,1,0,2021-02-20,1613775600.0
1802,3,2,2021-02-21,0,0,1,0,2021-02-21,1613862000.0
1803,3,2,2021-02-22,0,0,1,0,2021-02-22,1613948400.0
1804,3,2,2021-02-23,0,0,1,0,2021-02-23,1614034800.0
1805,3,2,2021-02-24,0,0,1,0,2021-02-24,1614121200.0
1806,3,2,2021-02-25,0,0,1,0,2021-02-25,1614207600.0
1807,3,2,2021-02-26,0,0,1,0,2021-02-26,1614294000.0
1808,3,2,2021-02-27,0,0,1,0,2021-02-27,1614380400.0
1809,3,2,2021-02-28,0,0,1,0,2021-02-28,1614466800.0
1810,3,2,2021-03-01,0,0,1,0,2021-03-01,1614553200.0
1811,3,2,2021-03-02,0,0,1,0,2021-03-02,1614639600.0
1812,3,2,2021-03-03,0,0,1,0,2021-03-03,1614726000.0
1813,3,2,2021-03-04,0,0,1,0,2021-03-04,1614812400.0
1814,3,2,2021-03-05,0,0,1,0,2021-03-05,1614898800.0
1815,3,2,2021-03-06,0,0,1,0,2021-03-06,1614985200.0
1816,3,2,2021-03-07,0,0,1,0,2021-03-07,1615071600.0
1817,3,2,2021-03-08,0,0,1,0,2021-03-08,1615158000.0
1818,3,2,2021-03-09,0,0,1,0,2021-03-09,1615244400.0
1819,3,2,2021-03-10,0,0,1,0,2021-03-10,1615330800.0
1820,3,2,2021-03-11,0,0,1,0,2021-03-11,1615417200.0
1821,3,2,2021-03-12,0,0,1,0,2021-03-12,1615503600.0
1822,3,2,2021-03-13,0,0,1,0,2021-03-13,1615590000.0
1823,3,2,2021-03-14,0,0,1,0,2021-03-14,1615676400.0
1824,3,2,2021-03-15,0,0,1,0,2021-03-15,1615762800.0
1825,3,2,2021-03-16,0,0,1,0,2021-03-16,1615849200.0
1826,3,2,2021-03-17,0,0,1,0,2021-03-17,1615935600.0
1827,3,2,2021-03-18,0,0,1,0,2021-03-18,1616022000.0
1828,3,2,2021-03-19,0,0,1,0,2021-03-19,1616108400.0
1829,3,2,2021-03-20,0,0,1,0,2021-03-20,1616194800.0
1830,3,2,2021-03-21,0,0,1,0,2021-03-21,1616281200.0
1831,3,2,2021-03-22,0,0,1,0,2021-03-22,1616367600.0
1832,3,2,2021-03-23,0,0,1,0,2021-03-23,1616454000.0
1833,3,2,2021-03-24,0,0,1,0,2021-03-24,1616540400.0
1834,3,2,2021-03-25,0,0,1,0,2021-03-25,1616626800.0
1835,3,2,2021-03-26,0,0,1,0,2021-03-26,1616713200.0
1836,3,2,2021-03-27,0,0,1,0,2021-03-27,1616799600.0
1837,3,2,2021-03-28,0,0,1,0,2021-03-28,1616886000.0
1838,3,2,2021-03-29,0,0,1,0,2021-03-29,1616972400.0
1839,3,2,2021-03-30,0,0,1,0,2021-03-30,1617058800.0
1840,3,2,2021-03-31,0,0,1,0,2021-03-31,1617145200.0
1841,3,2,2021-04-01,0,0,1,0,2021-04-01,1617231600.0
1842,3,2,2021-04-02,0,0,1,0,2021-04-02,1617318000.0
1843,3,2,2021-04-03,0,0,1,0,2021-04-03,1617404400.0
1844,3,2,2021-04-04,0,0,1,0,2021-04-04,1617490800.0
1845,3,2,2021-04-05,0,0,1,0,2021-04-05,1617577200.0
1846,3,2,2021-04-06,0,0,1,0,2021-04-06,1617663600.0
1847,3,2,2021-04-07,0,0,1,0,2021-04-07,1617750000.0
1848,3,2,2021-04-08,0,0,1,0,2021-04-08,1617836400.0
1849,3,2,2021-04-09,0,0,1,0,2021-04-09,1617922800.0
1850,3,2,2021-04-10,0,0,1,0,2021-04-10,1618009200.0
1851,3,2,2021-04-11,0,0,1,0,2021-04-11,1618095600.0
1852,3,2,2021-04-12,0,0,1,0,2021-04-12,1618185600.0
1853,3,2,2021-04-13,0,0,1,0,2021-04-13,1618272000.0
1854,3,2,2021-04-14,0,0,1,0,2021-04-14,1618358400.0
1855,3,2,2021-04-15,0,0,1,0,2021-04-15,1618444800.0
1856,3,2,2021-04-16,0,0,1,0,2021-04-16,1618531200.0
1857,3,2,2021-04-17,0,0,1,0,2021-04-17,1618617600.0
1858,3,2,2021-04-18,0,0,1,0,2021-04-18,1618704000.0
1859,3,2,2021-04-19,0,0,1,0,2021-04-19,1618790400.0
1860,3,2,2021-04-20,0,0,1,0,2021-04-20,1618876800.0
1861,3,2,2021-04-21,0,0,1,0,2021-04-21,1618963200.0
1862,3,2,2021-04-22,0,0,1,0,2021-04-22,1619049600.0
1863,3,2,2021-04-23,0,0,1,0,2021-04-23,1619136000.0
1864,3,2,2021-04-24,0,0,1,0,2021-04-24,1619222400.0
1865,3,2,2021-04-25,0,0,1,0,2021-04-25,1619308800.0
1866,3,2,2021-04-26,0,0,1,0,2021-04-26,1619395200.0
1867,3,2,2021-04-27,0,0,1,0,2021-04-27,1619481600.0
1868,3,2,2021-04-28,0,0,1,0,2021-04-28,1619568000.0
1869,3,2,2021-04-29,0,0,1,0,2021-04-29,1619654400.0
1870,3,2,2021-04-30,0,0,1,0,2021-04-30,1619740800.0
1871,3,2,2021-05-01,0,0,1,0,2021-05-01,1619827200.0
1872,3,2,2021-05-02,0,0,1,0,2021-05-02,1619913600.0
1873,3,2,2021-05-03,0,0,1,0,2021-05-03,1620000000.0
1874,3,2,2021-05-04,0,0,1,0,2021-05-04,1620086400.0
1875,3,2,2021-05-05,0,0,1,0,2021-05-05,1620172800.0
1876,3,2,2021-05-06,0,0,1,0,2021-05-06,1620259200.0
1877,3,2,2021-05-07,0,0,1,0,2021-05-07,1620345600.0
1878,3,2,2021-05-08,0,0,1,0,2021-05-08,1620432000.0
1879,3,2,2021-05-09,0,0,1,0,2021-05-09,1620518400.0
1880,3,2,2021-05-10,0,0,1,0,2021-05-10,1620604800.0
1881,3,2,2021-05-11,0,0,1,0,2021-05-11,1620691200.0
1882,3,2,2021-05-12,0,0,1,0,2021-05-12,1620777600.0
1883,3,2,2021-05-13,0,0,1,0,2021-05-13,1620864000.0
1884,3,2,2021-05-14,0,0,1,0,2021-05-14,1620950400.0
1885,3,2,2021-05-15,0,0,1,0,2021-05-15,1621036800.0
1886,3,2,2021-05-16,0,0,1,0,2021-05-16,1621123200.0
1887,3,2,2021-05-17,0,0,1,0,2021-05-17,1621206000.0
1888,3,2,2021-05-18,0,0,1,0,2021-05-18,1621292400.0
1889,3,2,2021-05-19,0,0,1,0,2021-05-19,1621378800.0
1890,3,2,2021-05-20,0,0,1,0,2021-05-20,1621465200.0
1891,3,2,2021-05-21,0,0,1,0,2021-05-21,1621551600.0
1892,3,2,2021-05-22,0,0,1,0,2021-05-22,1621638000.0
1893,3,2,2021-05-23,0,0,1,0,2021-05-23,1621724400.0
1894,3,2,2021-05-24,0,0,1,0,2021-05-24,1621810800.0
1895,3,2,2021-05-25,0,0,1,0,2021-05-25,1621897200.0
1896,3,2,2021-05-26,0,0,1,0,2021-05-26,1621983600.0
1897,3,2,2021-05-27,0,0,1,0,2021-05-27,1622070000.0
1898,3,2,2021-05-28,0,0,1,0,2021-05-28,1622156400.0
1899,3,2,2021-05-29,0,0,1,0,2021-05-29,1622242800.0
1900,3,2,2021-05-30,0,0,1,0,2021-05-30,1622329200.0
1901,3,2,2021-05-31,0,0,1,0,2021-05-31,1622415600.0
1902,3,2,2021-06-01,0,0,1,0,2021-06-01,1622502000.0
1903,3,2,2021-06-02,0,0,1,0,2021-06-02,1622588400.0
1904,3,2,2021-06-03,0,0,1,0,2021-06-03,1622674800.0
1905,3,2,2021-06-04,0,0,1,0,2021-06-04,1622761200.0
1906,3,2,2021-06-05,0,0,1,0,2021-06-05,1622847600.0
1907,3,2,2021-06-06,0,0,1,0,2021-06-06,1622934000.0
1908,3,2,2021-06-07,0,0,1,0,2021-06-07,1623020400.0
1909,3,2,2021-06-08,0,0,1,0,2021-06-08,1623106800.0
1910,3,2,2021-06-09,0,0,1,0,2021-06-09,1623193200.0
1911,3,2,2021-06-10,0,0,1,0,2021-06-10,1623279600.0
1912,3,2,2021-06-11,0,0,1,0,2021-06-11,1623366000.0
1913,3,2,2021-06-12,0,0,1,0,2021-06-12,1623452400.0
1914,3,2,2021-06-13,0,0,1,0,2021-06-13,1623538800.0
1915,3,2,2021-06-14,0,0,1,0,2021-06-14,1623625200.0
1916,3,2,2021-06-15,0,0,1,0,2021-06-15,1623711600.0
1917,3,2,2021-06-16,0,0,1,0,2021-06-16,1623798000.0
1918,3,2,2021-06-17,0,0,1,0,2021-06-17,1623884400.0
1919,3,2,2021-06-18,0,0,1,0,2021-06-18,1623970800.0
1920,3,2,2021-06-19,0,0,1,0,2021-06-19,1624057200.0
1921,3,2,2021-06-20,0,0,1,0,2021-06-20,1624143600.0
1922,3,2,2021-06-21,0,0,1,0,2021-06-21,1624230000.0
1923,3,2,2021-06-22,0,0,1,0,2021-06-22,1624316400.0
1924,3,2,2021-06-23,0,0,1,0,2021-06-23,1624402800.0
1925,3,2,2021-06-24,0,0,1,0,2021-06-24,1624489200.0
1926,3,2,2021-06-25,0,0,1,0,2021-06-25,1624575600.0
1927,3,2,2021-06-26,0,0,1,0,2021-06-26,1624662000.0
1928,3,2,2021-06-27,0,0,1,0,2021-06-27,1624748400.0
1929,3,2,2021-06-28,0,0,1,0,2021-06-28,1624834800.0
1930,3,2,2021-06-29,0,0,1,0,2021-06-29,1624921200.0
1931,3,2,2021-06-30,0,1,1,1,2021-06-30,1625007600.0
1932,3,2,2021-07-01,0,0,1,1,2021-07-01,1625094000.0
1933,3,2,2021-07-02,0,0,1,1,2021-07-02,1625180400.0
1934,3,2,2021-07-03,0,0,1,1,2021-07-03,1625266800.0
1935,3,2,2021-07-04,0,0,1,1,2021-07-04,1625353200.0
1936,3,2,2021-07-05,0,0,1,1,2021-07-05,1625439600.0
1937,3,2,2021-07-06,0,0,1,1,2021-07-06,1625526000.0
1938,3,2,2021-07-07,0,0,1,1,2021-07-07,1625612400.0
1939,3,2,2021-07-08,0,0,1,1,2021-07-08,1625698800.0
1940,3,3,2020-12-27,0,0,0,0,2020-12-27,1609023600.0
1941,3,3,2020-12-28,0,0,0,0,2020-12-28,1609110000.0
1942,3,3,2020-12-29,0,0,0,0,2020-12-29,1609196400.0
1943,3,3,2020-12-30,0,0,0,0,2020-12-30,1609282800.0
1944,3,3,2020-12-31,0,0,0,0,2020-12-31,1609369200.0
1945,3,3,2021-01-01,0,0,0,0,2021-01-01,1609455600.0
1946,3,3,2021-01-02,0,0,0,0,2021-01-02,1609542000.0
1947,3,3,2021-01-03,0,0,0,0,2021-01-03,1609628400.0
1948,3,3,2021-01-04,0,0,0,0,2021-01-04,1609714800.0
1949,3,3,2021-01-05,0,0,0,0,2021-01-05,1609801200.0
1950,3,3,2021-01-06,0,0,0,0,2021-01-06,1609887600.0
1951,3,3,2021-01-07,0,0,0,0,2021-01-07,1609974000.0
1952,3,3,2021-01-08,0,0,0,0,2021-01-08,1610060400.0
1953,3,3,2021-01-09,0,0,0,0,2021-01-09,1610146800.0
1954,3,3,2021-01-10,0,0,0,0,2021-01-10,1610233200.0
1955,3,3,2021-01-11,0,0,0,0,2021-01-11,1610319600.0
1956,3,3,2021-01-12,0,0,0,0,2021-01-12,1610406000.0
1957,3,3,2021-01-13,0,0,0,0,2021-01-13,1610492400.0
1958,3,3,2021-01-14,0,0,0,0,2021-01-14,1610578800.0
1959,3,3,2021-01-15,0,0,0,0,2021-01-15,1610665200.0
1960,3,3,2021-01-16,0,0,0,0,2021-01-16,1610751600.0
1961,3,3,2021-01-17,0,0,0,0,2021-01-17,1610838000.0
1962,3,3,2021-01-18,0,0,0,0,2021-01-18,1610924400.0
1963,3,3,2021-01-19,0,0,0,0,2021-01-19,1611010800.0
1964,3,3,2021-01-20,0,0,0,0,2021-01-20,1611097200.0
1965,3,3,2021-01-21,0,0,0,0,2021-01-21,1611183600.0
1966,3,3,2021-01-22,0,0,0,0,2021-01-22,1611270000.0
1967,3,3,2021-01-23,0,0,0,0,2021-01-23,1611356400.0
1968,3,3,2021-01-24,0,0,0,0,2021-01-24,1611442800.0
1969,3,3,2021-01-25,0,0,0,0,2021-01-25,1611529200.0
1970,3,3,2021-01-26,0,0,0,0,2021-01-26,1611615600.0
1971,3,3,2021-01-27,0,0,0,0,2021-01-27,1611702000.0
1972,3,3,2021-01-28,0,0,0,0,2021-01-28,1611788400.0
1973,3,3,2021-01-29,0,0,0,0,2021-01-29,1611874800.0
1974,3,3,2021-01-30,0,0,0,0,2021-01-30,1611961200.0
1975,3,3,2021-01-31,0,0,0,0,2021-01-31,1612047600.0
1976,3,3,2021-02-01,0,0,0,0,2021-02-01,1612134000.0
1977,3,3,2021-02-02,0,0,0,0,2021-02-02,1612220400.0
1978,3,3,2021-02-03,0,0,0,0,2021-02-03,1612306800.0
1979,3,3,2021-02-04,0,0,0,0,2021-02-04,1612393200.0
1980,3,3,2021-02-05,0,0,0,0,2021-02-05,1612479600.0
1981,3,3,2021-02-06,0,0,0,0,2021-02-06,1612566000.0
1982,3,3,2021-02-07,0,0,0,0,2021-02-07,1612652400.0
1983,3,3,2021-02-08,0,0,0,0,2021-02-08,1612738800.0
1984,3,3,2021-02-09,0,0,0,0,2021-02-09,1612825200.0
1985,3,3,2021-02-10,0,0,0,0,2021-02-10,1612911600.0
1986,3,3,2021-02-11,0,0,0,0,2021-02-11,1612998000.0
1987,3,3,2021-02-12,0,0,0,0,2021-02-12,1613084400.0
1988,3,3,2021-02-13,0,0,0,0,2021-02-13,1613170800.0
1989,3,3,2021-02-14,0,0,0,0,2021-02-14,1613257200.0
1990,3,3,2021-02-15,0,0,0,0,2021-02-15,1613343600.0
1991,3,3,2021-02-16,0,0,0,0,2021-02-16,1613430000.0
1992,3,3,2021-02-17,0,0,0,0,2021-02-17,1613516400.0
1993,3,3,2021-02-18,0,0,0,0,2021-02-18,1613602800.0
1994,3,3,2021-02-19,0,0,0,0,2021-02-19,1613689200.0
1995,3,3,2021-02-20,0,0,0,0,2021-02-20,1613775600.0
1996,3,3,2021-02-21,0,0,0,0,2021-02-21,1613862000.0
1997,3,3,2021-02-22,0,0,0,0,2021-02-22,1613948400.0
1998,3,3,2021-02-23,0,0,0,0,2021-02-23,1614034800.0
1999,3,3,2021-02-24,0,0,0,0,2021-02-24,1614121200.0
2000,3,3,2021-02-25,0,0,0,0,2021-02-25,1614207600.0
2001,3,3,2021-02-26,0,0,0,0,2021-02-26,1614294000.0
2002,3,3,2021-02-27,0,0,0,0,2021-02-27,1614380400.0
2003,3,3,2021-02-28,0,0,0,0,2021-02-28,1614466800.0
2004,3,3,2021-03-01,1,0,1,0,2021-03-01,1614553200.0
2005,3,3,2021-03-02,0,0,1,0,2021-03-02,1614639600.0
2006,3,3,2021-03-03,0,0,1,0,2021-03-03,1614726000.0
2007,3,3,2021-03-04,0,0,1,0,2021-03-04,1614812400.0
2008,3,3,2021-03-05,0,0,1,0,2021-03-05,1614898800.0
2009,3,3,2021-03-06,0,0,1,0,2021-03-06,1614985200.0
2010,3,3,2021-03-07,0,0,1,0,2021-03-07,1615071600.0
2011,3,3,2021-03-08,1,0,2,0,2021-03-08,1615158000.0
2012,3,3,2021-03-09,0,0,2,0,2021-03-09,1615244400.0
2013,3,3,2021-03-10,0,0,2,0,2021-03-10,1615330800.0
2014,3,3,2021-03-11,0,0,2,0,2021-03-11,1615417200.0
2015,3,3,2021-03-12,0,0,2,0,2021-03-12,1615503600.0
2016,3,3,2021-03-13,0,0,2,0,2021-03-13,1615590000.0
2017,3,3,2021-03-14,0,0,2,0,2021-03-14,1615676400.0
2018,3,3,2021-03-15,0,0,2,0,2021-03-15,1615762800.0
2019,3,3,2021-03-16,0,0,2,0,2021-03-16,1615849200.0
2020,3,3,2021-03-17,0,0,2,0,2021-03-17,1615935600.0
2021,3,3,2021-03-18,0,0,2,0,2021-03-18,1616022000.0
2022,3,3,2021-03-19,0,0,2,0,2021-03-19,1616108400.0
2023,3,3,2021-03-20,0,0,2,0,2021-03-20,1616194800.0
2024,3,3,2021-03-21,0,0,2,0,2021-03-21,1616281200.0
2025,3,3,2021-03-22,0,0,2,0,2021-03-22,1616367600.0
2026,3,3,2021-03-23,0,0,2,0,2021-03-23,1616454000.0
2027,3,3,2021-03-24,1,0,3,0,2021-03-24,1616540400.0
2028,3,3,2021-03-25,0,0,3,0,2021-03-25,1616626800.0
2029,3,3,2021-03-26,0,0,3,0,2021-03-26,1616713200.0
2030,3,3,2021-03-27,0,0,3,0,2021-03-27,1616799600.0
2031,3,3,2021-03-28,0,0,3,0,2021-03-28,1616886000.0
2032,3,3,2021-03-29,0,0,3,0,2021-03-29,1616972400.0
2033,3,3,2021-03-30,0,0,3,0,2021-03-30,1617058800.0
2034,3,3,2021-03-31,0,0,3,0,2021-03-31,1617145200.0
2035,3,3,2021-04-01,0,0,3,0,2021-04-01,1617231600.0
2036,3,3,2021-04-02,0,0,3,0,2021-04-02,1617318000.0
2037,3,3,2021-04-03,0,0,3,0,2021-04-03,1617404400.0
2038,3,3,2021-04-04,0,0,3,0,2021-04-04,1617490800.0
2039,3,3,2021-04-05,0,0,3,0,2021-04-05,1617577200.0
2040,3,3,2021-04-06,0,0,3,0,2021-04-06,1617663600.0
2041,3,3,2021-04-07,0,0,3,0,2021-04-07,1617750000.0
2042,3,3,2021-04-08,1,0,4,0,2021-04-08,1617836400.0
2043,3,3,2021-04-09,0,0,4,0,2021-04-09,1617922800.0
2044,3,3,2021-04-10,0,0,4,0,2021-04-10,1618009200.0
2045,3,3,2021-04-11,1,0,5,0,2021-04-11,1618095600.0
2046,3,3,2021-04-12,0,0,5,0,2021-04-12,1618185600.0
2047,3,3,2021-04-13,0,0,5,0,2021-04-13,1618272000.0
2048,3,3,2021-04-14,0,0,5,0,2021-04-14,1618358400.0
2049,3,3,2021-04-15,0,0,5,0,2021-04-15,1618444800.0
2050,3,3,2021-04-16,0,0,5,0,2021-04-16,1618531200.0
2051,3,3,2021-04-17,0,0,5,0,2021-04-17,1618617600.0
2052,3,3,2021-04-18,0,0,5,0,2021-04-18,1618704000.0
2053,3,3,2021-04-19,0,0,5,0,2021-04-19,1618790400.0
2054,3,3,2021-04-20,0,0,5,0,2021-04-20,1618876800.0
2055,3,3,2021-04-21,0,0,5,0,2021-04-21,1618963200.0
2056,3,3,2021-04-22,0,0,5,0,2021-04-22,1619049600.0
2057,3,3,2021-04-23,0,0,5,0,2021-04-23,1619136000.0
2058,3,3,2021-04-24,0,0,5,0,2021-04-24,1619222400.0
2059,3,3,2021-04-25,0,0,5,0,2021-04-25,1619308800.0
2060,3,3,2021-04-26,0,0,5,0,2021-04-26,1619395200.0
2061,3,3,2021-04-27,0,0,5,0,2021-04-27,1619481600.0
2062,3,3,2021-04-28,0,0,5,0,2021-04-28,1619568000.0
2063,3,3,2021-04-29,0,0,5,0,2021-04-29,1619654400.0
2064,3,3,2021-04-30,0,0,5,0,2021-04-30,1619740800.0
2065,3,3,2021-05-01,0,0,5,0,2021-05-01,1619827200.0
2066,3,3,2021-05-02,0,0,5,0,2021-05-02,1619913600.0
2067,3,3,2021-05-03,0,0,5,0,2021-05-03,1620000000.0
2068,3,3,2021-05-04,0,0,5,0,2021-05-04,1620086400.0
2069,3,3,2021-05-05,1,0,6,0,2021-05-05,1620172800.0
2070,3,3,2021-05-06,0,0,6,0,2021-05-06,1620259200.0
2071,3,3,2021-05-07,0,0,6,0,2021-05-07,1620345600.0
2072,3,3,2021-05-08,0,0,6,0,2021-05-08,1620432000.0
2073,3,3,2021-05-09,0,0,6,0,2021-05-09,1620518400.0
2074,3,3,2021-05-10,0,0,6,0,2021-05-10,1620604800.0
2075,3,3,2021-05-11,0,0,6,0,2021-05-11,1620691200.0
2076,3,3,2021-05-12,0,0,6,0,2021-05-12,1620777600.0
2077,3,3,2021-05-13,0,0,6,0,2021-05-13,1620864000.0
2078,3,3,2021-05-14,0,0,6,0,2021-05-14,1620950400.0
2079,3,3,2021-05-15,0,0,6,0,2021-05-15,1621036800.0
2080,3,3,2021-05-16,0,0,6,0,2021-05-16,1621123200.0
2081,3,3,2021-05-17,0,0,6,0,2021-05-17,1621206000.0
2082,3,3,2021-05-18,0,0,6,0,2021-05-18,1621292400.0
2083,3,3,2021-05-19,0,0,6,0,2021-05-19,1621378800.0
2084,3,3,2021-05-20,0,0,6,0,2021-05-20,1621465200.0
2085,3,3,2021-05-21,0,0,6,0,2021-05-21,1621551600.0
2086,3,3,2021-05-22,0,0,6,0,2021-05-22,1621638000.0
2087,3,3,2021-05-23,0,0,6,0,2021-05-23,1621724400.0
2088,3,3,2021-05-24,0,0,6,0,2021-05-24,1621810800.0
2089,3,3,2021-05-25,0,0,6,0,2021-05-25,1621897200.0
2090,3,3,2021-05-26,0,0,6,0,2021-05-26,1621983600.0
2091,3,3,2021-05-27,0,0,6,0,2021-05-27,1622070000.0
2092,3,3,2021-05-28,0,0,6,0,2021-05-28,1622156400.0
2093,3,3,2021-05-29,0,0,6,0,2021-05-29,1622242800.0
2094,3,3,2021-05-30,0,0,6,0,2021-05-30,1622329200.0
2095,3,3,2021-05-31,0,0,6,0,2021-05-31,1622415600.0
2096,3,3,2021-06-01,0,0,6,0,2021-06-01,1622502000.0
2097,3,3,2021-06-02,0,0,6,0,2021-06-02,1622588400.0
2098,3,3,2021-06-03,0,0,6,0,2021-06-03,1622674800.0
2099,3,3,2021-06-04,0,0,6,0,2021-06-04,1622761200.0
2100,3,3,2021-06-05,0,0,6,0,2021-06-05,1622847600.0
2101,3,3,2021-06-06,0,0,6,0,2021-06-06,1622934000.0
2102,3,3,2021-06-07,0,0,6,0,2021-06-07,1623020400.0
2103,3,3,2021-06-08,0,0,6,0,2021-06-08,1623106800.0
2104,3,3,2021-06-09,0,0,6,0,2021-06-09,1623193200.0
2105,3,3,2021-06-10,0,0,6,0,2021-06-10,1623279600.0
2106,3,3,2021-06-11,0,0,6,0,2021-06-11,1623366000.0
2107,3,3,2021-06-12,0,0,6,0,2021-06-12,1623452400.0
2108,3,3,2021-06-13,0,0,6,0,2021-06-13,1623538800.0
2109,3,3,2021-06-14,0,0,6,0,2021-06-14,1623625200.0
2110,3,3,2021-06-15,0,0,6,0,2021-06-15,1623711600.0
2111,3,3,2021-06-16,0,0,6,0,2021-06-16,1623798000.0
2112,3,3,2021-06-17,0,1,6,1,2021-06-17,1623884400.0
2113,3,3,2021-06-18,0,0,6,1,2021-06-18,1623970800.0
2114,3,3,2021-06-19,0,0,6,1,2021-06-19,1624057200.0
2115,3,3,2021-06-20,0,0,6,1,2021-06-20,1624143600.0
2116,3,3,2021-06-21,0,0,6,1,2021-06-21,1624230000.0
2117,3,3,2021-06-22,0,0,6,1,2021-06-22,1624316400.0
2118,3,3,2021-06-23,0,1,6,2,2021-06-23,1624402800.0
2119,3,3,2021-06-24,0,0,6,2,2021-06-24,1624489200.0
2120,3,3,2021-06-25,0,0,6,2,2021-06-25,1624575600.0
2121,3,3,2021-06-26,0,0,6,2,2021-06-26,1624662000.0
2122,3,3,2021-06-27,0,0,6,2,2021-06-27,1624748400.0
2123,3,3,2021-06-28,0,0,6,2,2021-06-28,1624834800.0
2124,3,3,2021-06-29,0,0,6,2,2021-06-29,1624921200.0
2125,3,3,2021-06-30,0,0,6,2,2021-06-30,1625007600.0
2126,3,3,2021-07-01,0,0,6,2,2021-07-01,1625094000.0
2127,3,3,2021-07-02,0,0,6,2,2021-07-02,1625180400.0
2128,3,3,2021-07-03,0,0,6,2,2021-07-03,1625266800.0
2129,3,3,2021-07-04,0,0,6,2,2021-07-04,1625353200.0
2130,3,3,2021-07-05,0,0,6,2,2021-07-05,1625439600.0
2131,3,3,2021-07-06,0,0,6,2,2021-07-06,1625526000.0
2132,3,3,2021-07-07,0,0,6,2,2021-07-07,1625612400.0
2133,3,3,2021-07-08,0,0,6,2,2021-07-08,1625698800.0
2134,3,4,2020-12-27,0,0,0,0,2020-12-27,1609023600.0
2135,3,4,2020-12-28,0,0,0,0,2020-12-28,1609110000.0
2136,3,4,2020-12-29,0,0,0,0,2020-12-29,1609196400.0
2137,3,4,2020-12-30,0,0,0,0,2020-12-30,1609282800.0
2138,3,4,2020-12-31,0,0,0,0,2020-12-31,1609369200.0
2139,3,4,2021-01-01,0,0,0,0,2021-01-01,1609455600.0
2140,3,4,2021-01-02,0,0,0,0,2021-01-02,1609542000.0
2141,3,4,2021-01-03,0,0,0,0,2021-01-03,1609628400.0
2142,3,4,2021-01-04,0,0,0,0,2021-01-04,1609714800.0
2143,3,4,2021-01-05,0,0,0,0,2021-01-05,1609801200.0
2144,3,4,2021-01-06,0,0,0,0,2021-01-06,1609887600.0
2145,3,4,2021-01-07,0,0,0,0,2021-01-07,1609974000.0
2146,3,4,2021-01-08,0,0,0,0,2021-01-08,1610060400.0
2147,3,4,2021-01-09,0,0,0,0,2021-01-09,1610146800.0
2148,3,4,2021-01-10,0,0,0,0,2021-01-10,1610233200.0
2149,3,4,2021-01-11,0,0,0,0,2021-01-11,1610319600.0
2150,3,4,2021-01-12,0,0,0,0,2021-01-12,1610406000.0
2151,3,4,2021-01-13,0,0,0,0,2021-01-13,1610492400.0
2152,3,4,2021-01-14,0,0,0,0,2021-01-14,1610578800.0
2153,3,4,2021-01-15,0,0,0,0,2021-01-15,1610665200.0
2154,3,4,2021-01-16,0,0,0,0,2021-01-16,1610751600.0
2155,3,4,2021-01-17,0,0,0,0,2021-01-17,1610838000.0
2156,3,4,2021-01-18,0,0,0,0,2021-01-18,1610924400.0
2157,3,4,2021-01-19,0,0,0,0,2021-01-19,1611010800.0
2158,3,4,2021-01-20,0,0,0,0,2021-01-20,1611097200.0
2159,3,4,2021-01-21,0,0,0,0,2021-01-21,1611183600.0
2160,3,4,2021-01-22,0,0,0,0,2021-01-22,1611270000.0
2161,3,4,2021-01-23,0,0,0,0,2021-01-23,1611356400.0
2162,3,4,2021-01-24,0,0,0,0,2021-01-24,1611442800.0
2163,3,4,2021-01-25,0,0,0,0,2021-01-25,1611529200.0
2164,3,4,2021-01-26,0,0,0,0,2021-01-26,1611615600.0
2165,3,4,2021-01-27,0,0,0,0,2021-01-27,1611702000.0
2166,3,4,2021-01-28,0,0,0,0,2021-01-28,1611788400.0
2167,3,4,2021-01-29,0,0,0,0,2021-01-29,1611874800.0
2168,3,4,2021-01-30,0,0,0,0,2021-01-30,1611961200.0
2169,3,4,2021-01-31,0,0,0,0,2021-01-31,1612047600.0
2170,3,4,2021-02-01,0,0,0,0,2021-02-01,1612134000.0
2171,3,4,2021-02-02,0,0,0,0,2021-02-02,1612220400.0
2172,3,4,2021-02-03,0,0,0,0,2021-02-03,1612306800.0
2173,3,4,2021-02-04,0,0,0,0,2021-02-04,1612393200.0
2174,3,4,2021-02-05,0,0,0,0,2021-02-05,1612479600.0
2175,3,4,2021-02-06,0,0,0,0,2021-02-06,1612566000.0
2176,3,4,2021-02-07,0,0,0,0,2021-02-07,1612652400.0
2177,3,4,2021-02-08,0,0,0,0,2021-02-08,1612738800.0
2178,3,4,2021-02-09,0,0,0,0,2021-02-09,1612825200.0
2179,3,4,2021-02-10,0,0,0,0,2021-02-10,1612911600.0
2180,3,4,2021-02-11,0,0,0,0,2021-02-11,1612998000.0
2181,3,4,2021-02-12,0,0,0,0,2021-02-12,1613084400.0
2182,3,4,2021-02-13,0,0,0,0,2021-02-13,1613170800.0
2183,3,4,2021-02-14,0,0,0,0,2021-02-14,1613257200.0
2184,3,4,2021-02-15,0,0,0,0,2021-02-15,1613343600.0
2185,3,4,2021-02-16,0,0,0,0,2021-02-16,1613430000.0
2186,3,4,2021-02-17,0,0,0,0,2021-02-17,1613516400.0
2187,3,4,2021-02-18,0,0,0,0,2021-02-18,1613602800.0
2188,3,4,2021-02-19,0,0,0,0,2021-02-19,1613689200.0
2189,3,4,2021-02-20,0,0,0,0,2021-02-20,1613775600.0
2190,3,4,2021-02-21,0,0,0,0,2021-02-21,1613862000.0
2191,3,4,2021-02-22,0,0,0,0,2021-02-22,1613948400.0
2192,3,4,2021-02-23,0,0,0,0,2021-02-23,1614034800.0
2193,3,4,2021-02-24,0,0,0,0,2021-02-24,1614121200.0
2194,3,4,2021-02-25,0,0,0,0,2021-02-25,1614207600.0
2195,3,4,2021-02-26,0,0,0,0,2021-02-26,1614294000.0
2196,3,4,2021-02-27,0,0,0,0,2021-02-27,1614380400.0
2197,3,4,2021-02-28,0,0,0,0,2021-02-28,1614466800.0
2198,3,4,2021-03-01,0,0,0,0,2021-03-01,1614553200.0
2199,3,4,2021-03-02,0,0,0,0,2021-03-02,1614639600.0
2200,3,4,2021-03-03,0,0,0,0,2021-03-03,1614726000.0
2201,3,4,2021-03-04,0,0,0,0,2021-03-04,1614812400.0
2202,3,4,2021-03-05,0,0,0,0,2021-03-05,1614898800.0
2203,3,4,2021-03-06,0,0,0,0,2021-03-06,1614985200.0
2204,3,4,2021-03-07,0,0,0,0,2021-03-07,1615071600.0
2205,3,4,2021-03-08,0,0,0,0,2021-03-08,1615158000.0
2206,3,4,2021-03-09,0,0,0,0,2021-03-09,1615244400.0
2207,3,4,2021-03-10,0,0,0,0,2021-03-10,1615330800.0
2208,3,4,2021-03-11,0,0,0,0,2021-03-11,1615417200.0
2209,3,4,2021-03-12,0,0,0,0,2021-03-12,1615503600.0
2210,3,4,2021-03-13,0,0,0,0,2021-03-13,1615590000.0
2211,3,4,2021-03-14,0,0,0,0,2021-03-14,1615676400.0
2212,3,4,2021-03-15,0,0,0,0,2021-03-15,1615762800.0
2213,3,4,2021-03-16,0,0,0,0,2021-03-16,1615849200.0
2214,3,4,2021-03-17,0,0,0,0,2021-03-17,1615935600.0
2215,3,4,2021-03-18,0,0,0,0,2021-03-18,1616022000.0
2216,3,4,2021-03-19,0,0,0,0,2021-03-19,1616108400.0
2217,3,4,2021-03-20,0,0,0,0,2021-03-20,1616194800.0
2218,3,4,2021-03-21,0,0,0,0,2021-03-21,1616281200.0
2219,3,4,2021-03-22,0,0,0,0,2021-03-22,1616367600.0
2220,3,4,2021-03-23,0,0,0,0,2021-03-23,1616454000.0
2221,3,4,2021-03-24,0,0,0,0,2021-03-24,1616540400.0
2222,3,4,2021-03-25,0,0,0,0,2021-03-25,1616626800.0
2223,3,4,2021-03-26,0,0,0,0,2021-03-26,1616713200.0
2224,3,4,2021-03-27,0,0,0,0,2021-03-27,1616799600.0
2225,3,4,2021-03-28,0,0,0,0,2021-03-28,1616886000.0
2226,3,4,2021-03-29,0,0,0,0,2021-03-29,1616972400.0
2227,3,4,2021-03-30,0,0,0,0,2021-03-30,1617058800.0
2228,3,4,2021-03-31,0,0,0,0,2021-03-31,1617145200.0
2229,3,4,2021-04-01,0,0,0,0,2021-04-01,1617231600.0
2230,3,4,2021-04-02,0,0,0,0,2021-04-02,1617318000.0
2231,3,4,2021-04-03,0,0,0,0,2021-04-03,1617404400.0
2232,3,4,2021-04-04,0,0,0,0,2021-04-04,1617490800.0
2233,3,4,2021-04-05,0,0,0,0,2021-04-05,1617577200.0
2234,3,4,2021-04-06,0,0,0,0,2021-04-06,1617663600.0
2235,3,4,2021-04-07,0,0,0,0,2021-04-07,1617750000.0
2236,3,4,2021-04-08,0,0,0,0,2021-04-08,1617836400.0
2237,3,4,2021-04-09,0,0,0,0,2021-04-09,1617922800.0
2238,3,4,2021-04-10,0,0,0,0,2021-04-10,1618009200.0
2239,3,4,2021-04-11,0,0,0,0,2021-04-11,1618095600.0
2240,3,4,2021-04-12,0,0,0,0,2021-04-12,1618185600.0
2241,3,4,2021-04-13,0,0,0,0,2021-04-13,1618272000.0
2242,3,4,2021-04-14,0,0,0,0,2021-04-14,1618358400.0
2243,3,4,2021-04-15,0,0,0,0,2021-04-15,1618444800.0
2244,3,4,2021-04-16,0,0,0,0,2021-04-16,1618531200.0
2245,3,4,2021-04-17,0,0,0,0,2021-04-17,1618617600.0
2246,3,4,2021-04-18,0,0,0,0,2021-04-18,1618704000.0
2247,3,4,2021-04-19,0,0,0,0,2021-04-19,1618790400.0
2248,3,4,2021-04-20,0,0,0,0,2021-04-20,1618876800.0
2249,3,4,2021-04-21,0,0,0,0,2021-04-21,1618963200.0
2250,3,4,2021-04-22,0,0,0,0,2021-04-22,1619049600.0
2251,3,4,2021-04-23,0,0,0,0,2021-04-23,1619136000.0
2252,3,4,2021-04-24,0,0,0,0,2021-04-24,1619222400.0
2253,3,4,2021-04-25,0,0,0,0,2021-04-25,1619308800.0
2254,3,4,2021-04-26,0,0,0,0,2021-04-26,1619395200.0
2255,3,4,2021-04-27,0,0,0,0,2021-04-27,1619481600.0
2256,3,4,2021-04-28,0,0,0,0,2021-04-28,1619568000.0
2257,3,4,2021-04-29,0,0,0,0,2021-04-29,1619654400.0
2258,3,4,2021-04-30,0,0,0,0,2021-04-30,1619740800.0
2259,3,4,2021-05-01,0,0,0,0,2021-05-01,1619827200.0
2260,3,4,2021-05-02,0,0,0,0,2021-05-02,1619913600.0
2261,3,4,2021-05-03,0,0,0,0,2021-05-03,1620000000.0
2262,3,4,2021-05-04,0,0,0,0,2021-05-04,1620086400.0
2263,3,4,2021-05-05,0,0,0,0,2021-05-05,1620172800.0
2264,3,4,2021-05-06,0,0,0,0,2021-05-06,1620259200.0
2265,3,4,2021-05-07,0,0,0,0,2021-05-07,1620345600.0
2266,3,4,2021-05-08,0,0,0,0,2021-05-08,1620432000.0
2267,3,4,2021-05-09,0,0,0,0,2021-05-09,1620518400.0
2268,3,4,2021-05-10,0,0,0,0,2021-05-10,1620604800.0
2269,3,4,2021-05-11,0,0,0,0,2021-05-11,1620691200.0
2270,3,4,2021-05-12,0,0,0,0,2021-05-12,1620777600.0
2271,3,4,2021-05-13,0,0,0,0,2021-05-13,1620864000.0
2272,3,4,2021-05-14,0,0,0,0,2021-05-14,1620950400.0
2273,3,4,2021-05-15,0,0,0,0,2021-05-15,1621036800.0
2274,3,4,2021-05-16,0,0,0,0,2021-05-16,1621123200.0
2275,3,4,2021-05-17,0,0,0,0,2021-05-17,1621206000.0
2276,3,4,2021-05-18,0,0,0,0,2021-05-18,1621292400.0
2277,3,4,2021-05-19,0,0,0,0,2021-05-19,1621378800.0
2278,3,4,2021-05-20,0,0,0,0,2021-05-20,1621465200.0
2279,3,4,2021-05-21,0,0,0,0,2021-05-21,1621551600.0
2280,3,4,2021-05-22,0,0,0,0,2021-05-22,1621638000.0
2281,3,4,2021-05-23,0,0,0,0,2021-05-23,1621724400.0
2282,3,4,2021-05-24,0,0,0,0,2021-05-24,1621810800.0
2283,3,4,2021-05-25,0,0,0,0,2021-05-25,1621897200.0
2284,3,4,2021-05-26,0,0,0,0,2021-05-26,1621983600.0
2285,3,4,2021-05-27,0,0,0,0,2021-05-27,1622070000.0
2286,3,4,2021-05-28,0,0,0,0,2021-05-28,1622156400.0
2287,3,4,2021-05-29,0,0,0,0,2021-05-29,1622242800.0
2288,3,4,2021-05-30,0,0,0,0,2021-05-30,1622329200.0
2289,3,4,2021-05-31,0,0,0,0,2021-05-31,1622415600.0
2290,3,4,2021-06-01,0,0,0,0,2021-06-01,1622502000.0
2291,3,4,2021-06-02,0,0,0,0,2021-06-02,1622588400.0
2292,3,4,2021-06-03,0,0,0,0,2021-06-03,1622674800.0
2293,3,4,2021-06-04,0,0,0,0,2021-06-04,1622761200.0
2294,3,4,2021-06-05,0,0,0,0,2021-06-05,1622847600.0
2295,3,4,2021-06-06,0,0,0,0,2021-06-06,1622934000.0
2296,3,4,2021-06-07,0,0,0,0,2021-06-07,1623020400.0
2297,3,4,2021-06-08,0,0,0,0,2021-06-08,1623106800.0
2298,3,4,2021-06-09,0,0,0,0,2021-06-09,1623193200.0
2299,3,4,2021-06-10,0,0,0,0,2021-06-10,1623279600.0
2300,3,4,2021-06-11,0,0,0,0,2021-06-11,1623366000.0
2301,3,4,2021-06-12,0,0,0,0,2021-06-12,1623452400.0
2302,3,4,2021-06-13,0,0,0,0,2021-06-13,1623538800.0
2303,3,4,2021-06-14,0,0,0,0,2021-06-14,1623625200.0
2304,3,4,2021-06-15,0,0,0,0,2021-06-15,1623711600.0
2305,3,4,2021-06-16,0,0,0,0,2021-06-16,1623798000.0
2306,3,4,2021-06-17,0,0,0,0,2021-06-17,1623884400.0
2307,3,4,2021-06-18,0,0,0,0,2021-06-18,1623970800.0
2308,3,4,2021-06-19,0,0,0,0,2021-06-19,1624057200.0
2309,3,4,2021-06-20,0,0,0,0,2021-06-20,1624143600.0
2310,3,4,2021-06-21,0,0,0,0,2021-06-21,1624230000.0
2311,3,4,2021-06-22,0,0,0,0,2021-06-22,1624316400.0
2312,3,4,2021-06-23,0,0,0,0,2021-06-23,1624402800.0
2313,3,4,2021-06-24,0,0,0,0,2021-06-24,1624489200.0
2314,3,4,2021-06-25,0,0,0,0,2021-06-25,1624575600.0
2315,3,4,2021-06-26,0,0,0,0,2021-06-26,1624662000.0
2316,3,4,2021-06-27,0,0,0,0,2021-06-27,1624748400.0
2317,3,4,2021-06-28,0,0,0,0,2021-06-28,1624834800.0
2318,3,4,2021-06-29,0,0,0,0,2021-06-29,1624921200.0
2319,3,4,2021-06-30,0,0,0,0,2021-06-30,1625007600.0
2320,3,4,2021-07-01,0,0,0,0,2021-07-01,1625094000.0
2321,3,4,2021-07-02,0,0,0,0,2021-07-02,1625180400.0
2322,3,4,2021-07-03,0,0,0,0,2021-07-03,1625266800.0
2323,3,4,2021-07-04,0,0,0,0,2021-07-04,1625353200.0
2324,3,4,2021-07-05,0,0,0,0,2021-07-05,1625439600.0
2325,3,4,2021-07-06,0,0,0,0,2021-07-06,1625526000.0
2326,3,4,2021-07-07,0,0,0,0,2021-07-07,1625612400.0
2327,3,4,2021-07-08,0,0,0,0,2021-07-08,1625698800.0
2328,4,1,2020-12-27,0,0,0,0,2020-12-27,1609023600.0
2329,4,1,2020-12-28,0,0,0,0,2020-12-28,1609110000.0
2330,4,1,2020-12-29,0,0,0,0,2020-12-29,1609196400.0
2331,4,1,2020-12-30,0,0,0,0,2020-12-30,1609282800.0
2332,4,1,2020-12-31,0,0,0,0,2020-12-31,1609369200.0
2333,4,1,2021-01-01,1,0,1,0,2021-01-01,1609455600.0
2334,4,1,2021-01-02,0,0,1,0,2021-01-02,1609542000.0
2335,4,1,2021-01-03,0,0,1,0,2021-01-03,1609628400.0
2336,4,1,2021-01-04,0,0,1,0,2021-01-04,1609714800.0
2337,4,1,2021-01-05,2,0,3,0,2021-01-05,1609801200.0
2338,4,1,2021-01-06,0,0,3,0,2021-01-06,1609887600.0
2339,4,1,2021-01-07,0,0,3,0,2021-01-07,1609974000.0
2340,4,1,2021-01-08,0,0,3,0,2021-01-08,1610060400.0
2341,4,1,2021-01-09,1,0,4,0,2021-01-09,1610146800.0
2342,4,1,2021-01-10,0,0,4,0,2021-01-10,1610233200.0
2343,4,1,2021-01-11,0,0,4,0,2021-01-11,1610319600.0
2344,4,1,2021-01-12,0,0,4,0,2021-01-12,1610406000.0
2345,4,1,2021-01-13,0,0,4,0,2021-01-13,1610492400.0
2346,4,1,2021-01-14,0,0,4,0,2021-01-14,1610578800.0
2347,4,1,2021-01-15,332,0,336,0,2021-01-15,1610665200.0
2348,4,1,2021-01-16,27,0,363,0,2021-01-16,1610751600.0
2349,4,1,2021-01-17,0,0,363,0,2021-01-17,1610838000.0
2350,4,1,2021-01-18,49,0,412,0,2021-01-18,1610924400.0
2351,4,1,2021-01-19,393,0,805,0,2021-01-19,1611010800.0
2352,4,1,2021-01-20,481,0,1286,0,2021-01-20,1611097200.0
2353,4,1,2021-01-21,614,1,1900,1,2021-01-21,1611183600.0
2354,4,1,2021-01-22,409,0,2309,1,2021-01-22,1611270000.0
2355,4,1,2021-01-23,75,0,2384,1,2021-01-23,1611356400.0
2356,4,1,2021-01-24,0,0,2384,1,2021-01-24,1611442800.0
2357,4,1,2021-01-25,273,0,2657,1,2021-01-25,1611529200.0
2358,4,1,2021-01-26,429,0,3086,1,2021-01-26,1611615600.0
2359,4,1,2021-01-27,317,0,3403,1,2021-01-27,1611702000.0
2360,4,1,2021-01-28,407,0,3810,1,2021-01-28,1611788400.0
2361,4,1,2021-01-29,421,3,4231,4,2021-01-29,1611874800.0
2362,4,1,2021-01-30,420,0,4651,4,2021-01-30,1611961200.0
2363,4,1,2021-01-31,0,0,4651,4,2021-01-31,1612047600.0
2364,4,1,2021-02-01,371,3,5022,7,2021-02-01,1612134000.0
2365,4,1,2021-02-02,499,4,5521,11,2021-02-02,1612220400.0
2366,4,1,2021-02-03,602,13,6123,24,2021-02-03,1612306800.0
2367,4,1,2021-02-04,626,21,6749,45,2021-02-04,1612393200.0
2368,4,1,2021-02-05,564,98,7313,143,2021-02-05,1612479600.0
2369,4,1,2021-02-06,501,4,7814,147,2021-02-06,1612566000.0
2370,4,1,2021-02-07,0,8,7814,155,2021-02-07,1612652400.0
2371,4,1,2021-02-08,467,34,8281,189,2021-02-08,1612738800.0
2372,4,1,2021-02-09,784,90,9065,279,2021-02-09,1612825200.0
2373,4,1,2021-02-10,820,85,9885,364,2021-02-10,1612911600.0
2374,4,1,2021-02-11,796,85,10681,449,2021-02-11,1612998000.0
2375,4,1,2021-02-12,637,95,11318,544,2021-02-12,1613084400.0
2376,4,1,2021-02-13,651,74,11969,618,2021-02-13,1613170800.0
2377,4,1,2021-02-14,1,0,11970,618,2021-02-14,1613257200.0
2378,4,1,2021-02-15,524,124,12494,742,2021-02-15,1613343600.0
2379,4,1,2021-02-16,651,534,13145,1276,2021-02-16,1613430000.0
2380,4,1,2021-02-17,592,328,13737,1604,2021-02-17,1613516400.0
2381,4,1,2021-02-18,493,414,14230,2018,2021-02-18,1613602800.0
2382,4,1,2021-02-19,496,320,14726,2338,2021-02-19,1613689200.0
2383,4,1,2021-02-20,576,116,15302,2454,2021-02-20,1613775600.0
2384,4,1,2021-02-21,0,0,15302,2454,2021-02-21,1613862000.0
2385,4,1,2021-02-22,402,236,15704,2690,2021-02-22,1613948400.0
2386,4,1,2021-02-23,607,236,16311,2926,2021-02-23,1614034800.0
2387,4,1,2021-02-24,583,253,16894,3179,2021-02-24,1614121200.0
2388,4,1,2021-02-25,645,294,17539,3473,2021-02-25,1614207600.0
2389,4,1,2021-02-26,483,470,18022,3943,2021-02-26,1614294000.0
2390,4,1,2021-02-27,385,470,18407,4413,2021-02-27,1614380400.0
2391,4,1,2021-02-28,0,0,18407,4413,2021-02-28,1614466800.0
2392,4,1,2021-03-01,290,391,18697,4804,2021-03-01,1614553200.0
2393,4,1,2021-03-02,485,500,19182,5304,2021-03-02,1614639600.0
2394,4,1,2021-03-03,755,554,19937,5858,2021-03-03,1614726000.0
2395,4,1,2021-03-04,774,538,20711,6396,2021-03-04,1614812400.0
2396,4,1,2021-03-05,727,532,21438,6928,2021-03-05,1614898800.0
2397,4,1,2021-03-06,812,529,22250,7457,2021-03-06,1614985200.0
2398,4,1,2021-03-07,0,0,22250,7457,2021-03-07,1615071600.0
2399,4,1,2021-03-08,435,590,22685,8047,2021-03-08,1615158000.0
2400,4,1,2021-03-09,670,774,23355,8821,2021-03-09,1615244400.0
2401,4,1,2021-03-10,644,848,23999,9669,2021-03-10,1615330800.0
2402,4,1,2021-03-11,699,642,24698,10311,2021-03-11,1615417200.0
2403,4,1,2021-03-12,729,661,25427,10972,2021-03-12,1615503600.0
2404,4,1,2021-03-13,668,609,26095,11581,2021-03-13,1615590000.0
2405,4,1,2021-03-14,2,0,26097,11581,2021-03-14,1615676400.0
2406,4,1,2021-03-15,503,504,26600,12085,2021-03-15,1615762800.0
2407,4,1,2021-03-16,680,708,27280,12793,2021-03-16,1615849200.0
2408,4,1,2021-03-17,847,537,28127,13330,2021-03-17,1615935600.0
2409,4,1,2021-03-18,1021,551,29148,13881,2021-03-18,1616022000.0
2410,4,1,2021-03-19,784,541,29932,14422,2021-03-19,1616108400.0
2411,4,1,2021-03-20,576,595,30508,15017,2021-03-20,1616194800.0
2412,4,1,2021-03-21,0,0,30508,15017,2021-03-21,1616281200.0
2413,4,1,2021-03-22,565,478,31073,15495,2021-03-22,1616367600.0
2414,4,1,2021-03-23,780,634,31853,16129,2021-03-23,1616454000.0
2415,4,1,2021-03-24,792,667,32645,16796,2021-03-24,1616540400.0
2416,4,1,2021-03-25,929,548,33574,17344,2021-03-25,1616626800.0
2417,4,1,2021-03-26,921,441,34495,17785,2021-03-26,1616713200.0
2418,4,1,2021-03-27,782,337,35277,18122,2021-03-27,1616799600.0
2419,4,1,2021-03-28,1,0,35278,18122,2021-03-28,1616886000.0
2420,4,1,2021-03-29,961,269,36239,18391,2021-03-29,1616972400.0
2421,4,1,2021-03-30,883,498,37122,18889,2021-03-30,1617058800.0
2422,4,1,2021-03-31,740,669,37862,19558,2021-03-31,1617145200.0
2423,4,1,2021-04-01,716,707,38578,20265,2021-04-01,1617231600.0
2424,4,1,2021-04-02,688,758,39266,21023,2021-04-02,1617318000.0
2425,4,1,2021-04-03,699,699,39965,21722,2021-04-03,1617404400.0
2426,4,1,2021-04-04,0,0,39965,21722,2021-04-04,1617490800.0
2427,4,1,2021-04-05,0,2,39965,21724,2021-04-05,1617577200.0
2428,4,1,2021-04-06,794,634,40759,22358,2021-04-06,1617663600.0
2429,4,1,2021-04-07,1369,777,42128,23135,2021-04-07,1617750000.0
2430,4,1,2021-04-08,1792,775,43920,23910,2021-04-08,1617836400.0
2431,4,1,2021-04-09,1509,779,45429,24689,2021-04-09,1617922800.0
2432,4,1,2021-04-10,1137,649,46566,25338,2021-04-10,1618009200.0
2433,4,1,2021-04-11,2,0,46568,25338,2021-04-11,1618095600.0
2434,4,1,2021-04-12,1238,542,47806,25880,2021-04-12,1618185600.0
2435,4,1,2021-04-13,1440,745,49246,26625,2021-04-13,1618272000.0
2436,4,1,2021-04-14,2069,770,51315,27395,2021-04-14,1618358400.0
2437,4,1,2021-04-15,2504,939,53819,28334,2021-04-15,1618444800.0
2438,4,1,2021-04-16,1932,766,55751,29100,2021-04-16,1618531200.0
2439,4,1,2021-04-17,1289,595,57040,29695,2021-04-17,1618617600.0
2440,4,1,2021-04-18,0,0,57040,29695,2021-04-18,1618704000.0
2441,4,1,2021-04-19,1376,561,58416,30256,2021-04-19,1618790400.0
2442,4,1,2021-04-20,1649,792,60065,31048,2021-04-20,1618876800.0
2443,4,1,2021-04-21,2127,598,62192,31646,2021-04-21,1618963200.0
2444,4,1,2021-04-22,2946,780,65138,32426,2021-04-22,1619049600.0
2445,4,1,2021-04-23,2309,796,67447,33222,2021-04-23,1619136000.0
2446,4,1,2021-04-24,1102,790,68549,34012,2021-04-24,1619222400.0
2447,4,1,2021-04-25,2,0,68551,34012,2021-04-25,1619308800.0
2448,4,1,2021-04-26,1164,908,69715,34920,2021-04-26,1619395200.0
2449,4,1,2021-04-27,1683,1014,71398,35934,2021-04-27,1619481600.0
2450,4,1,2021-04-28,2897,716,74295,36650,2021-04-28,1619568000.0
2451,4,1,2021-04-29,3946,797,78241,37447,2021-04-29,1619654400.0
2452,4,1,2021-04-30,3432,879,81673,38326,2021-04-30,1619740800.0
2453,4,1,2021-05-01,2106,202,83779,38528,2021-05-01,1619827200.0
2454,4,1,2021-05-02,2,0,83781,38528,2021-05-02,1619913600.0
2455,4,1,2021-05-03,1865,542,85646,39070,2021-05-03,1620000000.0
2456,4,1,2021-05-04,2127,1072,87773,40142,2021-05-04,1620086400.0
2457,4,1,2021-05-05,3119,1607,90892,41749,2021-05-05,1620172800.0
2458,4,1,2021-05-06,4005,1562,94897,43311,2021-05-06,1620259200.0
2459,4,1,2021-05-07,3228,1502,98125,44813,2021-05-07,1620345600.0
2460,4,1,2021-05-08,1565,481,99690,45294,2021-05-08,1620432000.0
2461,4,1,2021-05-09,0,0,99690,45294,2021-05-09,1620518400.0
2462,4,1,2021-05-10,2411,976,102101,46270,2021-05-10,1620604800.0
2463,4,1,2021-05-11,3630,1583,105731,47853,2021-05-11,1620691200.0
2464,4,1,2021-05-12,4678,2310,110409,50163,2021-05-12,1620777600.0
2465,4,1,2021-05-13,3553,544,113962,50707,2021-05-13,1620864000.0
2466,4,1,2021-05-14,5189,2350,119151,53057,2021-05-14,1620950400.0
2467,4,1,2021-05-15,3142,1477,122293,54534,2021-05-15,1621036800.0
2468,4,1,2021-05-16,3,6,122296,54540,2021-05-16,1621123200.0
2469,4,1,2021-05-17,2926,1372,125222,55912,2021-05-17,1621206000.0
2470,4,1,2021-05-18,3590,1552,128812,57464,2021-05-18,1621292400.0
2471,4,1,2021-05-19,4571,2162,133383,59626,2021-05-19,1621378800.0
2472,4,1,2021-05-20,5049,2648,138432,62274,2021-05-20,1621465200.0
2473,4,1,2021-05-21,4830,2414,143262,64688,2021-05-21,1621551600.0
2474,4,1,2021-05-22,3282,1112,146544,65800,2021-05-22,1621638000.0
2475,4,1,2021-05-23,2,0,146546,65800,2021-05-23,1621724400.0
2476,4,1,2021-05-24,3589,966,150135,66766,2021-05-24,1621810800.0
2477,4,1,2021-05-25,3931,1511,154066,68277,2021-05-25,1621897200.0
2478,4,1,2021-05-26,4718,2604,158784,70881,2021-05-26,1621983600.0
2479,4,1,2021-05-27,4302,3688,163086,74569,2021-05-27,1622070000.0
2480,4,1,2021-05-28,4132,3497,167218,78066,2021-05-28,1622156400.0
2481,4,1,2021-05-29,2398,2256,169616,80322,2021-05-29,1622242800.0
2482,4,1,2021-05-30,6,13,169622,80335,2021-05-30,1622329200.0
2483,4,1,2021-05-31,2143,1988,171765,82323,2021-05-31,1622415600.0
2484,4,1,2021-06-01,2996,2342,174761,84665,2021-06-01,1622502000.0
2485,4,1,2021-06-02,3732,3044,178493,87709,2021-06-02,1622588400.0
2486,4,1,2021-06-03,3780,3326,182273,91035,2021-06-03,1622674800.0
2487,4,1,2021-06-04,3576,3409,185849,94444,2021-06-04,1622761200.0
2488,4,1,2021-06-05,2117,1799,187966,96243,2021-06-05,1622847600.0
2489,4,1,2021-06-06,1047,74,189013,96317,2021-06-06,1622934000.0
2490,4,1,2021-06-07,1840,2324,190853,98641,2021-06-07,1623020400.0
2491,4,1,2021-06-08,2319,3046,193172,101687,2021-06-08,1623106800.0
2492,4,1,2021-06-09,2821,4547,195993,106234,2021-06-09,1623193200.0
2493,4,1,2021-06-10,3244,4209,199237,110443,2021-06-10,1623279600.0
2494,4,1,2021-06-11,2683,4398,201920,114841,2021-06-11,1623366000.0
2495,4,1,2021-06-12,1572,3203,203492,118044,2021-06-12,1623452400.0
2496,4,1,2021-06-13,1278,184,204770,118228,2021-06-13,1623538800.0
2497,4,1,2021-06-14,1377,3029,206147,121257,2021-06-14,1623625200.0
2498,4,1,2021-06-15,1827,3330,207974,124587,2021-06-15,1623711600.0
2499,4,1,2021-06-16,2540,4393,210514,128980,2021-06-16,1623798000.0
2500,4,1,2021-06-17,2369,4700,212883,133680,2021-06-17,1623884400.0
2501,4,1,2021-06-18,2414,4674,215297,138354,2021-06-18,1623970800.0
2502,4,1,2021-06-19,1221,3407,216518,141761,2021-06-19,1624057200.0
2503,4,1,2021-06-20,603,235,217121,141996,2021-06-20,1624143600.0
2504,4,1,2021-06-21,1154,3087,218275,145083,2021-06-21,1624230000.0
2505,4,1,2021-06-22,1438,3538,219713,148621,2021-06-22,1624316400.0
2506,4,1,2021-06-23,2134,4786,221847,153407,2021-06-23,1624402800.0
2507,4,1,2021-06-24,2153,3874,224000,157281,2021-06-24,1624489200.0
2508,4,1,2021-06-25,2056,3918,226056,161199,2021-06-25,1624575600.0
2509,4,1,2021-06-26,1316,2598,227372,163797,2021-06-26,1624662000.0
2510,4,1,2021-06-27,607,199,227979,163996,2021-06-27,1624748400.0
2511,4,1,2021-06-28,1235,2351,229214,166347,2021-06-28,1624834800.0
2512,4,1,2021-06-29,1593,2637,230807,168984,2021-06-29,1624921200.0
2513,4,1,2021-06-30,2408,3613,233215,172597,2021-06-30,1625007600.0
2514,4,1,2021-07-01,2537,3613,235752,176210,2021-07-01,1625094000.0
2515,4,1,2021-07-02,2345,3467,238097,179677,2021-07-02,1625180400.0
2516,4,1,2021-07-03,1507,2309,239604,181986,2021-07-03,1625266800.0
2517,4,1,2021-07-04,820,965,240424,182951,2021-07-04,1625353200.0
2518,4,1,2021-07-05,1565,2036,241989,184987,2021-07-05,1625439600.0
2519,4,1,2021-07-06,2232,2284,244221,187271,2021-07-06,1625526000.0
2520,4,1,2021-07-07,2485,2898,246706,190169,2021-07-07,1625612400.0
2521,4,1,2021-07-08,2224,2969,248930,193138,2021-07-08,1625698800.0
2522,4,2,2020-12-27,0,0,0,0,2020-12-27,1609023600.0
2523,4,2,2020-12-28,0,0,0,0,2020-12-28,1609110000.0
2524,4,2,2020-12-29,0,0,0,0,2020-12-29,1609196400.0
2525,4,2,2020-12-30,0,0,0,0,2020-12-30,1609282800.0
2526,4,2,2020-12-31,0,0,0,0,2020-12-31,1609369200.0
2527,4,2,2021-01-01,0,0,0,0,2021-01-01,1609455600.0
2528,4,2,2021-01-02,0,0,0,0,2021-01-02,1609542000.0
2529,4,2,2021-01-03,0,0,0,0,2021-01-03,1609628400.0
2530,4,2,2021-01-04,0,0,0,0,2021-01-04,1609714800.0
2531,4,2,2021-01-05,0,0,0,0,2021-01-05,1609801200.0
2532,4,2,2021-01-06,0,0,0,0,2021-01-06,1609887600.0
2533,4,2,2021-01-07,0,0,0,0,2021-01-07,1609974000.0
2534,4,2,2021-01-08,0,0,0,0,2021-01-08,1610060400.0
2535,4,2,2021-01-09,0,0,0,0,2021-01-09,1610146800.0
2536,4,2,2021-01-10,0,0,0,0,2021-01-10,1610233200.0
2537,4,2,2021-01-11,0,0,0,0,2021-01-11,1610319600.0
2538,4,2,2021-01-12,0,0,0,0,2021-01-12,1610406000.0
2539,4,2,2021-01-13,0,0,0,0,2021-01-13,1610492400.0
2540,4,2,2021-01-14,0,0,0,0,2021-01-14,1610578800.0
2541,4,2,2021-01-15,0,0,0,0,2021-01-15,1610665200.0
2542,4,2,2021-01-16,0,0,0,0,2021-01-16,1610751600.0
2543,4,2,2021-01-17,0,0,0,0,2021-01-17,1610838000.0
2544,4,2,2021-01-18,0,0,0,0,2021-01-18,1610924400.0
2545,4,2,2021-01-19,0,0,0,0,2021-01-19,1611010800.0
2546,4,2,2021-01-20,0,0,0,0,2021-01-20,1611097200.0
2547,4,2,2021-01-21,0,0,0,0,2021-01-21,1611183600.0
2548,4,2,2021-01-22,0,0,0,0,2021-01-22,1611270000.0
2549,4,2,2021-01-23,0,0,0,0,2021-01-23,1611356400.0
2550,4,2,2021-01-24,0,0,0,0,2021-01-24,1611442800.0
2551,4,2,2021-01-25,0,0,0,0,2021-01-25,1611529200.0
2552,4,2,2021-01-26,0,0,0,0,2021-01-26,1611615600.0
2553,4,2,2021-01-27,0,0,0,0,2021-01-27,1611702000.0
2554,4,2,2021-01-28,0,0,0,0,2021-01-28,1611788400.0
2555,4,2,2021-01-29,0,0,0,0,2021-01-29,1611874800.0
2556,4,2,2021-01-30,0,0,0,0,2021-01-30,1611961200.0
2557,4,2,2021-01-31,0,0,0,0,2021-01-31,1612047600.0
2558,4,2,2021-02-01,1,0,1,0,2021-02-01,1612134000.0
2559,4,2,2021-02-02,0,0,1,0,2021-02-02,1612220400.0
2560,4,2,2021-02-03,0,0,1,0,2021-02-03,1612306800.0
2561,4,2,2021-02-04,0,0,1,0,2021-02-04,1612393200.0
2562,4,2,2021-02-05,0,0,1,0,2021-02-05,1612479600.0
2563,4,2,2021-02-06,0,0,1,0,2021-02-06,1612566000.0
2564,4,2,2021-02-07,0,0,1,0,2021-02-07,1612652400.0
2565,4,2,2021-02-08,0,0,1,0,2021-02-08,1612738800.0
2566,4,2,2021-02-09,0,0,1,0,2021-02-09,1612825200.0
2567,4,2,2021-02-10,0,0,1,0,2021-02-10,1612911600.0
2568,4,2,2021-02-11,0,0,1,0,2021-02-11,1612998000.0
2569,4,2,2021-02-12,0,0,1,0,2021-02-12,1613084400.0
2570,4,2,2021-02-13,0,0,1,0,2021-02-13,1613170800.0
2571,4,2,2021-02-14,0,0,1,0,2021-02-14,1613257200.0
2572,4,2,2021-02-15,0,0,1,0,2021-02-15,1613343600.0
2573,4,2,2021-02-16,0,0,1,0,2021-02-16,1613430000.0
2574,4,2,2021-02-17,0,0,1,0,2021-02-17,1613516400.0
2575,4,2,2021-02-18,0,0,1,0,2021-02-18,1613602800.0
2576,4,2,2021-02-19,0,0,1,0,2021-02-19,1613689200.0
2577,4,2,2021-02-20,0,0,1,0,2021-02-20,1613775600.0
2578,4,2,2021-02-21,0,0,1,0,2021-02-21,1613862000.0
2579,4,2,2021-02-22,0,0,1,0,2021-02-22,1613948400.0
2580,4,2,2021-02-23,0,0,1,0,2021-02-23,1614034800.0
2581,4,2,2021-02-24,0,0,1,0,2021-02-24,1614121200.0
2582,4,2,2021-02-25,0,0,1,0,2021-02-25,1614207600.0
2583,4,2,2021-02-26,0,0,1,0,2021-02-26,1614294000.0
2584,4,2,2021-02-27,0,0,1,0,2021-02-27,1614380400.0
2585,4,2,2021-02-28,0,0,1,0,2021-02-28,1614466800.0
2586,4,2,2021-03-01,0,0,1,0,2021-03-01,1614553200.0
2587,4,2,2021-03-02,0,0,1,0,2021-03-02,1614639600.0
2588,4,2,2021-03-03,0,0,1,0,2021-03-03,1614726000.0
2589,4,2,2021-03-04,0,0,1,0,2021-03-04,1614812400.0
2590,4,2,2021-03-05,0,0,1,0,2021-03-05,1614898800.0
2591,4,2,2021-03-06,0,0,1,0,2021-03-06,1614985200.0
2592,4,2,2021-03-07,0,0,1,0,2021-03-07,1615071600.0
2593,4,2,2021-03-08,0,0,1,0,2021-03-08,1615158000.0
2594,4,2,2021-03-09,0,0,1,0,2021-03-09,1615244400.0
2595,4,2,2021-03-10,0,0,1,0,2021-03-10,1615330800.0
2596,4,2,2021-03-11,0,0,1,0,2021-03-11,1615417200.0
2597,4,2,2021-03-12,0,0,1,0,2021-03-12,1615503600.0
2598,4,2,2021-03-13,0,0,1,0,2021-03-13,1615590000.0
2599,4,2,2021-03-14,0,0,1,0,2021-03-14,1615676400.0
2600,4,2,2021-03-15,1,0,2,0,2021-03-15,1615762800.0
2601,4,2,2021-03-16,0,0,2,0,2021-03-16,1615849200.0
2602,4,2,2021-03-17,0,0,2,0,2021-03-17,1615935600.0
2603,4,2,2021-03-18,0,0,2,0,2021-03-18,1616022000.0
2604,4,2,2021-03-19,0,0,2,0,2021-03-19,1616108400.0
2605,4,2,2021-03-20,0,0,2,0,2021-03-20,1616194800.0
2606,4,2,2021-03-21,0,0,2,0,2021-03-21,1616281200.0
2607,4,2,2021-03-22,0,0,2,0,2021-03-22,1616367600.0
2608,4,2,2021-03-23,0,0,2,0,2021-03-23,1616454000.0
2609,4,2,2021-03-24,0,0,2,0,2021-03-24,1616540400.0
2610,4,2,2021-03-25,0,0,2,0,2021-03-25,1616626800.0
2611,4,2,2021-03-26,0,0,2,0,2021-03-26,1616713200.0
2612,4,2,2021-03-27,0,0,2,0,2021-03-27,1616799600.0
2613,4,2,2021-03-28,0,0,2,0,2021-03-28,1616886000.0
2614,4,2,2021-03-29,0,0,2,0,2021-03-29,1616972400.0
2615,4,2,2021-03-30,0,0,2,0,2021-03-30,1617058800.0
2616,4,2,2021-03-31,0,0,2,0,2021-03-31,1617145200.0
2617,4,2,2021-04-01,0,0,2,0,2021-04-01,1617231600.0
2618,4,2,2021-04-02,0,0,2,0,2021-04-02,1617318000.0
2619,4,2,2021-04-03,0,0,2,0,2021-04-03,1617404400.0
2620,4,2,2021-04-04,0,0,2,0,2021-04-04,1617490800.0
2621,4,2,2021-04-05,0,0,2,0,2021-04-05,1617577200.0
2622,4,2,2021-04-06,1,0,3,0,2021-04-06,1617663600.0
2623,4,2,2021-04-07,0,0,3,0,2021-04-07,1617750000.0
2624,4,2,2021-04-08,0,0,3,0,2021-04-08,1617836400.0
2625,4,2,2021-04-09,0,0,3,0,2021-04-09,1617922800.0
2626,4,2,2021-04-10,0,0,3,0,2021-04-10,1618009200.0
2627,4,2,2021-04-11,0,0,3,0,2021-04-11,1618095600.0
2628,4,2,2021-04-12,0,0,3,0,2021-04-12,1618185600.0
2629,4,2,2021-04-13,0,0,3,0,2021-04-13,1618272000.0
2630,4,2,2021-04-14,0,0,3,0,2021-04-14,1618358400.0
2631,4,2,2021-04-15,0,0,3,0,2021-04-15,1618444800.0
2632,4,2,2021-04-16,0,0,3,0,2021-04-16,1618531200.0
2633,4,2,2021-04-17,0,0,3,0,2021-04-17,1618617600.0
2634,4,2,2021-04-18,0,0,3,0,2021-04-18,1618704000.0
2635,4,2,2021-04-19,0,0,3,0,2021-04-19,1618790400.0
2636,4,2,2021-04-20,0,0,3,0,2021-04-20,1618876800.0
2637,4,2,2021-04-21,0,0,3,0,2021-04-21,1618963200.0
2638,4,2,2021-04-22,0,0,3,0,2021-04-22,1619049600.0
2639,4,2,2021-04-23,0,0,3,0,2021-04-23,1619136000.0
2640,4,2,2021-04-24,0,0,3,0,2021-04-24,1619222400.0
2641,4,2,2021-04-25,0,0,3,0,2021-04-25,1619308800.0
2642,4,2,2021-04-26,0,0,3,0,2021-04-26,1619395200.0
2643,4,2,2021-04-27,0,0,3,0,2021-04-27,1619481600.0
2644,4,2,2021-04-28,0,0,3,0,2021-04-28,1619568000.0
2645,4,2,2021-04-29,0,0,3,0,2021-04-29,1619654400.0
2646,4,2,2021-04-30,0,0,3,0,2021-04-30,1619740800.0
2647,4,2,2021-05-01,0,0,3,0,2021-05-01,1619827200.0
2648,4,2,2021-05-02,0,0,3,0,2021-05-02,1619913600.0
2649,4,2,2021-05-03,0,0,3,0,2021-05-03,1620000000.0
2650,4,2,2021-05-04,0,0,3,0,2021-05-04,1620086400.0
2651,4,2,2021-05-05,0,0,3,0,2021-05-05,1620172800.0
2652,4,2,2021-05-06,0,0,3,0,2021-05-06,1620259200.0
2653,4,2,2021-05-07,0,0,3,0,2021-05-07,1620345600.0
2654,4,2,2021-05-08,0,0,3,0,2021-05-08,1620432000.0
2655,4,2,2021-05-09,1,0,4,0,2021-05-09,1620518400.0
2656,4,2,2021-05-10,0,0,4,0,2021-05-10,1620604800.0
2657,4,2,2021-05-11,0,0,4,0,2021-05-11,1620691200.0
2658,4,2,2021-05-12,0,0,4,0,2021-05-12,1620777600.0
2659,4,2,2021-05-13,0,0,4,0,2021-05-13,1620864000.0
2660,4,2,2021-05-14,0,0,4,0,2021-05-14,1620950400.0
2661,4,2,2021-05-15,0,0,4,0,2021-05-15,1621036800.0
2662,4,2,2021-05-16,0,0,4,0,2021-05-16,1621123200.0
2663,4,2,2021-05-17,0,0,4,0,2021-05-17,1621206000.0
2664,4,2,2021-05-18,0,0,4,0,2021-05-18,1621292400.0
2665,4,2,2021-05-19,0,0,4,0,2021-05-19,1621378800.0
2666,4,2,2021-05-20,0,0,4,0,2021-05-20,1621465200.0
2667,4,2,2021-05-21,0,0,4,0,2021-05-21,1621551600.0
2668,4,2,2021-05-22,0,0,4,0,2021-05-22,1621638000.0
2669,4,2,2021-05-23,0,0,4,0,2021-05-23,1621724400.0
2670,4,2,2021-05-24,0,0,4,0,2021-05-24,1621810800.0
2671,4,2,2021-05-25,0,0,4,0,2021-05-25,1621897200.0
2672,4,2,2021-05-26,0,0,4,0,2021-05-26,1621983600.0
2673,4,2,2021-05-27,0,0,4,0,2021-05-27,1622070000.0
2674,4,2,2021-05-28,2,0,6,0,2021-05-28,1622156400.0
2675,4,2,2021-05-29,0,0,6,0,2021-05-29,1622242800.0
2676,4,2,2021-05-30,0,0,6,0,2021-05-30,1622329200.0
2677,4,2,2021-05-31,0,0,6,0,2021-05-31,1622415600.0
2678,4,2,2021-06-01,0,0,6,0,2021-06-01,1622502000.0
2679,4,2,2021-06-02,0,0,6,0,2021-06-02,1622588400.0
2680,4,2,2021-06-03,0,0,6,0,2021-06-03,1622674800.0
2681,4,2,2021-06-04,0,0,6,0,2021-06-04,1622761200.0
2682,4,2,2021-06-05,0,0,6,0,2021-06-05,1622847600.0
2683,4,2,2021-06-06,0,0,6,0,2021-06-06,1622934000.0
2684,4,2,2021-06-07,0,0,6,0,2021-06-07,1623020400.0
2685,4,2,2021-06-08,0,0,6,0,2021-06-08,1623106800.0
2686,4,2,2021-06-09,0,0,6,0,2021-06-09,1623193200.0
2687,4,2,2021-06-10,1,1,7,1,2021-06-10,1623279600.0
2688,4,2,2021-06-11,0,2,7,3,2021-06-11,1623366000.0
2689,4,2,2021-06-12,0,0,7,3,2021-06-12,1623452400.0
2690,4,2,2021-06-13,0,0,7,3,2021-06-13,1623538800.0
2691,4,2,2021-06-14,0,0,7,3,2021-06-14,1623625200.0
2692,4,2,2021-06-15,0,0,7,3,2021-06-15,1623711600.0
2693,4,2,2021-06-16,0,0,7,3,2021-06-16,1623798000.0
2694,4,2,2021-06-17,0,0,7,3,2021-06-17,1623884400.0
2695,4,2,2021-06-18,0,0,7,3,2021-06-18,1623970800.0
2696,4,2,2021-06-19,0,0,7,3,2021-06-19,1624057200.0
2697,4,2,2021-06-20,0,0,7,3,2021-06-20,1624143600.0
2698,4,2,2021-06-21,0,0,7,3,2021-06-21,1624230000.0
2699,4,2,2021-06-22,0,0,7,3,2021-06-22,1624316400.0
2700,4,2,2021-06-23,0,0,7,3,2021-06-23,1624402800.0
2701,4,2,2021-06-24,0,0,7,3,2021-06-24,1624489200.0
2702,4,2,2021-06-25,0,0,7,3,2021-06-25,1624575600.0
2703,4,2,2021-06-26,0,0,7,3,2021-06-26,1624662000.0
2704,4,2,2021-06-27,0,0,7,3,2021-06-27,1624748400.0
2705,4,2,2021-06-28,0,0,7,3,2021-06-28,1624834800.0
2706,4,2,2021-06-29,0,0,7,3,2021-06-29,1624921200.0
2707,4,2,2021-06-30,0,0,7,3,2021-06-30,1625007600.0
2708,4,2,2021-07-01,0,0,7,3,2021-07-01,1625094000.0
2709,4,2,2021-07-02,0,0,7,3,2021-07-02,1625180400.0
2710,4,2,2021-07-03,0,0,7,3,2021-07-03,1625266800.0
2711,4,2,2021-07-04,0,1,7,4,2021-07-04,1625353200.0
2712,4,2,2021-07-05,0,0,7,4,2021-07-05,1625439600.0
2713,4,2,2021-07-06,0,0,7,4,2021-07-06,1625526000.0
2714,4,2,2021-07-07,0,0,7,4,2021-07-07,1625612400.0
2715,4,2,2021-07-08,0,0,7,4,2021-07-08,1625698800.0
2716,4,3,2020-12-27,0,0,0,0,2020-12-27,1609023600.0
2717,4,3,2020-12-28,0,0,0,0,2020-12-28,1609110000.0
2718,4,3,2020-12-29,0,0,0,0,2020-12-29,1609196400.0
2719,4,3,2020-12-30,0,0,0,0,2020-12-30,1609282800.0
2720,4,3,2020-12-31,0,0,0,0,2020-12-31,1609369200.0
2721,4,3,2021-01-01,0,0,0,0,2021-01-01,1609455600.0
2722,4,3,2021-01-02,0,0,0,0,2021-01-02,1609542000.0
2723,4,3,2021-01-03,0,0,0,0,2021-01-03,1609628400.0
2724,4,3,2021-01-04,0,0,0,0,2021-01-04,1609714800.0
2725,4,3,2021-01-05,0,0,0,0,2021-01-05,1609801200.0
2726,4,3,2021-01-06,0,0,0,0,2021-01-06,1609887600.0
2727,4,3,2021-01-07,0,0,0,0,2021-01-07,1609974000.0
2728,4,3,2021-01-08,0,0,0,0,2021-01-08,1610060400.0
2729,4,3,2021-01-09,0,0,0,0,2021-01-09,1610146800.0
2730,4,3,2021-01-10,0,0,0,0,2021-01-10,1610233200.0
2731,4,3,2021-01-11,0,0,0,0,2021-01-11,1610319600.0
2732,4,3,2021-01-12,0,0,0,0,2021-01-12,1610406000.0
2733,4,3,2021-01-13,0,0,0,0,2021-01-13,1610492400.0
2734,4,3,2021-01-14,0,0,0,0,2021-01-14,1610578800.0
2735,4,3,2021-01-15,0,0,0,0,2021-01-15,1610665200.0
2736,4,3,2021-01-16,0,0,0,0,2021-01-16,1610751600.0
2737,4,3,2021-01-17,0,0,0,0,2021-01-17,1610838000.0
2738,4,3,2021-01-18,0,0,0,0,2021-01-18,1610924400.0
2739,4,3,2021-01-19,0,0,0,0,2021-01-19,1611010800.0
2740,4,3,2021-01-20,0,0,0,0,2021-01-20,1611097200.0
2741,4,3,2021-01-21,0,0,0,0,2021-01-21,1611183600.0
2742,4,3,2021-01-22,0,0,0,0,2021-01-22,1611270000.0
2743,4,3,2021-01-23,0,0,0,0,2021-01-23,1611356400.0
2744,4,3,2021-01-24,0,0,0,0,2021-01-24,1611442800.0
2745,4,3,2021-01-25,0,0,0,0,2021-01-25,1611529200.0
2746,4,3,2021-01-26,0,0,0,0,2021-01-26,1611615600.0
2747,4,3,2021-01-27,0,0,0,0,2021-01-27,1611702000.0
2748,4,3,2021-01-28,0,0,0,0,2021-01-28,1611788400.0
2749,4,3,2021-01-29,0,0,0,0,2021-01-29,1611874800.0
2750,4,3,2021-01-30,0,0,0,0,2021-01-30,1611961200.0
2751,4,3,2021-01-31,0,0,0,0,2021-01-31,1612047600.0
2752,4,3,2021-02-01,0,0,0,0,2021-02-01,1612134000.0
2753,4,3,2021-02-02,0,0,0,0,2021-02-02,1612220400.0
2754,4,3,2021-02-03,0,0,0,0,2021-02-03,1612306800.0
2755,4,3,2021-02-04,0,0,0,0,2021-02-04,1612393200.0
2756,4,3,2021-02-05,0,0,0,0,2021-02-05,1612479600.0
2757,4,3,2021-02-06,0,0,0,0,2021-02-06,1612566000.0
2758,4,3,2021-02-07,0,0,0,0,2021-02-07,1612652400.0
2759,4,3,2021-02-08,5,0,5,0,2021-02-08,1612738800.0
2760,4,3,2021-02-09,0,0,5,0,2021-02-09,1612825200.0
2761,4,3,2021-02-10,0,0,5,0,2021-02-10,1612911600.0
2762,4,3,2021-02-11,0,0,5,0,2021-02-11,1612998000.0
2763,4,3,2021-02-12,0,0,5,0,2021-02-12,1613084400.0
2764,4,3,2021-02-13,0,0,5,0,2021-02-13,1613170800.0
2765,4,3,2021-02-14,0,0,5,0,2021-02-14,1613257200.0
2766,4,3,2021-02-15,0,0,5,0,2021-02-15,1613343600.0
2767,4,3,2021-02-16,0,0,5,0,2021-02-16,1613430000.0
2768,4,3,2021-02-17,0,0,5,0,2021-02-17,1613516400.0
2769,4,3,2021-02-18,0,0,5,0,2021-02-18,1613602800.0
2770,4,3,2021-02-19,0,0,5,0,2021-02-19,1613689200.0
2771,4,3,2021-02-20,0,0,5,0,2021-02-20,1613775600.0
2772,4,3,2021-02-21,0,0,5,0,2021-02-21,1613862000.0
2773,4,3,2021-02-22,0,0,5,0,2021-02-22,1613948400.0
2774,4,3,2021-02-23,0,0,5,0,2021-02-23,1614034800.0
2775,4,3,2021-02-24,0,0,5,0,2021-02-24,1614121200.0
2776,4,3,2021-02-25,0,0,5,0,2021-02-25,1614207600.0
2777,4,3,2021-02-26,0,0,5,0,2021-02-26,1614294000.0
2778,4,3,2021-02-27,0,0,5,0,2021-02-27,1614380400.0
2779,4,3,2021-02-28,0,0,5,0,2021-02-28,1614466800.0
2780,4,3,2021-03-01,0,0,5,0,2021-03-01,1614553200.0
2781,4,3,2021-03-02,1,0,6,0,2021-03-02,1614639600.0
2782,4,3,2021-03-03,0,0,6,0,2021-03-03,1614726000.0
2783,4,3,2021-03-04,1,0,7,0,2021-03-04,1614812400.0
2784,4,3,2021-03-05,0,0,7,0,2021-03-05,1614898800.0
2785,4,3,2021-03-06,0,0,7,0,2021-03-06,1614985200.0
2786,4,3,2021-03-07,0,0,7,0,2021-03-07,1615071600.0
2787,4,3,2021-03-08,0,0,7,0,2021-03-08,1615158000.0
2788,4,3,2021-03-09,0,0,7,0,2021-03-09,1615244400.0
2789,4,3,2021-03-10,0,1,7,1,2021-03-10,1615330800.0
2790,4,3,2021-03-11,0,0,7,1,2021-03-11,1615417200.0
2791,4,3,2021-03-12,0,0,7,1,2021-03-12,1615503600.0
2792,4,3,2021-03-13,0,0,7,1,2021-03-13,1615590000.0
2793,4,3,2021-03-14,0,0,7,1,2021-03-14,1615676400.0
2794,4,3,2021-03-15,0,2,7,3,2021-03-15,1615762800.0
2795,4,3,2021-03-16,0,0,7,3,2021-03-16,1615849200.0
2796,4,3,2021-03-17,0,0,7,3,2021-03-17,1615935600.0
2797,4,3,2021-03-18,0,0,7,3,2021-03-18,1616022000.0
2798,4,3,2021-03-19,0,0,7,3,2021-03-19,1616108400.0
2799,4,3,2021-03-20,0,0,7,3,2021-03-20,1616194800.0
2800,4,3,2021-03-21,0,0,7,3,2021-03-21,1616281200.0
2801,4,3,2021-03-22,0,0,7,3,2021-03-22,1616367600.0
2802,4,3,2021-03-23,0,0,7,3,2021-03-23,1616454000.0
2803,4,3,2021-03-24,0,0,7,3,2021-03-24,1616540400.0
2804,4,3,2021-03-25,0,1,7,4,2021-03-25,1616626800.0
2805,4,3,2021-03-26,0,0,7,4,2021-03-26,1616713200.0
2806,4,3,2021-03-27,0,0,7,4,2021-03-27,1616799600.0
2807,4,3,2021-03-28,0,0,7,4,2021-03-28,1616886000.0
2808,4,3,2021-03-29,0,0,7,4,2021-03-29,1616972400.0
2809,4,3,2021-03-30,0,0,7,4,2021-03-30,1617058800.0
2810,4,3,2021-03-31,0,0,7,4,2021-03-31,1617145200.0
2811,4,3,2021-04-01,0,0,7,4,2021-04-01,1617231600.0
2812,4,3,2021-04-02,0,0,7,4,2021-04-02,1617318000.0
2813,4,3,2021-04-03,0,0,7,4,2021-04-03,1617404400.0
2814,4,3,2021-04-04,0,0,7,4,2021-04-04,1617490800.0
2815,4,3,2021-04-05,0,0,7,4,2021-04-05,1617577200.0
2816,4,3,2021-04-06,0,0,7,4,2021-04-06,1617663600.0
2817,4,3,2021-04-07,0,0,7,4,2021-04-07,1617750000.0
2818,4,3,2021-04-08,0,0,7,4,2021-04-08,1617836400.0
2819,4,3,2021-04-09,0,0,7,4,2021-04-09,1617922800.0
2820,4,3,2021-04-10,0,0,7,4,2021-04-10,1618009200.0
2821,4,3,2021-04-11,0,0,7,4,2021-04-11,1618095600.0
2822,4,3,2021-04-12,0,0,7,4,2021-04-12,1618185600.0
2823,4,3,2021-04-13,0,0,7,4,2021-04-13,1618272000.0
2824,4,3,2021-04-14,0,0,7,4,2021-04-14,1618358400.0
2825,4,3,2021-04-15,0,0,7,4,2021-04-15,1618444800.0
2826,4,3,2021-04-16,0,0,7,4,2021-04-16,1618531200.0
2827,4,3,2021-04-17,0,0,7,4,2021-04-17,1618617600.0
2828,4,3,2021-04-18,0,0,7,4,2021-04-18,1618704000.0
2829,4,3,2021-04-19,0,0,7,4,2021-04-19,1618790400.0
2830,4,3,2021-04-20,0,0,7,4,2021-04-20,1618876800.0
2831,4,3,2021-04-21,0,0,7,4,2021-04-21,1618963200.0
2832,4,3,2021-04-22,0,0,7,4,2021-04-22,1619049600.0
2833,4,3,2021-04-23,0,0,7,4,2021-04-23,1619136000.0
2834,4,3,2021-04-24,0,0,7,4,2021-04-24,1619222400.0
2835,4,3,2021-04-25,0,0,7,4,2021-04-25,1619308800.0
2836,4,3,2021-04-26,0,0,7,4,2021-04-26,1619395200.0
2837,4,3,2021-04-27,0,0,7,4,2021-04-27,1619481600.0
2838,4,3,2021-04-28,0,0,7,4,2021-04-28,1619568000.0
2839,4,3,2021-04-29,0,0,7,4,2021-04-29,1619654400.0
2840,4,3,2021-04-30,0,0,7,4,2021-04-30,1619740800.0
2841,4,3,2021-05-01,0,0,7,4,2021-05-01,1619827200.0
2842,4,3,2021-05-02,0,0,7,4,2021-05-02,1619913600.0
2843,4,3,2021-05-03,0,0,7,4,2021-05-03,1620000000.0
2844,4,3,2021-05-04,0,0,7,4,2021-05-04,1620086400.0
2845,4,3,2021-05-05,0,0,7,4,2021-05-05,1620172800.0
2846,4,3,2021-05-06,0,0,7,4,2021-05-06,1620259200.0
2847,4,3,2021-05-07,0,0,7,4,2021-05-07,1620345600.0
2848,4,3,2021-05-08,0,0,7,4,2021-05-08,1620432000.0
2849,4,3,2021-05-09,0,0,7,4,2021-05-09,1620518400.0
2850,4,3,2021-05-10,0,0,7,4,2021-05-10,1620604800.0
2851,4,3,2021-05-11,0,0,7,4,2021-05-11,1620691200.0
2852,4,3,2021-05-12,0,0,7,4,2021-05-12,1620777600.0
2853,4,3,2021-05-13,0,0,7,4,2021-05-13,1620864000.0
2854,4,3,2021-05-14,0,0,7,4,2021-05-14,1620950400.0
2855,4,3,2021-05-15,0,0,7,4,2021-05-15,1621036800.0
2856,4,3,2021-05-16,0,0,7,4,2021-05-16,1621123200.0
2857,4,3,2021-05-17,0,0,7,4,2021-05-17,1621206000.0
2858,4,3,2021-05-18,0,0,7,4,2021-05-18,1621292400.0
2859,4,3,2021-05-19,0,0,7,4,2021-05-19,1621378800.0
2860,4,3,2021-05-20,0,0,7,4,2021-05-20,1621465200.0
2861,4,3,2021-05-21,0,0,7,4,2021-05-21,1621551600.0
2862,4,3,2021-05-22,0,0,7,4,2021-05-22,1621638000.0
2863,4,3,2021-05-23,0,0,7,4,2021-05-23,1621724400.0
2864,4,3,2021-05-24,0,0,7,4,2021-05-24,1621810800.0
2865,4,3,2021-05-25,0,0,7,4,2021-05-25,1621897200.0
2866,4,3,2021-05-26,0,0,7,4,2021-05-26,1621983600.0
2867,4,3,2021-05-27,0,0,7,4,2021-05-27,1622070000.0
2868,4,3,2021-05-28,0,0,7,4,2021-05-28,1622156400.0
2869,4,3,2021-05-29,0,0,7,4,2021-05-29,1622242800.0
2870,4,3,2021-05-30,0,0,7,4,2021-05-30,1622329200.0
2871,4,3,2021-05-31,0,0,7,4,2021-05-31,1622415600.0
2872,4,3,2021-06-01,0,0,7,4,2021-06-01,1622502000.0
2873,4,3,2021-06-02,0,0,7,4,2021-06-02,1622588400.0
2874,4,3,2021-06-03,0,0,7,4,2021-06-03,1622674800.0
2875,4,3,2021-06-04,0,0,7,4,2021-06-04,1622761200.0
2876,4,3,2021-06-05,0,0,7,4,2021-06-05,1622847600.0
2877,4,3,2021-06-06,0,0,7,4,2021-06-06,1622934000.0
2878,4,3,2021-06-07,0,0,7,4,2021-06-07,1623020400.0
2879,4,3,2021-06-08,0,0,7,4,2021-06-08,1623106800.0
2880,4,3,2021-06-09,0,0,7,4,2021-06-09,1623193200.0
2881,4,3,2021-06-10,0,0,7,4,2021-06-10,1623279600.0
2882,4,3,2021-06-11,0,0,7,4,2021-06-11,1623366000.0
2883,4,3,2021-06-12,0,0,7,4,2021-06-12,1623452400.0
2884,4,3,2021-06-13,0,0,7,4,2021-06-13,1623538800.0
2885,4,3,2021-06-14,0,0,7,4,2021-06-14,1623625200.0
2886,4,3,2021-06-15,0,0,7,4,2021-06-15,1623711600.0
2887,4,3,2021-06-16,0,0,7,4,2021-06-16,1623798000.0
2888,4,3,2021-06-17,0,0,7,4,2021-06-17,1623884400.0
2889,4,3,2021-06-18,0,0,7,4,2021-06-18,1623970800.0
2890,4,3,2021-06-19,0,0,7,4,2021-06-19,1624057200.0
2891,4,3,2021-06-20,0,0,7,4,2021-06-20,1624143600.0
2892,4,3,2021-06-21,0,0,7,4,2021-06-21,1624230000.0
2893,4,3,2021-06-22,0,0,7,4,2021-06-22,1624316400.0
2894,4,3,2021-06-23,0,0,7,4,2021-06-23,1624402800.0
2895,4,3,2021-06-24,0,0,7,4,2021-06-24,1624489200.0
2896,4,3,2021-06-25,0,0,7,4,2021-06-25,1624575600.0
2897,4,3,2021-06-26,0,0,7,4,2021-06-26,1624662000.0
2898,4,3,2021-06-27,0,0,7,4,2021-06-27,1624748400.0
2899,4,3,2021-06-28,0,0,7,4,2021-06-28,1624834800.0
2900,4,3,2021-06-29,0,0,7,4,2021-06-29,1624921200.0
2901,4,3,2021-06-30,0,0,7,4,2021-06-30,1625007600.0
2902,4,3,2021-07-01,0,0,7,4,2021-07-01,1625094000.0
2903,4,3,2021-07-02,0,0,7,4,2021-07-02,1625180400.0
2904,4,3,2021-07-03,0,0,7,4,2021-07-03,1625266800.0
2905,4,3,2021-07-04,0,0,7,4,2021-07-04,1625353200.0
2906,4,3,2021-07-05,0,0,7,4,2021-07-05,1625439600.0
2907,4,3,2021-07-06,0,0,7,4,2021-07-06,1625526000.0
2908,4,3,2021-07-07,0,0,7,4,2021-07-07,1625612400.0
2909,4,3,2021-07-08,0,0,7,4,2021-07-08,1625698800.0
2910,4,4,2020-12-27,0,0,0,0,2020-12-27,1609023600.0
2911,4,4,2020-12-28,0,0,0,0,2020-12-28,1609110000.0
2912,4,4,2020-12-29,0,0,0,0,2020-12-29,1609196400.0
2913,4,4,2020-12-30,0,0,0,0,2020-12-30,1609282800.0
2914,4,4,2020-12-31,0,0,0,0,2020-12-31,1609369200.0
2915,4,4,2021-01-01,0,0,0,0,2021-01-01,1609455600.0
2916,4,4,2021-01-02,0,0,0,0,2021-01-02,1609542000.0
2917,4,4,2021-01-03,0,0,0,0,2021-01-03,1609628400.0
2918,4,4,2021-01-04,0,0,0,0,2021-01-04,1609714800.0
2919,4,4,2021-01-05,0,0,0,0,2021-01-05,1609801200.0
2920,4,4,2021-01-06,0,0,0,0,2021-01-06,1609887600.0
2921,4,4,2021-01-07,0,0,0,0,2021-01-07,1609974000.0
2922,4,4,2021-01-08,0,0,0,0,2021-01-08,1610060400.0
2923,4,4,2021-01-09,0,0,0,0,2021-01-09,1610146800.0
2924,4,4,2021-01-10,0,0,0,0,2021-01-10,1610233200.0
2925,4,4,2021-01-11,0,0,0,0,2021-01-11,1610319600.0
2926,4,4,2021-01-12,0,0,0,0,2021-01-12,1610406000.0
2927,4,4,2021-01-13,0,0,0,0,2021-01-13,1610492400.0
2928,4,4,2021-01-14,0,0,0,0,2021-01-14,1610578800.0
2929,4,4,2021-01-15,0,0,0,0,2021-01-15,1610665200.0
2930,4,4,2021-01-16,0,0,0,0,2021-01-16,1610751600.0
2931,4,4,2021-01-17,0,0,0,0,2021-01-17,1610838000.0
2932,4,4,2021-01-18,0,0,0,0,2021-01-18,1610924400.0
2933,4,4,2021-01-19,0,0,0,0,2021-01-19,1611010800.0
2934,4,4,2021-01-20,0,0,0,0,2021-01-20,1611097200.0
2935,4,4,2021-01-21,0,0,0,0,2021-01-21,1611183600.0
2936,4,4,2021-01-22,0,0,0,0,2021-01-22,1611270000.0
2937,4,4,2021-01-23,0,0,0,0,2021-01-23,1611356400.0
2938,4,4,2021-01-24,0,0,0,0,2021-01-24,1611442800.0
2939,4,4,2021-01-25,0,0,0,0,2021-01-25,1611529200.0
2940,4,4,2021-01-26,0,0,0,0,2021-01-26,1611615600.0
2941,4,4,2021-01-27,0,0,0,0,2021-01-27,1611702000.0
2942,4,4,2021-01-28,0,0,0,0,2021-01-28,1611788400.0
2943,4,4,2021-01-29,0,0,0,0,2021-01-29,1611874800.0
2944,4,4,2021-01-30,0,0,0,0,2021-01-30,1611961200.0
2945,4,4,2021-01-31,0,0,0,0,2021-01-31,1612047600.0
2946,4,4,2021-02-01,0,0,0,0,2021-02-01,1612134000.0
2947,4,4,2021-02-02,0,0,0,0,2021-02-02,1612220400.0
2948,4,4,2021-02-03,0,0,0,0,2021-02-03,1612306800.0
2949,4,4,2021-02-04,0,0,0,0,2021-02-04,1612393200.0
2950,4,4,2021-02-05,0,0,0,0,2021-02-05,1612479600.0
2951,4,4,2021-02-06,0,0,0,0,2021-02-06,1612566000.0
2952,4,4,2021-02-07,0,0,0,0,2021-02-07,1612652400.0
2953,4,4,2021-02-08,0,0,0,0,2021-02-08,1612738800.0
2954,4,4,2021-02-09,0,0,0,0,2021-02-09,1612825200.0
2955,4,4,2021-02-10,0,0,0,0,2021-02-10,1612911600.0
2956,4,4,2021-02-11,0,0,0,0,2021-02-11,1612998000.0
2957,4,4,2021-02-12,0,0,0,0,2021-02-12,1613084400.0
2958,4,4,2021-02-13,0,0,0,0,2021-02-13,1613170800.0
2959,4,4,2021-02-14,0,0,0,0,2021-02-14,1613257200.0
2960,4,4,2021-02-15,0,0,0,0,2021-02-15,1613343600.0
2961,4,4,2021-02-16,0,0,0,0,2021-02-16,1613430000.0
2962,4,4,2021-02-17,0,0,0,0,2021-02-17,1613516400.0
2963,4,4,2021-02-18,0,0,0,0,2021-02-18,1613602800.0
2964,4,4,2021-02-19,0,0,0,0,2021-02-19,1613689200.0
2965,4,4,2021-02-20,0,0,0,0,2021-02-20,1613775600.0
2966,4,4,2021-02-21,0,0,0,0,2021-02-21,1613862000.0
2967,4,4,2021-02-22,0,0,0,0,2021-02-22,1613948400.0
2968,4,4,2021-02-23,0,0,0,0,2021-02-23,1614034800.0
2969,4,4,2021-02-24,0,0,0,0,2021-02-24,1614121200.0
2970,4,4,2021-02-25,0,0,0,0,2021-02-25,1614207600.0
2971,4,4,2021-02-26,0,0,0,0,2021-02-26,1614294000.0
2972,4,4,2021-02-27,0,0,0,0,2021-02-27,1614380400.0
2973,4,4,2021-02-28,0,0,0,0,2021-02-28,1614466800.0
2974,4,4,2021-03-01,0,0,0,0,2021-03-01,1614553200.0
2975,4,4,2021-03-02,0,0,0,0,2021-03-02,1614639600.0
2976,4,4,2021-03-03,0,0,0,0,2021-03-03,1614726000.0
2977,4,4,2021-03-04,0,0,0,0,2021-03-04,1614812400.0
2978,4,4,2021-03-05,0,0,0,0,2021-03-05,1614898800.0
2979,4,4,2021-03-06,0,0,0,0,2021-03-06,1614985200.0
2980,4,4,2021-03-07,0,0,0,0,2021-03-07,1615071600.0
2981,4,4,2021-03-08,0,0,0,0,2021-03-08,1615158000.0
2982,4,4,2021-03-09,0,0,0,0,2021-03-09,1615244400.0
2983,4,4,2021-03-10,0,0,0,0,2021-03-10,1615330800.0
2984,4,4,2021-03-11,0,0,0,0,2021-03-11,1615417200.0
2985,4,4,2021-03-12,0,0,0,0,2021-03-12,1615503600.0
2986,4,4,2021-03-13,0,0,0,0,2021-03-13,1615590000.0
2987,4,4,2021-03-14,0,0,0,0,2021-03-14,1615676400.0
2988,4,4,2021-03-15,0,0,0,0,2021-03-15,1615762800.0
2989,4,4,2021-03-16,0,0,0,0,2021-03-16,1615849200.0
2990,4,4,2021-03-17,0,0,0,0,2021-03-17,1615935600.0
2991,4,4,2021-03-18,0,0,0,0,2021-03-18,1616022000.0
2992,4,4,2021-03-19,0,0,0,0,2021-03-19,1616108400.0
2993,4,4,2021-03-20,0,0,0,0,2021-03-20,1616194800.0
2994,4,4,2021-03-21,0,0,0,0,2021-03-21,1616281200.0
2995,4,4,2021-03-22,0,0,0,0,2021-03-22,1616367600.0
2996,4,4,2021-03-23,0,0,0,0,2021-03-23,1616454000.0
2997,4,4,2021-03-24,0,0,0,0,2021-03-24,1616540400.0
2998,4,4,2021-03-25,0,0,0,0,2021-03-25,1616626800.0
2999,4,4,2021-03-26,0,0,0,0,2021-03-26,1616713200.0
3000,4,4,2021-03-27,0,0,0,0,2021-03-27,1616799600.0
3001,4,4,2021-03-28,0,0,0,0,2021-03-28,1616886000.0
3002,4,4,2021-03-29,0,0,0,0,2021-03-29,1616972400.0
3003,4,4,2021-03-30,0,0,0,0,2021-03-30,1617058800.0
3004,4,4,2021-03-31,0,0,0,0,2021-03-31,1617145200.0
3005,4,4,2021-04-01,0,0,0,0,2021-04-01,1617231600.0
3006,4,4,2021-04-02,0,0,0,0,2021-04-02,1617318000.0
3007,4,4,2021-04-03,0,0,0,0,2021-04-03,1617404400.0
3008,4,4,2021-04-04,0,0,0,0,2021-04-04,1617490800.0
3009,4,4,2021-04-05,0,0,0,0,2021-04-05,1617577200.0
3010,4,4,2021-04-06,0,0,0,0,2021-04-06,1617663600.0
3011,4,4,2021-04-07,0,0,0,0,2021-04-07,1617750000.0
3012,4,4,2021-04-08,0,0,0,0,2021-04-08,1617836400.0
3013,4,4,2021-04-09,0,0,0,0,2021-04-09,1617922800.0
3014,4,4,2021-04-10,0,0,0,0,2021-04-10,1618009200.0
3015,4,4,2021-04-11,0,0,0,0,2021-04-11,1618095600.0
3016,4,4,2021-04-12,0,0,0,0,2021-04-12,1618185600.0
3017,4,4,2021-04-13,0,0,0,0,2021-04-13,1618272000.0
3018,4,4,2021-04-14,0,0,0,0,2021-04-14,1618358400.0
3019,4,4,2021-04-15,0,0,0,0,2021-04-15,1618444800.0
3020,4,4,2021-04-16,0,0,0,0,2021-04-16,1618531200.0
3021,4,4,2021-04-17,0,0,0,0,2021-04-17,1618617600.0
3022,4,4,2021-04-18,0,0,0,0,2021-04-18,1618704000.0
3023,4,4,2021-04-19,0,0,0,0,2021-04-19,1618790400.0
3024,4,4,2021-04-20,0,0,0,0,2021-04-20,1618876800.0
3025,4,4,2021-04-21,0,0,0,0,2021-04-21,1618963200.0
3026,4,4,2021-04-22,0,0,0,0,2021-04-22,1619049600.0
3027,4,4,2021-04-23,0,0,0,0,2021-04-23,1619136000.0
3028,4,4,2021-04-24,0,0,0,0,2021-04-24,1619222400.0
3029,4,4,2021-04-25,0,0,0,0,2021-04-25,1619308800.0
3030,4,4,2021-04-26,0,0,0,0,2021-04-26,1619395200.0
3031,4,4,2021-04-27,0,0,0,0,2021-04-27,1619481600.0
3032,4,4,2021-04-28,0,0,0,0,2021-04-28,1619568000.0
3033,4,4,2021-04-29,0,0,0,0,2021-04-29,1619654400.0
3034,4,4,2021-04-30,0,0,0,0,2021-04-30,1619740800.0
3035,4,4,2021-05-01,0,0,0,0,2021-05-01,1619827200.0
3036,4,4,2021-05-02,0,0,0,0,2021-05-02,1619913600.0
3037,4,4,2021-05-03,0,0,0,0,2021-05-03,1620000000.0
3038,4,4,2021-05-04,0,0,0,0,2021-05-04,1620086400.0
3039,4,4,2021-05-05,0,0,0,0,2021-05-05,1620172800.0
3040,4,4,2021-05-06,0,0,0,0,2021-05-06,1620259200.0
3041,4,4,2021-05-07,0,0,0,0,2021-05-07,1620345600.0
3042,4,4,2021-05-08,0,0,0,0,2021-05-08,1620432000.0
3043,4,4,2021-05-09,0,0,0,0,2021-05-09,1620518400.0
3044,4,4,2021-05-10,0,0,0,0,2021-05-10,1620604800.0
3045,4,4,2021-05-11,20,0,20,0,2021-05-11,1620691200.0
3046,4,4,2021-05-12,45,0,65,0,2021-05-12,1620777600.0
3047,4,4,2021-05-13,1,0,66,0,2021-05-13,1620864000.0
3048,4,4,2021-05-14,78,0,144,0,2021-05-14,1620950400.0
3049,4,4,2021-05-15,20,0,164,0,2021-05-15,1621036800.0
3050,4,4,2021-05-16,12,0,176,0,2021-05-16,1621123200.0
3051,4,4,2021-05-17,73,0,249,0,2021-05-17,1621206000.0
3052,4,4,2021-05-18,164,0,413,0,2021-05-18,1621292400.0
3053,4,4,2021-05-19,110,0,523,0,2021-05-19,1621378800.0
3054,4,4,2021-05-20,92,0,615,0,2021-05-20,1621465200.0
3055,4,4,2021-05-21,158,0,773,0,2021-05-21,1621551600.0
3056,4,4,2021-05-22,85,0,858,0,2021-05-22,1621638000.0
3057,4,4,2021-05-23,3,0,861,0,2021-05-23,1621724400.0
3058,4,4,2021-05-24,53,0,914,0,2021-05-24,1621810800.0
3059,4,4,2021-05-25,315,0,1229,0,2021-05-25,1621897200.0
3060,4,4,2021-05-26,262,0,1491,0,2021-05-26,1621983600.0
3061,4,4,2021-05-27,310,1,1801,1,2021-05-27,1622070000.0
3062,4,4,2021-05-28,242,0,2043,1,2021-05-28,1622156400.0
3063,4,4,2021-05-29,155,0,2198,1,2021-05-29,1622242800.0
3064,4,4,2021-05-30,1,0,2199,1,2021-05-30,1622329200.0
3065,4,4,2021-05-31,208,0,2407,1,2021-05-31,1622415600.0
3066,4,4,2021-06-01,300,0,2707,1,2021-06-01,1622502000.0
3067,4,4,2021-06-02,231,2,2938,3,2021-06-02,1622588400.0
3068,4,4,2021-06-03,260,0,3198,3,2021-06-03,1622674800.0
3069,4,4,2021-06-04,271,1,3469,4,2021-06-04,1622761200.0
3070,4,4,2021-06-05,93,0,3562,4,2021-06-05,1622847600.0
3071,4,4,2021-06-06,24,0,3586,4,2021-06-06,1622934000.0
3072,4,4,2021-06-07,169,0,3755,4,2021-06-07,1623020400.0
3073,4,4,2021-06-08,225,0,3980,4,2021-06-08,1623106800.0
3074,4,4,2021-06-09,152,0,4132,4,2021-06-09,1623193200.0
3075,4,4,2021-06-10,142,0,4274,4,2021-06-10,1623279600.0
3076,4,4,2021-06-11,155,0,4429,4,2021-06-11,1623366000.0
3077,4,4,2021-06-12,140,0,4569,4,2021-06-12,1623452400.0
3078,4,4,2021-06-13,35,0,4604,4,2021-06-13,1623538800.0
3079,4,4,2021-06-14,105,0,4709,4,2021-06-14,1623625200.0
3080,4,4,2021-06-15,217,0,4926,4,2021-06-15,1623711600.0
3081,4,4,2021-06-16,181,0,5107,4,2021-06-16,1623798000.0
3082,4,4,2021-06-17,130,1,5237,5,2021-06-17,1623884400.0
3083,4,4,2021-06-18,144,0,5381,5,2021-06-18,1623970800.0
3084,4,4,2021-06-19,74,0,5455,5,2021-06-19,1624057200.0
3085,4,4,2021-06-20,22,0,5477,5,2021-06-20,1624143600.0
3086,4,4,2021-06-21,101,0,5578,5,2021-06-21,1624230000.0
3087,4,4,2021-06-22,165,0,5743,5,2021-06-22,1624316400.0
3088,4,4,2021-06-23,98,0,5841,5,2021-06-23,1624402800.0
3089,4,4,2021-06-24,119,0,5960,5,2021-06-24,1624489200.0
3090,4,4,2021-06-25,117,0,6077,5,2021-06-25,1624575600.0
3091,4,4,2021-06-26,70,0,6147,5,2021-06-26,1624662000.0
3092,4,4,2021-06-27,48,1,6195,6,2021-06-27,1624748400.0
3093,4,4,2021-06-28,62,0,6257,6,2021-06-28,1624834800.0
3094,4,4,2021-06-29,134,0,6391,6,2021-06-29,1624921200.0
3095,4,4,2021-06-30,129,0,6520,6,2021-06-30,1625007600.0
3096,4,4,2021-07-01,117,0,6637,6,2021-07-01,1625094000.0
3097,4,4,2021-07-02,144,0,6781,6,2021-07-02,1625180400.0
3098,4,4,2021-07-03,90,1,6871,7,2021-07-03,1625266800.0
3099,4,4,2021-07-04,51,0,6922,7,2021-07-04,1625353200.0
3100,4,4,2021-07-05,103,0,7025,7,2021-07-05,1625439600.0
3101,4,4,2021-07-06,152,0,7177,7,2021-07-06,1625526000.0
3102,4,4,2021-07-07,125,0,7302,7,2021-07-07,1625612400.0
3103,4,4,2021-07-08,114,0,7416,7,2021-07-08,1625698800.0
3104,5,1,2020-12-27,0,0,0,0,2020-12-27,1609023600.0
3105,5,1,2020-12-28,0,0,0,0,2020-12-28,1609110000.0
3106,5,1,2020-12-29,0,0,0,0,2020-12-29,1609196400.0
3107,5,1,2020-12-30,0,0,0,0,2020-12-30,1609282800.0
3108,5,1,2020-12-31,0,0,0,0,2020-12-31,1609369200.0
3109,5,1,2021-01-01,0,0,0,0,2021-01-01,1609455600.0
3110,5,1,2021-01-02,0,0,0,0,2021-01-02,1609542000.0
3111,5,1,2021-01-03,0,0,0,0,2021-01-03,1609628400.0
3112,5,1,2021-01-04,0,0,0,0,2021-01-04,1609714800.0
3113,5,1,2021-01-05,0,0,0,0,2021-01-05,1609801200.0
3114,5,1,2021-01-06,0,0,0,0,2021-01-06,1609887600.0
3115,5,1,2021-01-07,0,0,0,0,2021-01-07,1609974000.0
3116,5,1,2021-01-08,0,0,0,0,2021-01-08,1610060400.0
3117,5,1,2021-01-09,0,0,0,0,2021-01-09,1610146800.0
3118,5,1,2021-01-10,0,0,0,0,2021-01-10,1610233200.0
3119,5,1,2021-01-11,0,0,0,0,2021-01-11,1610319600.0
3120,5,1,2021-01-12,0,0,0,0,2021-01-12,1610406000.0
3121,5,1,2021-01-13,0,0,0,0,2021-01-13,1610492400.0
3122,5,1,2021-01-14,0,0,0,0,2021-01-14,1610578800.0
3123,5,1,2021-01-15,0,0,0,0,2021-01-15,1610665200.0
3124,5,1,2021-01-16,0,0,0,0,2021-01-16,1610751600.0
3125,5,1,2021-01-17,0,0,0,0,2021-01-17,1610838000.0
3126,5,1,2021-01-18,0,0,0,0,2021-01-18,1610924400.0
3127,5,1,2021-01-19,0,0,0,0,2021-01-19,1611010800.0
3128,5,1,2021-01-20,0,0,0,0,2021-01-20,1611097200.0
3129,5,1,2021-01-21,0,0,0,0,2021-01-21,1611183600.0
3130,5,1,2021-01-22,0,0,0,0,2021-01-22,1611270000.0
3131,5,1,2021-01-23,0,0,0,0,2021-01-23,1611356400.0
3132,5,1,2021-01-24,0,0,0,0,2021-01-24,1611442800.0
3133,5,1,2021-01-25,0,0,0,0,2021-01-25,1611529200.0
3134,5,1,2021-01-26,0,0,0,0,2021-01-26,1611615600.0
3135,5,1,2021-01-27,0,0,0,0,2021-01-27,1611702000.0
3136,5,1,2021-01-28,0,0,0,0,2021-01-28,1611788400.0
3137,5,1,2021-01-29,0,0,0,0,2021-01-29,1611874800.0
3138,5,1,2021-01-30,0,0,0,0,2021-01-30,1611961200.0
3139,5,1,2021-01-31,0,0,0,0,2021-01-31,1612047600.0
3140,5,1,2021-02-01,0,0,0,0,2021-02-01,1612134000.0
3141,5,1,2021-02-02,0,0,0,0,2021-02-02,1612220400.0
3142,5,1,2021-02-03,0,0,0,0,2021-02-03,1612306800.0
3143,5,1,2021-02-04,0,0,0,0,2021-02-04,1612393200.0
3144,5,1,2021-02-05,0,0,0,0,2021-02-05,1612479600.0
3145,5,1,2021-02-06,0,0,0,0,2021-02-06,1612566000.0
3146,5,1,2021-02-07,0,0,0,0,2021-02-07,1612652400.0
3147,5,1,2021-02-08,0,0,0,0,2021-02-08,1612738800.0
3148,5,1,2021-02-09,0,0,0,0,2021-02-09,1612825200.0
3149,5,1,2021-02-10,0,0,0,0,2021-02-10,1612911600.0
3150,5,1,2021-02-11,0,0,0,0,2021-02-11,1612998000.0
3151,5,1,2021-02-12,0,0,0,0,2021-02-12,1613084400.0
3152,5,1,2021-02-13,0,0,0,0,2021-02-13,1613170800.0
3153,5,1,2021-02-14,0,0,0,0,2021-02-14,1613257200.0
3154,5,1,2021-02-15,0,0,0,0,2021-02-15,1613343600.0
3155,5,1,2021-02-16,0,0,0,0,2021-02-16,1613430000.0
3156,5,1,2021-02-17,0,0,0,0,2021-02-17,1613516400.0
3157,5,1,2021-02-18,0,0,0,0,2021-02-18,1613602800.0
3158,5,1,2021-02-19,0,0,0,0,2021-02-19,1613689200.0
3159,5,1,2021-02-20,0,0,0,0,2021-02-20,1613775600.0
3160,5,1,2021-02-21,0,0,0,0,2021-02-21,1613862000.0
3161,5,1,2021-02-22,0,0,0,0,2021-02-22,1613948400.0
3162,5,1,2021-02-23,0,0,0,0,2021-02-23,1614034800.0
3163,5,1,2021-02-24,0,0,0,0,2021-02-24,1614121200.0
3164,5,1,2021-02-25,0,0,0,0,2021-02-25,1614207600.0
3165,5,1,2021-02-26,0,0,0,0,2021-02-26,1614294000.0
3166,5,1,2021-02-27,0,0,0,0,2021-02-27,1614380400.0
3167,5,1,2021-02-28,0,0,0,0,2021-02-28,1614466800.0
3168,5,1,2021-03-01,0,0,0,0,2021-03-01,1614553200.0
3169,5,1,2021-03-02,0,0,0,0,2021-03-02,1614639600.0
3170,5,1,2021-03-03,0,0,0,0,2021-03-03,1614726000.0
3171,5,1,2021-03-04,0,0,0,0,2021-03-04,1614812400.0
3172,5,1,2021-03-05,0,0,0,0,2021-03-05,1614898800.0
3173,5,1,2021-03-06,0,0,0,0,2021-03-06,1614985200.0
3174,5,1,2021-03-07,0,0,0,0,2021-03-07,1615071600.0
3175,5,1,2021-03-08,0,0,0,0,2021-03-08,1615158000.0
3176,5,1,2021-03-09,0,0,0,0,2021-03-09,1615244400.0
3177,5,1,2021-03-10,0,0,0,0,2021-03-10,1615330800.0
3178,5,1,2021-03-11,0,0,0,0,2021-03-11,1615417200.0
3179,5,1,2021-03-12,0,0,0,0,2021-03-12,1615503600.0
3180,5,1,2021-03-13,0,0,0,0,2021-03-13,1615590000.0
3181,5,1,2021-03-14,0,0,0,0,2021-03-14,1615676400.0
3182,5,1,2021-03-15,0,0,0,0,2021-03-15,1615762800.0
3183,5,1,2021-03-16,0,0,0,0,2021-03-16,1615849200.0
3184,5,1,2021-03-17,0,0,0,0,2021-03-17,1615935600.0
3185,5,1,2021-03-18,0,0,0,0,2021-03-18,1616022000.0
3186,5,1,2021-03-19,0,0,0,0,2021-03-19,1616108400.0
3187,5,1,2021-03-20,0,0,0,0,2021-03-20,1616194800.0
3188,5,1,2021-03-21,0,0,0,0,2021-03-21,1616281200.0
3189,5,1,2021-03-22,0,0,0,0,2021-03-22,1616367600.0
3190,5,1,2021-03-23,0,0,0,0,2021-03-23,1616454000.0
3191,5,1,2021-03-24,0,0,0,0,2021-03-24,1616540400.0
3192,5,1,2021-03-25,0,0,0,0,2021-03-25,1616626800.0
3193,5,1,2021-03-26,0,0,0,0,2021-03-26,1616713200.0
3194,5,1,2021-03-27,0,0,0,0,2021-03-27,1616799600.0
3195,5,1,2021-03-28,0,0,0,0,2021-03-28,1616886000.0
3196,5,1,2021-03-29,0,0,0,0,2021-03-29,1616972400.0
3197,5,1,2021-03-30,0,0,0,0,2021-03-30,1617058800.0
3198,5,1,2021-03-31,0,0,0,0,2021-03-31,1617145200.0
3199,5,1,2021-04-01,0,0,0,0,2021-04-01,1617231600.0
3200,5,1,2021-04-02,0,0,0,0,2021-04-02,1617318000.0
3201,5,1,2021-04-03,0,0,0,0,2021-04-03,1617404400.0
3202,5,1,2021-04-04,0,0,0,0,2021-04-04,1617490800.0
3203,5,1,2021-04-05,0,0,0,0,2021-04-05,1617577200.0
3204,5,1,2021-04-06,0,0,0,0,2021-04-06,1617663600.0
3205,5,1,2021-04-07,0,0,0,0,2021-04-07,1617750000.0
3206,5,1,2021-04-08,0,0,0,0,2021-04-08,1617836400.0
3207,5,1,2021-04-09,0,0,0,0,2021-04-09,1617922800.0
3208,5,1,2021-04-10,0,0,0,0,2021-04-10,1618009200.0
3209,5,1,2021-04-11,0,0,0,0,2021-04-11,1618095600.0
3210,5,1,2021-04-12,0,0,0,0,2021-04-12,1618185600.0
3211,5,1,2021-04-13,0,0,0,0,2021-04-13,1618272000.0
3212,5,1,2021-04-14,0,0,0,0,2021-04-14,1618358400.0
3213,5,1,2021-04-15,0,0,0,0,2021-04-15,1618444800.0
3214,5,1,2021-04-16,0,0,0,0,2021-04-16,1618531200.0
3215,5,1,2021-04-17,0,0,0,0,2021-04-17,1618617600.0
3216,5,1,2021-04-18,0,0,0,0,2021-04-18,1618704000.0
3217,5,1,2021-04-19,0,0,0,0,2021-04-19,1618790400.0
3218,5,1,2021-04-20,0,0,0,0,2021-04-20,1618876800.0
3219,5,1,2021-04-21,0,0,0,0,2021-04-21,1618963200.0
3220,5,1,2021-04-22,0,0,0,0,2021-04-22,1619049600.0
3221,5,1,2021-04-23,0,0,0,0,2021-04-23,1619136000.0
3222,5,1,2021-04-24,0,0,0,0,2021-04-24,1619222400.0
3223,5,1,2021-04-25,0,0,0,0,2021-04-25,1619308800.0
3224,5,1,2021-04-26,0,0,0,0,2021-04-26,1619395200.0
3225,5,1,2021-04-27,0,0,0,0,2021-04-27,1619481600.0
3226,5,1,2021-04-28,0,0,0,0,2021-04-28,1619568000.0
3227,5,1,2021-04-29,0,0,0,0,2021-04-29,1619654400.0
3228,5,1,2021-04-30,0,0,0,0,2021-04-30,1619740800.0
3229,5,1,2021-05-01,0,0,0,0,2021-05-01,1619827200.0
3230,5,1,2021-05-02,0,0,0,0,2021-05-02,1619913600.0
3231,5,1,2021-05-03,0,0,0,0,2021-05-03,1620000000.0
3232,5,1,2021-05-04,0,0,0,0,2021-05-04,1620086400.0
3233,5,1,2021-05-05,0,0,0,0,2021-05-05,1620172800.0
3234,5,1,2021-05-06,0,0,0,0,2021-05-06,1620259200.0
3235,5,1,2021-05-07,0,0,0,0,2021-05-07,1620345600.0
3236,5,1,2021-05-08,0,0,0,0,2021-05-08,1620432000.0
3237,5,1,2021-05-09,0,0,0,0,2021-05-09,1620518400.0
3238,5,1,2021-05-10,0,0,0,0,2021-05-10,1620604800.0
3239,5,1,2021-05-11,0,0,0,0,2021-05-11,1620691200.0
3240,5,1,2021-05-12,0,0,0,0,2021-05-12,1620777600.0
3241,5,1,2021-05-13,0,0,0,0,2021-05-13,1620864000.0
3242,5,1,2021-05-14,0,0,0,0,2021-05-14,1620950400.0
3243,5,1,2021-05-15,0,0,0,0,2021-05-15,1621036800.0
3244,5,1,2021-05-16,0,0,0,0,2021-05-16,1621123200.0
3245,5,1,2021-05-17,0,0,0,0,2021-05-17,1621206000.0
3246,5,1,2021-05-18,0,0,0,0,2021-05-18,1621292400.0
3247,5,1,2021-05-19,0,0,0,0,2021-05-19,1621378800.0
3248,5,1,2021-05-20,0,0,0,0,2021-05-20,1621465200.0
3249,5,1,2021-05-21,0,0,0,0,2021-05-21,1621551600.0
3250,5,1,2021-05-22,0,0,0,0,2021-05-22,1621638000.0
3251,5,1,2021-05-23,0,0,0,0,2021-05-23,1621724400.0
3252,5,1,2021-05-24,0,0,0,0,2021-05-24,1621810800.0
3253,5,1,2021-05-25,0,0,0,0,2021-05-25,1621897200.0
3254,5,1,2021-05-26,0,0,0,0,2021-05-26,1621983600.0
3255,5,1,2021-05-27,0,0,0,0,2021-05-27,1622070000.0
3256,5,1,2021-05-28,0,0,0,0,2021-05-28,1622156400.0
3257,5,1,2021-05-29,0,0,0,0,2021-05-29,1622242800.0
3258,5,1,2021-05-30,0,0,0,0,2021-05-30,1622329200.0
3259,5,1,2021-05-31,0,0,0,0,2021-05-31,1622415600.0
3260,5,1,2021-06-01,0,0,0,0,2021-06-01,1622502000.0
3261,5,1,2021-06-02,0,0,0,0,2021-06-02,1622588400.0
3262,5,1,2021-06-03,0,0,0,0,2021-06-03,1622674800.0
3263,5,1,2021-06-04,0,0,0,0,2021-06-04,1622761200.0
3264,5,1,2021-06-05,0,0,0,0,2021-06-05,1622847600.0
3265,5,1,2021-06-06,0,0,0,0,2021-06-06,1622934000.0
3266,5,1,2021-06-07,0,0,0,0,2021-06-07,1623020400.0
3267,5,1,2021-06-08,0,0,0,0,2021-06-08,1623106800.0
3268,5,1,2021-06-09,0,0,0,0,2021-06-09,1623193200.0
3269,5,1,2021-06-10,0,0,0,0,2021-06-10,1623279600.0
3270,5,1,2021-06-11,0,0,0,0,2021-06-11,1623366000.0
3271,5,1,2021-06-12,0,0,0,0,2021-06-12,1623452400.0
3272,5,1,2021-06-13,0,0,0,0,2021-06-13,1623538800.0
3273,5,1,2021-06-14,0,0,0,0,2021-06-14,1623625200.0
3274,5,1,2021-06-15,0,0,0,0,2021-06-15,1623711600.0
3275,5,1,2021-06-16,0,0,0,0,2021-06-16,1623798000.0
3276,5,1,2021-06-17,0,0,0,0,2021-06-17,1623884400.0
3277,5,1,2021-06-18,0,0,0,0,2021-06-18,1623970800.0
3278,5,1,2021-06-19,0,0,0,0,2021-06-19,1624057200.0
3279,5,1,2021-06-20,0,0,0,0,2021-06-20,1624143600.0
3280,5,1,2021-06-21,0,0,0,0,2021-06-21,1624230000.0
3281,5,1,2021-06-22,0,0,0,0,2021-06-22,1624316400.0
3282,5,1,2021-06-23,0,0,0,0,2021-06-23,1624402800.0
3283,5,1,2021-06-24,0,0,0,0,2021-06-24,1624489200.0
3284,5,1,2021-06-25,0,0,0,0,2021-06-25,1624575600.0
3285,5,1,2021-06-26,0,0,0,0,2021-06-26,1624662000.0
3286,5,1,2021-06-27,0,0,0,0,2021-06-27,1624748400.0
3287,5,1,2021-06-28,0,0,0,0,2021-06-28,1624834800.0
3288,5,1,2021-06-29,0,0,0,0,2021-06-29,1624921200.0
3289,5,1,2021-06-30,0,0,0,0,2021-06-30,1625007600.0
3290,5,1,2021-07-01,0,0,0,0,2021-07-01,1625094000.0
3291,5,1,2021-07-02,0,0,0,0,2021-07-02,1625180400.0
3292,5,1,2021-07-03,0,0,0,0,2021-07-03,1625266800.0
3293,5,1,2021-07-04,0,0,0,0,2021-07-04,1625353200.0
3294,5,1,2021-07-05,0,0,0,0,2021-07-05,1625439600.0
3295,5,1,2021-07-06,0,0,0,0,2021-07-06,1625526000.0
3296,5,1,2021-07-07,0,0,0,0,2021-07-07,1625612400.0
3297,5,1,2021-07-08,0,0,0,0,2021-07-08,1625698800.0
3298,5,2,2020-12-27,0,0,0,0,2020-12-27,1609023600.0
3299,5,2,2020-12-28,0,0,0,0,2020-12-28,1609110000.0
3300,5,2,2020-12-29,0,0,0,0,2020-12-29,1609196400.0
3301,5,2,2020-12-30,0,0,0,0,2020-12-30,1609282800.0
3302,5,2,2020-12-31,0,0,0,0,2020-12-31,1609369200.0
3303,5,2,2021-01-01,0,0,0,0,2021-01-01,1609455600.0
3304,5,2,2021-01-02,0,0,0,0,2021-01-02,1609542000.0
3305,5,2,2021-01-03,0,0,0,0,2021-01-03,1609628400.0
3306,5,2,2021-01-04,0,0,0,0,2021-01-04,1609714800.0
3307,5,2,2021-01-05,0,0,0,0,2021-01-05,1609801200.0
3308,5,2,2021-01-06,0,0,0,0,2021-01-06,1609887600.0
3309,5,2,2021-01-07,0,0,0,0,2021-01-07,1609974000.0
3310,5,2,2021-01-08,0,0,0,0,2021-01-08,1610060400.0
3311,5,2,2021-01-09,0,0,0,0,2021-01-09,1610146800.0
3312,5,2,2021-01-10,0,0,0,0,2021-01-10,1610233200.0
3313,5,2,2021-01-11,0,0,0,0,2021-01-11,1610319600.0
3314,5,2,2021-01-12,0,0,0,0,2021-01-12,1610406000.0
3315,5,2,2021-01-13,0,0,0,0,2021-01-13,1610492400.0
3316,5,2,2021-01-14,0,0,0,0,2021-01-14,1610578800.0
3317,5,2,2021-01-15,0,0,0,0,2021-01-15,1610665200.0
3318,5,2,2021-01-16,0,0,0,0,2021-01-16,1610751600.0
3319,5,2,2021-01-17,0,0,0,0,2021-01-17,1610838000.0
3320,5,2,2021-01-18,0,0,0,0,2021-01-18,1610924400.0
3321,5,2,2021-01-19,0,0,0,0,2021-01-19,1611010800.0
3322,5,2,2021-01-20,0,0,0,0,2021-01-20,1611097200.0
3323,5,2,2021-01-21,0,0,0,0,2021-01-21,1611183600.0
3324,5,2,2021-01-22,0,0,0,0,2021-01-22,1611270000.0
3325,5,2,2021-01-23,0,0,0,0,2021-01-23,1611356400.0
3326,5,2,2021-01-24,0,0,0,0,2021-01-24,1611442800.0
3327,5,2,2021-01-25,0,0,0,0,2021-01-25,1611529200.0
3328,5,2,2021-01-26,0,0,0,0,2021-01-26,1611615600.0
3329,5,2,2021-01-27,0,0,0,0,2021-01-27,1611702000.0
3330,5,2,2021-01-28,0,0,0,0,2021-01-28,1611788400.0
3331,5,2,2021-01-29,0,0,0,0,2021-01-29,1611874800.0
3332,5,2,2021-01-30,0,0,0,0,2021-01-30,1611961200.0
3333,5,2,2021-01-31,0,0,0,0,2021-01-31,1612047600.0
3334,5,2,2021-02-01,0,0,0,0,2021-02-01,1612134000.0
3335,5,2,2021-02-02,0,0,0,0,2021-02-02,1612220400.0
3336,5,2,2021-02-03,0,0,0,0,2021-02-03,1612306800.0
3337,5,2,2021-02-04,0,0,0,0,2021-02-04,1612393200.0
3338,5,2,2021-02-05,0,0,0,0,2021-02-05,1612479600.0
3339,5,2,2021-02-06,0,0,0,0,2021-02-06,1612566000.0
3340,5,2,2021-02-07,0,0,0,0,2021-02-07,1612652400.0
3341,5,2,2021-02-08,0,0,0,0,2021-02-08,1612738800.0
3342,5,2,2021-02-09,0,0,0,0,2021-02-09,1612825200.0
3343,5,2,2021-02-10,0,0,0,0,2021-02-10,1612911600.0
3344,5,2,2021-02-11,0,0,0,0,2021-02-11,1612998000.0
3345,5,2,2021-02-12,0,0,0,0,2021-02-12,1613084400.0
3346,5,2,2021-02-13,0,0,0,0,2021-02-13,1613170800.0
3347,5,2,2021-02-14,0,0,0,0,2021-02-14,1613257200.0
3348,5,2,2021-02-15,0,0,0,0,2021-02-15,1613343600.0
3349,5,2,2021-02-16,0,0,0,0,2021-02-16,1613430000.0
3350,5,2,2021-02-17,0,0,0,0,2021-02-17,1613516400.0
3351,5,2,2021-02-18,0,0,0,0,2021-02-18,1613602800.0
3352,5,2,2021-02-19,0,0,0,0,2021-02-19,1613689200.0
3353,5,2,2021-02-20,0,0,0,0,2021-02-20,1613775600.0
3354,5,2,2021-02-21,0,0,0,0,2021-02-21,1613862000.0
3355,5,2,2021-02-22,0,0,0,0,2021-02-22,1613948400.0
3356,5,2,2021-02-23,0,0,0,0,2021-02-23,1614034800.0
3357,5,2,2021-02-24,0,0,0,0,2021-02-24,1614121200.0
3358,5,2,2021-02-25,0,0,0,0,2021-02-25,1614207600.0
3359,5,2,2021-02-26,0,0,0,0,2021-02-26,1614294000.0
3360,5,2,2021-02-27,0,0,0,0,2021-02-27,1614380400.0
3361,5,2,2021-02-28,0,0,0,0,2021-02-28,1614466800.0
3362,5,2,2021-03-01,0,0,0,0,2021-03-01,1614553200.0
3363,5,2,2021-03-02,0,0,0,0,2021-03-02,1614639600.0
3364,5,2,2021-03-03,0,0,0,0,2021-03-03,1614726000.0
3365,5,2,2021-03-04,0,0,0,0,2021-03-04,1614812400.0
3366,5,2,2021-03-05,0,0,0,0,2021-03-05,1614898800.0
3367,5,2,2021-03-06,0,0,0,0,2021-03-06,1614985200.0
3368,5,2,2021-03-07,0,0,0,0,2021-03-07,1615071600.0
3369,5,2,2021-03-08,0,0,0,0,2021-03-08,1615158000.0
3370,5,2,2021-03-09,0,0,0,0,2021-03-09,1615244400.0
3371,5,2,2021-03-10,0,0,0,0,2021-03-10,1615330800.0
3372,5,2,2021-03-11,0,0,0,0,2021-03-11,1615417200.0
3373,5,2,2021-03-12,0,0,0,0,2021-03-12,1615503600.0
3374,5,2,2021-03-13,0,0,0,0,2021-03-13,1615590000.0
3375,5,2,2021-03-14,0,0,0,0,2021-03-14,1615676400.0
3376,5,2,2021-03-15,0,0,0,0,2021-03-15,1615762800.0
3377,5,2,2021-03-16,0,0,0,0,2021-03-16,1615849200.0
3378,5,2,2021-03-17,0,0,0,0,2021-03-17,1615935600.0
3379,5,2,2021-03-18,0,0,0,0,2021-03-18,1616022000.0
3380,5,2,2021-03-19,0,0,0,0,2021-03-19,1616108400.0
3381,5,2,2021-03-20,0,0,0,0,2021-03-20,1616194800.0
3382,5,2,2021-03-21,0,0,0,0,2021-03-21,1616281200.0
3383,5,2,2021-03-22,0,0,0,0,2021-03-22,1616367600.0
3384,5,2,2021-03-23,0,0,0,0,2021-03-23,1616454000.0
3385,5,2,2021-03-24,0,0,0,0,2021-03-24,1616540400.0
3386,5,2,2021-03-25,0,0,0,0,2021-03-25,1616626800.0
3387,5,2,2021-03-26,0,0,0,0,2021-03-26,1616713200.0
3388,5,2,2021-03-27,0,0,0,0,2021-03-27,1616799600.0
3389,5,2,2021-03-28,0,0,0,0,2021-03-28,1616886000.0
3390,5,2,2021-03-29,2,0,2,0,2021-03-29,1616972400.0
3391,5,2,2021-03-30,0,0,2,0,2021-03-30,1617058800.0
3392,5,2,2021-03-31,0,0,2,0,2021-03-31,1617145200.0
3393,5,2,2021-04-01,0,0,2,0,2021-04-01,1617231600.0
3394,5,2,2021-04-02,0,0,2,0,2021-04-02,1617318000.0
3395,5,2,2021-04-03,0,0,2,0,2021-04-03,1617404400.0
3396,5,2,2021-04-04,0,0,2,0,2021-04-04,1617490800.0
3397,5,2,2021-04-05,0,0,2,0,2021-04-05,1617577200.0
3398,5,2,2021-04-06,0,0,2,0,2021-04-06,1617663600.0
3399,5,2,2021-04-07,0,0,2,0,2021-04-07,1617750000.0
3400,5,2,2021-04-08,1,0,3,0,2021-04-08,1617836400.0
3401,5,2,2021-04-09,0,0,3,0,2021-04-09,1617922800.0
3402,5,2,2021-04-10,0,0,3,0,2021-04-10,1618009200.0
3403,5,2,2021-04-11,0,0,3,0,2021-04-11,1618095600.0
3404,5,2,2021-04-12,0,0,3,0,2021-04-12,1618185600.0
3405,5,2,2021-04-13,0,0,3,0,2021-04-13,1618272000.0
3406,5,2,2021-04-14,0,0,3,0,2021-04-14,1618358400.0
3407,5,2,2021-04-15,0,0,3,0,2021-04-15,1618444800.0
3408,5,2,2021-04-16,0,0,3,0,2021-04-16,1618531200.0
3409,5,2,2021-04-17,0,0,3,0,2021-04-17,1618617600.0
3410,5,2,2021-04-18,0,0,3,0,2021-04-18,1618704000.0
3411,5,2,2021-04-19,0,0,3,0,2021-04-19,1618790400.0
3412,5,2,2021-04-20,0,0,3,0,2021-04-20,1618876800.0
3413,5,2,2021-04-21,0,0,3,0,2021-04-21,1618963200.0
3414,5,2,2021-04-22,0,0,3,0,2021-04-22,1619049600.0
3415,5,2,2021-04-23,0,0,3,0,2021-04-23,1619136000.0
3416,5,2,2021-04-24,0,0,3,0,2021-04-24,1619222400.0
3417,5,2,2021-04-25,0,0,3,0,2021-04-25,1619308800.0
3418,5,2,2021-04-26,0,0,3,0,2021-04-26,1619395200.0
3419,5,2,2021-04-27,0,0,3,0,2021-04-27,1619481600.0
3420,5,2,2021-04-28,0,0,3,0,2021-04-28,1619568000.0
3421,5,2,2021-04-29,0,0,3,0,2021-04-29,1619654400.0
3422,5,2,2021-04-30,0,0,3,0,2021-04-30,1619740800.0
3423,5,2,2021-05-01,0,0,3,0,2021-05-01,1619827200.0
3424,5,2,2021-05-02,0,0,3,0,2021-05-02,1619913600.0
3425,5,2,2021-05-03,0,0,3,0,2021-05-03,1620000000.0
3426,5,2,2021-05-04,0,0,3,0,2021-05-04,1620086400.0
3427,5,2,2021-05-05,0,0,3,0,2021-05-05,1620172800.0
3428,5,2,2021-05-06,0,0,3,0,2021-05-06,1620259200.0
3429,5,2,2021-05-07,0,0,3,0,2021-05-07,1620345600.0
3430,5,2,2021-05-08,0,0,3,0,2021-05-08,1620432000.0
3431,5,2,2021-05-09,0,0,3,0,2021-05-09,1620518400.0
3432,5,2,2021-05-10,0,0,3,0,2021-05-10,1620604800.0
3433,5,2,2021-05-11,0,0,3,0,2021-05-11,1620691200.0
3434,5,2,2021-05-12,0,0,3,0,2021-05-12,1620777600.0
3435,5,2,2021-05-13,0,0,3,0,2021-05-13,1620864000.0
3436,5,2,2021-05-14,0,0,3,0,2021-05-14,1620950400.0
3437,5,2,2021-05-15,0,0,3,0,2021-05-15,1621036800.0
3438,5,2,2021-05-16,0,0,3,0,2021-05-16,1621123200.0
3439,5,2,2021-05-17,0,0,3,0,2021-05-17,1621206000.0
3440,5,2,2021-05-18,0,0,3,0,2021-05-18,1621292400.0
3441,5,2,2021-05-19,0,0,3,0,2021-05-19,1621378800.0
3442,5,2,2021-05-20,0,0,3,0,2021-05-20,1621465200.0
3443,5,2,2021-05-21,0,0,3,0,2021-05-21,1621551600.0
3444,5,2,2021-05-22,0,0,3,0,2021-05-22,1621638000.0
3445,5,2,2021-05-23,0,0,3,0,2021-05-23,1621724400.0
3446,5,2,2021-05-24,0,0,3,0,2021-05-24,1621810800.0
3447,5,2,2021-05-25,0,0,3,0,2021-05-25,1621897200.0
3448,5,2,2021-05-26,0,0,3,0,2021-05-26,1621983600.0
3449,5,2,2021-05-27,0,0,3,0,2021-05-27,1622070000.0
3450,5,2,2021-05-28,0,0,3,0,2021-05-28,1622156400.0
3451,5,2,2021-05-29,0,2,3,2,2021-05-29,1622242800.0
3452,5,2,2021-05-30,0,0,3,2,2021-05-30,1622329200.0
3453,5,2,2021-05-31,0,0,3,2,2021-05-31,1622415600.0
3454,5,2,2021-06-01,0,0,3,2,2021-06-01,1622502000.0
3455,5,2,2021-06-02,0,0,3,2,2021-06-02,1622588400.0
3456,5,2,2021-06-03,0,0,3,2,2021-06-03,1622674800.0
3457,5,2,2021-06-04,0,0,3,2,2021-06-04,1622761200.0
3458,5,2,2021-06-05,0,0,3,2,2021-06-05,1622847600.0
3459,5,2,2021-06-06,0,0,3,2,2021-06-06,1622934000.0
3460,5,2,2021-06-07,0,0,3,2,2021-06-07,1623020400.0
3461,5,2,2021-06-08,0,0,3,2,2021-06-08,1623106800.0
3462,5,2,2021-06-09,0,0,3,2,2021-06-09,1623193200.0
3463,5,2,2021-06-10,0,0,3,2,2021-06-10,1623279600.0
3464,5,2,2021-06-11,0,0,3,2,2021-06-11,1623366000.0
3465,5,2,2021-06-12,0,0,3,2,2021-06-12,1623452400.0
3466,5,2,2021-06-13,0,0,3,2,2021-06-13,1623538800.0
3467,5,2,2021-06-14,0,0,3,2,2021-06-14,1623625200.0
3468,5,2,2021-06-15,0,0,3,2,2021-06-15,1623711600.0
3469,5,2,2021-06-16,0,0,3,2,2021-06-16,1623798000.0
3470,5,2,2021-06-17,0,0,3,2,2021-06-17,1623884400.0
3471,5,2,2021-06-18,0,0,3,2,2021-06-18,1623970800.0
3472,5,2,2021-06-19,0,0,3,2,2021-06-19,1624057200.0
3473,5,2,2021-06-20,0,0,3,2,2021-06-20,1624143600.0
3474,5,2,2021-06-21,0,0,3,2,2021-06-21,1624230000.0
3475,5,2,2021-06-22,0,0,3,2,2021-06-22,1624316400.0
3476,5,2,2021-06-23,0,0,3,2,2021-06-23,1624402800.0
3477,5,2,2021-06-24,0,0,3,2,2021-06-24,1624489200.0
3478,5,2,2021-06-25,0,0,3,2,2021-06-25,1624575600.0
3479,5,2,2021-06-26,0,0,3,2,2021-06-26,1624662000.0
3480,5,2,2021-06-27,0,0,3,2,2021-06-27,1624748400.0
3481,5,2,2021-06-28,0,0,3,2,2021-06-28,1624834800.0
3482,5,2,2021-06-29,0,0,3,2,2021-06-29,1624921200.0
3483,5,2,2021-06-30,0,0,3,2,2021-06-30,1625007600.0
3484,5,2,2021-07-01,0,0,3,2,2021-07-01,1625094000.0
3485,5,2,2021-07-02,0,0,3,2,2021-07-02,1625180400.0
3486,5,2,2021-07-03,0,0,3,2,2021-07-03,1625266800.0
3487,5,2,2021-07-04,0,0,3,2,2021-07-04,1625353200.0
3488,5,2,2021-07-05,0,0,3,2,2021-07-05,1625439600.0
3489,5,2,2021-07-06,0,0,3,2,2021-07-06,1625526000.0
3490,5,2,2021-07-07,0,0,3,2,2021-07-07,1625612400.0
3491,5,2,2021-07-08,0,0,3,2,2021-07-08,1625698800.0
3492,5,3,2020-12-27,0,0,0,0,2020-12-27,1609023600.0
3493,5,3,2020-12-28,0,0,0,0,2020-12-28,1609110000.0
3494,5,3,2020-12-29,0,0,0,0,2020-12-29,1609196400.0
3495,5,3,2020-12-30,0,0,0,0,2020-12-30,1609282800.0
3496,5,3,2020-12-31,0,0,0,0,2020-12-31,1609369200.0
3497,5,3,2021-01-01,0,0,0,0,2021-01-01,1609455600.0
3498,5,3,2021-01-02,0,0,0,0,2021-01-02,1609542000.0
3499,5,3,2021-01-03,0,0,0,0,2021-01-03,1609628400.0
3500,5,3,2021-01-04,0,0,0,0,2021-01-04,1609714800.0
3501,5,3,2021-01-05,0,0,0,0,2021-01-05,1609801200.0
3502,5,3,2021-01-06,0,0,0,0,2021-01-06,1609887600.0
3503,5,3,2021-01-07,0,0,0,0,2021-01-07,1609974000.0
3504,5,3,2021-01-08,0,0,0,0,2021-01-08,1610060400.0
3505,5,3,2021-01-09,0,0,0,0,2021-01-09,1610146800.0
3506,5,3,2021-01-10,0,0,0,0,2021-01-10,1610233200.0
3507,5,3,2021-01-11,0,0,0,0,2021-01-11,1610319600.0
3508,5,3,2021-01-12,0,0,0,0,2021-01-12,1610406000.0
3509,5,3,2021-01-13,0,0,0,0,2021-01-13,1610492400.0
3510,5,3,2021-01-14,0,0,0,0,2021-01-14,1610578800.0
3511,5,3,2021-01-15,0,0,0,0,2021-01-15,1610665200.0
3512,5,3,2021-01-16,0,0,0,0,2021-01-16,1610751600.0
3513,5,3,2021-01-17,0,0,0,0,2021-01-17,1610838000.0
3514,5,3,2021-01-18,0,0,0,0,2021-01-18,1610924400.0
3515,5,3,2021-01-19,0,0,0,0,2021-01-19,1611010800.0
3516,5,3,2021-01-20,0,0,0,0,2021-01-20,1611097200.0
3517,5,3,2021-01-21,0,0,0,0,2021-01-21,1611183600.0
3518,5,3,2021-01-22,0,0,0,0,2021-01-22,1611270000.0
3519,5,3,2021-01-23,0,0,0,0,2021-01-23,1611356400.0
3520,5,3,2021-01-24,0,0,0,0,2021-01-24,1611442800.0
3521,5,3,2021-01-25,0,0,0,0,2021-01-25,1611529200.0
3522,5,3,2021-01-26,0,0,0,0,2021-01-26,1611615600.0
3523,5,3,2021-01-27,0,0,0,0,2021-01-27,1611702000.0
3524,5,3,2021-01-28,0,0,0,0,2021-01-28,1611788400.0
3525,5,3,2021-01-29,0,0,0,0,2021-01-29,1611874800.0
3526,5,3,2021-01-30,0,0,0,0,2021-01-30,1611961200.0
3527,5,3,2021-01-31,0,0,0,0,2021-01-31,1612047600.0
3528,5,3,2021-02-01,0,0,0,0,2021-02-01,1612134000.0
3529,5,3,2021-02-02,0,0,0,0,2021-02-02,1612220400.0
3530,5,3,2021-02-03,0,0,0,0,2021-02-03,1612306800.0
3531,5,3,2021-02-04,0,0,0,0,2021-02-04,1612393200.0
3532,5,3,2021-02-05,0,0,0,0,2021-02-05,1612479600.0
3533,5,3,2021-02-06,0,0,0,0,2021-02-06,1612566000.0
3534,5,3,2021-02-07,0,0,0,0,2021-02-07,1612652400.0
3535,5,3,2021-02-08,0,0,0,0,2021-02-08,1612738800.0
3536,5,3,2021-02-09,0,0,0,0,2021-02-09,1612825200.0
3537,5,3,2021-02-10,0,0,0,0,2021-02-10,1612911600.0
3538,5,3,2021-02-11,0,0,0,0,2021-02-11,1612998000.0
3539,5,3,2021-02-12,0,0,0,0,2021-02-12,1613084400.0
3540,5,3,2021-02-13,0,0,0,0,2021-02-13,1613170800.0
3541,5,3,2021-02-14,0,0,0,0,2021-02-14,1613257200.0
3542,5,3,2021-02-15,0,0,0,0,2021-02-15,1613343600.0
3543,5,3,2021-02-16,0,0,0,0,2021-02-16,1613430000.0
3544,5,3,2021-02-17,0,0,0,0,2021-02-17,1613516400.0
3545,5,3,2021-02-18,0,0,0,0,2021-02-18,1613602800.0
3546,5,3,2021-02-19,0,0,0,0,2021-02-19,1613689200.0
3547,5,3,2021-02-20,0,0,0,0,2021-02-20,1613775600.0
3548,5,3,2021-02-21,0,0,0,0,2021-02-21,1613862000.0
3549,5,3,2021-02-22,0,0,0,0,2021-02-22,1613948400.0
3550,5,3,2021-02-23,0,0,0,0,2021-02-23,1614034800.0
3551,5,3,2021-02-24,0,0,0,0,2021-02-24,1614121200.0
3552,5,3,2021-02-25,0,0,0,0,2021-02-25,1614207600.0
3553,5,3,2021-02-26,0,0,0,0,2021-02-26,1614294000.0
3554,5,3,2021-02-27,0,0,0,0,2021-02-27,1614380400.0
3555,5,3,2021-02-28,0,0,0,0,2021-02-28,1614466800.0
3556,5,3,2021-03-01,0,0,0,0,2021-03-01,1614553200.0
3557,5,3,2021-03-02,0,0,0,0,2021-03-02,1614639600.0
3558,5,3,2021-03-03,0,0,0,0,2021-03-03,1614726000.0
3559,5,3,2021-03-04,0,0,0,0,2021-03-04,1614812400.0
3560,5,3,2021-03-05,0,0,0,0,2021-03-05,1614898800.0
3561,5,3,2021-03-06,0,0,0,0,2021-03-06,1614985200.0
3562,5,3,2021-03-07,0,0,0,0,2021-03-07,1615071600.0
3563,5,3,2021-03-08,0,0,0,0,2021-03-08,1615158000.0
3564,5,3,2021-03-09,0,0,0,0,2021-03-09,1615244400.0
3565,5,3,2021-03-10,0,0,0,0,2021-03-10,1615330800.0
3566,5,3,2021-03-11,0,0,0,0,2021-03-11,1615417200.0
3567,5,3,2021-03-12,0,0,0,0,2021-03-12,1615503600.0
3568,5,3,2021-03-13,0,0,0,0,2021-03-13,1615590000.0
3569,5,3,2021-03-14,0,0,0,0,2021-03-14,1615676400.0
3570,5,3,2021-03-15,0,0,0,0,2021-03-15,1615762800.0
3571,5,3,2021-03-16,0,0,0,0,2021-03-16,1615849200.0
3572,5,3,2021-03-17,0,0,0,0,2021-03-17,1615935600.0
3573,5,3,2021-03-18,0,0,0,0,2021-03-18,1616022000.0
3574,5,3,2021-03-19,0,0,0,0,2021-03-19,1616108400.0
3575,5,3,2021-03-20,0,0,0,0,2021-03-20,1616194800.0
3576,5,3,2021-03-21,0,0,0,0,2021-03-21,1616281200.0
3577,5,3,2021-03-22,0,0,0,0,2021-03-22,1616367600.0
3578,5,3,2021-03-23,0,0,0,0,2021-03-23,1616454000.0
3579,5,3,2021-03-24,0,0,0,0,2021-03-24,1616540400.0
3580,5,3,2021-03-25,0,0,0,0,2021-03-25,1616626800.0
3581,5,3,2021-03-26,0,0,0,0,2021-03-26,1616713200.0
3582,5,3,2021-03-27,0,0,0,0,2021-03-27,1616799600.0
3583,5,3,2021-03-28,0,0,0,0,2021-03-28,1616886000.0
3584,5,3,2021-03-29,0,0,0,0,2021-03-29,1616972400.0
3585,5,3,2021-03-30,0,0,0,0,2021-03-30,1617058800.0
3586,5,3,2021-03-31,0,0,0,0,2021-03-31,1617145200.0
3587,5,3,2021-04-01,0,0,0,0,2021-04-01,1617231600.0
3588,5,3,2021-04-02,0,0,0,0,2021-04-02,1617318000.0
3589,5,3,2021-04-03,0,0,0,0,2021-04-03,1617404400.0
3590,5,3,2021-04-04,0,0,0,0,2021-04-04,1617490800.0
3591,5,3,2021-04-05,0,0,0,0,2021-04-05,1617577200.0
3592,5,3,2021-04-06,0,0,0,0,2021-04-06,1617663600.0
3593,5,3,2021-04-07,0,0,0,0,2021-04-07,1617750000.0
3594,5,3,2021-04-08,0,0,0,0,2021-04-08,1617836400.0
3595,5,3,2021-04-09,0,0,0,0,2021-04-09,1617922800.0
3596,5,3,2021-04-10,0,0,0,0,2021-04-10,1618009200.0
3597,5,3,2021-04-11,0,0,0,0,2021-04-11,1618095600.0
3598,5,3,2021-04-12,0,0,0,0,2021-04-12,1618185600.0
3599,5,3,2021-04-13,0,0,0,0,2021-04-13,1618272000.0
3600,5,3,2021-04-14,0,0,0,0,2021-04-14,1618358400.0
3601,5,3,2021-04-15,0,0,0,0,2021-04-15,1618444800.0
3602,5,3,2021-04-16,0,0,0,0,2021-04-16,1618531200.0
3603,5,3,2021-04-17,0,0,0,0,2021-04-17,1618617600.0
3604,5,3,2021-04-18,0,0,0,0,2021-04-18,1618704000.0
3605,5,3,2021-04-19,0,0,0,0,2021-04-19,1618790400.0
3606,5,3,2021-04-20,0,0,0,0,2021-04-20,1618876800.0
3607,5,3,2021-04-21,0,0,0,0,2021-04-21,1618963200.0
3608,5,3,2021-04-22,0,0,0,0,2021-04-22,1619049600.0
3609,5,3,2021-04-23,0,0,0,0,2021-04-23,1619136000.0
3610,5,3,2021-04-24,0,0,0,0,2021-04-24,1619222400.0
3611,5,3,2021-04-25,0,0,0,0,2021-04-25,1619308800.0
3612,5,3,2021-04-26,0,0,0,0,2021-04-26,1619395200.0
3613,5,3,2021-04-27,0,0,0,0,2021-04-27,1619481600.0
3614,5,3,2021-04-28,0,0,0,0,2021-04-28,1619568000.0
3615,5,3,2021-04-29,0,0,0,0,2021-04-29,1619654400.0
3616,5,3,2021-04-30,0,0,0,0,2021-04-30,1619740800.0
3617,5,3,2021-05-01,0,0,0,0,2021-05-01,1619827200.0
3618,5,3,2021-05-02,0,0,0,0,2021-05-02,1619913600.0
3619,5,3,2021-05-03,0,0,0,0,2021-05-03,1620000000.0
3620,5,3,2021-05-04,0,0,0,0,2021-05-04,1620086400.0
3621,5,3,2021-05-05,0,0,0,0,2021-05-05,1620172800.0
3622,5,3,2021-05-06,0,0,0,0,2021-05-06,1620259200.0
3623,5,3,2021-05-07,0,0,0,0,2021-05-07,1620345600.0
3624,5,3,2021-05-08,0,0,0,0,2021-05-08,1620432000.0
3625,5,3,2021-05-09,0,0,0,0,2021-05-09,1620518400.0
3626,5,3,2021-05-10,0,0,0,0,2021-05-10,1620604800.0
3627,5,3,2021-05-11,0,0,0,0,2021-05-11,1620691200.0
3628,5,3,2021-05-12,0,0,0,0,2021-05-12,1620777600.0
3629,5,3,2021-05-13,0,0,0,0,2021-05-13,1620864000.0
3630,5,3,2021-05-14,0,0,0,0,2021-05-14,1620950400.0
3631,5,3,2021-05-15,0,0,0,0,2021-05-15,1621036800.0
3632,5,3,2021-05-16,0,0,0,0,2021-05-16,1621123200.0
3633,5,3,2021-05-17,0,0,0,0,2021-05-17,1621206000.0
3634,5,3,2021-05-18,0,0,0,0,2021-05-18,1621292400.0
3635,5,3,2021-05-19,0,0,0,0,2021-05-19,1621378800.0
3636,5,3,2021-05-20,0,0,0,0,2021-05-20,1621465200.0
3637,5,3,2021-05-21,0,0,0,0,2021-05-21,1621551600.0
3638,5,3,2021-05-22,0,0,0,0,2021-05-22,1621638000.0
3639,5,3,2021-05-23,0,0,0,0,2021-05-23,1621724400.0
3640,5,3,2021-05-24,0,0,0,0,2021-05-24,1621810800.0
3641,5,3,2021-05-25,0,0,0,0,2021-05-25,1621897200.0
3642,5,3,2021-05-26,0,0,0,0,2021-05-26,1621983600.0
3643,5,3,2021-05-27,0,0,0,0,2021-05-27,1622070000.0
3644,5,3,2021-05-28,0,0,0,0,2021-05-28,1622156400.0
3645,5,3,2021-05-29,0,0,0,0,2021-05-29,1622242800.0
3646,5,3,2021-05-30,0,0,0,0,2021-05-30,1622329200.0
3647,5,3,2021-05-31,0,0,0,0,2021-05-31,1622415600.0
3648,5,3,2021-06-01,0,0,0,0,2021-06-01,1622502000.0
3649,5,3,2021-06-02,0,0,0,0,2021-06-02,1622588400.0
3650,5,3,2021-06-03,0,0,0,0,2021-06-03,1622674800.0
3651,5,3,2021-06-04,0,0,0,0,2021-06-04,1622761200.0
3652,5,3,2021-06-05,0,0,0,0,2021-06-05,1622847600.0
3653,5,3,2021-06-06,0,0,0,0,2021-06-06,1622934000.0
3654,5,3,2021-06-07,0,0,0,0,2021-06-07,1623020400.0
3655,5,3,2021-06-08,0,0,0,0,2021-06-08,1623106800.0
3656,5,3,2021-06-09,0,0,0,0,2021-06-09,1623193200.0
3657,5,3,2021-06-10,0,0,0,0,2021-06-10,1623279600.0
3658,5,3,2021-06-11,0,0,0,0,2021-06-11,1623366000.0
3659,5,3,2021-06-12,0,0,0,0,2021-06-12,1623452400.0
3660,5,3,2021-06-13,0,0,0,0,2021-06-13,1623538800.0
3661,5,3,2021-06-14,0,0,0,0,2021-06-14,1623625200.0
3662,5,3,2021-06-15,0,0,0,0,2021-06-15,1623711600.0
3663,5,3,2021-06-16,0,0,0,0,2021-06-16,1623798000.0
3664,5,3,2021-06-17,0,0,0,0,2021-06-17,1623884400.0
3665,5,3,2021-06-18,0,0,0,0,2021-06-18,1623970800.0
3666,5,3,2021-06-19,0,0,0,0,2021-06-19,1624057200.0
3667,5,3,2021-06-20,0,0,0,0,2021-06-20,1624143600.0
3668,5,3,2021-06-21,0,0,0,0,2021-06-21,1624230000.0
3669,5,3,2021-06-22,0,0,0,0,2021-06-22,1624316400.0
3670,5,3,2021-06-23,0,0,0,0,2021-06-23,1624402800.0
3671,5,3,2021-06-24,0,0,0,0,2021-06-24,1624489200.0
3672,5,3,2021-06-25,0,0,0,0,2021-06-25,1624575600.0
3673,5,3,2021-06-26,0,0,0,0,2021-06-26,1624662000.0
3674,5,3,2021-06-27,0,0,0,0,2021-06-27,1624748400.0
3675,5,3,2021-06-28,0,0,0,0,2021-06-28,1624834800.0
3676,5,3,2021-06-29,0,0,0,0,2021-06-29,1624921200.0
3677,5,3,2021-06-30,0,0,0,0,2021-06-30,1625007600.0
3678,5,3,2021-07-01,0,0,0,0,2021-07-01,1625094000.0
3679,5,3,2021-07-02,0,0,0,0,2021-07-02,1625180400.0
3680,5,3,2021-07-03,0,0,0,0,2021-07-03,1625266800.0
3681,5,3,2021-07-04,0,0,0,0,2021-07-04,1625353200.0
3682,5,3,2021-07-05,0,0,0,0,2021-07-05,1625439600.0
3683,5,3,2021-07-06,0,0,0,0,2021-07-06,1625526000.0
3684,5,3,2021-07-07,0,0,0,0,2021-07-07,1625612400.0
3685,5,3,2021-07-08,0,0,0,0,2021-07-08,1625698800.0
3686,5,4,2020-12-27,0,0,0,0,2020-12-27,1609023600.0
3687,5,4,2020-12-28,0,0,0,0,2020-12-28,1609110000.0
3688,5,4,2020-12-29,0,0,0,0,2020-12-29,1609196400.0
3689,5,4,2020-12-30,0,0,0,0,2020-12-30,1609282800.0
3690,5,4,2020-12-31,0,0,0,0,2020-12-31,1609369200.0
3691,5,4,2021-01-01,0,0,0,0,2021-01-01,1609455600.0
3692,5,4,2021-01-02,0,0,0,0,2021-01-02,1609542000.0
3693,5,4,2021-01-03,0,0,0,0,2021-01-03,1609628400.0
3694,5,4,2021-01-04,0,0,0,0,2021-01-04,1609714800.0
3695,5,4,2021-01-05,0,0,0,0,2021-01-05,1609801200.0
3696,5,4,2021-01-06,0,0,0,0,2021-01-06,1609887600.0
3697,5,4,2021-01-07,0,0,0,0,2021-01-07,1609974000.0
3698,5,4,2021-01-08,0,0,0,0,2021-01-08,1610060400.0
3699,5,4,2021-01-09,0,0,0,0,2021-01-09,1610146800.0
3700,5,4,2021-01-10,0,0,0,0,2021-01-10,1610233200.0
3701,5,4,2021-01-11,0,0,0,0,2021-01-11,1610319600.0
3702,5,4,2021-01-12,0,0,0,0,2021-01-12,1610406000.0
3703,5,4,2021-01-13,0,0,0,0,2021-01-13,1610492400.0
3704,5,4,2021-01-14,0,0,0,0,2021-01-14,1610578800.0
3705,5,4,2021-01-15,0,0,0,0,2021-01-15,1610665200.0
3706,5,4,2021-01-16,0,0,0,0,2021-01-16,1610751600.0
3707,5,4,2021-01-17,0,0,0,0,2021-01-17,1610838000.0
3708,5,4,2021-01-18,0,0,0,0,2021-01-18,1610924400.0
3709,5,4,2021-01-19,0,0,0,0,2021-01-19,1611010800.0
3710,5,4,2021-01-20,0,0,0,0,2021-01-20,1611097200.0
3711,5,4,2021-01-21,0,0,0,0,2021-01-21,1611183600.0
3712,5,4,2021-01-22,0,0,0,0,2021-01-22,1611270000.0
3713,5,4,2021-01-23,0,0,0,0,2021-01-23,1611356400.0
3714,5,4,2021-01-24,0,0,0,0,2021-01-24,1611442800.0
3715,5,4,2021-01-25,0,0,0,0,2021-01-25,1611529200.0
3716,5,4,2021-01-26,0,0,0,0,2021-01-26,1611615600.0
3717,5,4,2021-01-27,0,0,0,0,2021-01-27,1611702000.0
3718,5,4,2021-01-28,0,0,0,0,2021-01-28,1611788400.0
3719,5,4,2021-01-29,0,0,0,0,2021-01-29,1611874800.0
3720,5,4,2021-01-30,0,0,0,0,2021-01-30,1611961200.0
3721,5,4,2021-01-31,0,0,0,0,2021-01-31,1612047600.0
3722,5,4,2021-02-01,0,0,0,0,2021-02-01,1612134000.0
3723,5,4,2021-02-02,0,0,0,0,2021-02-02,1612220400.0
3724,5,4,2021-02-03,0,0,0,0,2021-02-03,1612306800.0
3725,5,4,2021-02-04,0,0,0,0,2021-02-04,1612393200.0
3726,5,4,2021-02-05,0,0,0,0,2021-02-05,1612479600.0
3727,5,4,2021-02-06,0,0,0,0,2021-02-06,1612566000.0
3728,5,4,2021-02-07,0,0,0,0,2021-02-07,1612652400.0
3729,5,4,2021-02-08,0,0,0,0,2021-02-08,1612738800.0
3730,5,4,2021-02-09,0,0,0,0,2021-02-09,1612825200.0
3731,5,4,2021-02-10,0,0,0,0,2021-02-10,1612911600.0
3732,5,4,2021-02-11,0,0,0,0,2021-02-11,1612998000.0
3733,5,4,2021-02-12,0,0,0,0,2021-02-12,1613084400.0
3734,5,4,2021-02-13,0,0,0,0,2021-02-13,1613170800.0
3735,5,4,2021-02-14,0,0,0,0,2021-02-14,1613257200.0
3736,5,4,2021-02-15,0,0,0,0,2021-02-15,1613343600.0
3737,5,4,2021-02-16,0,0,0,0,2021-02-16,1613430000.0
3738,5,4,2021-02-17,0,0,0,0,2021-02-17,1613516400.0
3739,5,4,2021-02-18,0,0,0,0,2021-02-18,1613602800.0
3740,5,4,2021-02-19,0,0,0,0,2021-02-19,1613689200.0
3741,5,4,2021-02-20,0,0,0,0,2021-02-20,1613775600.0
3742,5,4,2021-02-21,0,0,0,0,2021-02-21,1613862000.0
3743,5,4,2021-02-22,0,0,0,0,2021-02-22,1613948400.0
3744,5,4,2021-02-23,0,0,0,0,2021-02-23,1614034800.0
3745,5,4,2021-02-24,0,0,0,0,2021-02-24,1614121200.0
3746,5,4,2021-02-25,0,0,0,0,2021-02-25,1614207600.0
3747,5,4,2021-02-26,0,0,0,0,2021-02-26,1614294000.0
3748,5,4,2021-02-27,0,0,0,0,2021-02-27,1614380400.0
3749,5,4,2021-02-28,0,0,0,0,2021-02-28,1614466800.0
3750,5,4,2021-03-01,0,0,0,0,2021-03-01,1614553200.0
3751,5,4,2021-03-02,0,0,0,0,2021-03-02,1614639600.0
3752,5,4,2021-03-03,0,0,0,0,2021-03-03,1614726000.0
3753,5,4,2021-03-04,0,0,0,0,2021-03-04,1614812400.0
3754,5,4,2021-03-05,0,0,0,0,2021-03-05,1614898800.0
3755,5,4,2021-03-06,0,0,0,0,2021-03-06,1614985200.0
3756,5,4,2021-03-07,0,0,0,0,2021-03-07,1615071600.0
3757,5,4,2021-03-08,0,0,0,0,2021-03-08,1615158000.0
3758,5,4,2021-03-09,0,0,0,0,2021-03-09,1615244400.0
3759,5,4,2021-03-10,0,0,0,0,2021-03-10,1615330800.0
3760,5,4,2021-03-11,0,0,0,0,2021-03-11,1615417200.0
3761,5,4,2021-03-12,0,0,0,0,2021-03-12,1615503600.0
3762,5,4,2021-03-13,0,0,0,0,2021-03-13,1615590000.0
3763,5,4,2021-03-14,0,0,0,0,2021-03-14,1615676400.0
3764,5,4,2021-03-15,0,0,0,0,2021-03-15,1615762800.0
3765,5,4,2021-03-16,0,0,0,0,2021-03-16,1615849200.0
3766,5,4,2021-03-17,0,0,0,0,2021-03-17,1615935600.0
3767,5,4,2021-03-18,0,0,0,0,2021-03-18,1616022000.0
3768,5,4,2021-03-19,0,0,0,0,2021-03-19,1616108400.0
3769,5,4,2021-03-20,0,0,0,0,2021-03-20,1616194800.0
3770,5,4,2021-03-21,0,0,0,0,2021-03-21,1616281200.0
3771,5,4,2021-03-22,0,0,0,0,2021-03-22,1616367600.0
3772,5,4,2021-03-23,0,0,0,0,2021-03-23,1616454000.0
3773,5,4,2021-03-24,0,0,0,0,2021-03-24,1616540400.0
3774,5,4,2021-03-25,0,0,0,0,2021-03-25,1616626800.0
3775,5,4,2021-03-26,0,0,0,0,2021-03-26,1616713200.0
3776,5,4,2021-03-27,0,0,0,0,2021-03-27,1616799600.0
3777,5,4,2021-03-28,0,0,0,0,2021-03-28,1616886000.0
3778,5,4,2021-03-29,0,0,0,0,2021-03-29,1616972400.0
3779,5,4,2021-03-30,0,0,0,0,2021-03-30,1617058800.0
3780,5,4,2021-03-31,0,0,0,0,2021-03-31,1617145200.0
3781,5,4,2021-04-01,0,0,0,0,2021-04-01,1617231600.0
3782,5,4,2021-04-02,0,0,0,0,2021-04-02,1617318000.0
3783,5,4,2021-04-03,0,0,0,0,2021-04-03,1617404400.0
3784,5,4,2021-04-04,0,0,0,0,2021-04-04,1617490800.0
3785,5,4,2021-04-05,0,0,0,0,2021-04-05,1617577200.0
3786,5,4,2021-04-06,0,0,0,0,2021-04-06,1617663600.0
3787,5,4,2021-04-07,0,0,0,0,2021-04-07,1617750000.0
3788,5,4,2021-04-08,0,0,0,0,2021-04-08,1617836400.0
3789,5,4,2021-04-09,0,0,0,0,2021-04-09,1617922800.0
3790,5,4,2021-04-10,0,0,0,0,2021-04-10,1618009200.0
3791,5,4,2021-04-11,0,0,0,0,2021-04-11,1618095600.0
3792,5,4,2021-04-12,0,0,0,0,2021-04-12,1618185600.0
3793,5,4,2021-04-13,0,0,0,0,2021-04-13,1618272000.0
3794,5,4,2021-04-14,0,0,0,0,2021-04-14,1618358400.0
3795,5,4,2021-04-15,0,0,0,0,2021-04-15,1618444800.0
3796,5,4,2021-04-16,0,0,0,0,2021-04-16,1618531200.0
3797,5,4,2021-04-17,0,0,0,0,2021-04-17,1618617600.0
3798,5,4,2021-04-18,0,0,0,0,2021-04-18,1618704000.0
3799,5,4,2021-04-19,0,0,0,0,2021-04-19,1618790400.0
3800,5,4,2021-04-20,0,0,0,0,2021-04-20,1618876800.0
3801,5,4,2021-04-21,0,0,0,0,2021-04-21,1618963200.0
3802,5,4,2021-04-22,0,0,0,0,2021-04-22,1619049600.0
3803,5,4,2021-04-23,0,0,0,0,2021-04-23,1619136000.0
3804,5,4,2021-04-24,0,0,0,0,2021-04-24,1619222400.0
3805,5,4,2021-04-25,0,0,0,0,2021-04-25,1619308800.0
3806,5,4,2021-04-26,0,0,0,0,2021-04-26,1619395200.0
3807,5,4,2021-04-27,0,0,0,0,2021-04-27,1619481600.0
3808,5,4,2021-04-28,0,0,0,0,2021-04-28,1619568000.0
3809,5,4,2021-04-29,0,0,0,0,2021-04-29,1619654400.0
3810,5,4,2021-04-30,0,0,0,0,2021-04-30,1619740800.0
3811,5,4,2021-05-01,0,0,0,0,2021-05-01,1619827200.0
3812,5,4,2021-05-02,0,0,0,0,2021-05-02,1619913600.0
3813,5,4,2021-05-03,0,0,0,0,2021-05-03,1620000000.0
3814,5,4,2021-05-04,0,0,0,0,2021-05-04,1620086400.0
3815,5,4,2021-05-05,0,0,0,0,2021-05-05,1620172800.0
3816,5,4,2021-05-06,0,0,0,0,2021-05-06,1620259200.0
3817,5,4,2021-05-07,0,0,0,0,2021-05-07,1620345600.0
3818,5,4,2021-05-08,0,0,0,0,2021-05-08,1620432000.0
3819,5,4,2021-05-09,0,0,0,0,2021-05-09,1620518400.0
3820,5,4,2021-05-10,0,0,0,0,2021-05-10,1620604800.0
3821,5,4,2021-05-11,0,0,0,0,2021-05-11,1620691200.0
3822,5,4,2021-05-12,0,0,0,0,2021-05-12,1620777600.0
3823,5,4,2021-05-13,0,0,0,0,2021-05-13,1620864000.0
3824,5,4,2021-05-14,0,0,0,0,2021-05-14,1620950400.0
3825,5,4,2021-05-15,0,0,0,0,2021-05-15,1621036800.0
3826,5,4,2021-05-16,0,0,0,0,2021-05-16,1621123200.0
3827,5,4,2021-05-17,0,0,0,0,2021-05-17,1621206000.0
3828,5,4,2021-05-18,0,0,0,0,2021-05-18,1621292400.0
3829,5,4,2021-05-19,0,0,0,0,2021-05-19,1621378800.0
3830,5,4,2021-05-20,0,0,0,0,2021-05-20,1621465200.0
3831,5,4,2021-05-21,0,0,0,0,2021-05-21,1621551600.0
3832,5,4,2021-05-22,0,0,0,0,2021-05-22,1621638000.0
3833,5,4,2021-05-23,0,0,0,0,2021-05-23,1621724400.0
3834,5,4,2021-05-24,0,0,0,0,2021-05-24,1621810800.0
3835,5,4,2021-05-25,0,0,0,0,2021-05-25,1621897200.0
3836,5,4,2021-05-26,0,0,0,0,2021-05-26,1621983600.0
3837,5,4,2021-05-27,0,0,0,0,2021-05-27,1622070000.0
3838,5,4,2021-05-28,0,0,0,0,2021-05-28,1622156400.0
3839,5,4,2021-05-29,0,0,0,0,2021-05-29,1622242800.0
3840,5,4,2021-05-30,0,0,0,0,2021-05-30,1622329200.0
3841,5,4,2021-05-31,0,0,0,0,2021-05-31,1622415600.0
3842,5,4,2021-06-01,0,0,0,0,2021-06-01,1622502000.0
3843,5,4,2021-06-02,0,0,0,0,2021-06-02,1622588400.0
3844,5,4,2021-06-03,0,0,0,0,2021-06-03,1622674800.0
3845,5,4,2021-06-04,0,0,0,0,2021-06-04,1622761200.0
3846,5,4,2021-06-05,0,0,0,0,2021-06-05,1622847600.0
3847,5,4,2021-06-06,0,0,0,0,2021-06-06,1622934000.0
3848,5,4,2021-06-07,0,0,0,0,2021-06-07,1623020400.0
3849,5,4,2021-06-08,0,0,0,0,2021-06-08,1623106800.0
3850,5,4,2021-06-09,0,0,0,0,2021-06-09,1623193200.0
3851,5,4,2021-06-10,0,0,0,0,2021-06-10,1623279600.0
3852,5,4,2021-06-11,0,0,0,0,2021-06-11,1623366000.0
3853,5,4,2021-06-12,0,0,0,0,2021-06-12,1623452400.0
3854,5,4,2021-06-13,0,0,0,0,2021-06-13,1623538800.0
3855,5,4,2021-06-14,0,0,0,0,2021-06-14,1623625200.0
3856,5,4,2021-06-15,0,0,0,0,2021-06-15,1623711600.0
3857,5,4,2021-06-16,0,0,0,0,2021-06-16,1623798000.0
3858,5,4,2021-06-17,0,0,0,0,2021-06-17,1623884400.0
3859,5,4,2021-06-18,0,0,0,0,2021-06-18,1623970800.0
3860,5,4,2021-06-19,0,0,0,0,2021-06-19,1624057200.0
3861,5,4,2021-06-20,0,0,0,0,2021-06-20,1624143600.0
3862,5,4,2021-06-21,0,0,0,0,2021-06-21,1624230000.0
3863,5,4,2021-06-22,0,0,0,0,2021-06-22,1624316400.0
3864,5,4,2021-06-23,0,0,0,0,2021-06-23,1624402800.0
3865,5,4,2021-06-24,0,0,0,0,2021-06-24,1624489200.0
3866,5,4,2021-06-25,0,0,0,0,2021-06-25,1624575600.0
3867,5,4,2021-06-26,0,0,0,0,2021-06-26,1624662000.0
3868,5,4,2021-06-27,0,0,0,0,2021-06-27,1624748400.0
3869,5,4,2021-06-28,0,0,0,0,2021-06-28,1624834800.0
3870,5,4,2021-06-29,0,0,0,0,2021-06-29,1624921200.0
3871,5,4,2021-06-30,0,0,0,0,2021-06-30,1625007600.0
3872,5,4,2021-07-01,0,0,0,0,2021-07-01,1625094000.0
3873,5,4,2021-07-02,0,0,0,0,2021-07-02,1625180400.0
3874,5,4,2021-07-03,0,0,0,0,2021-07-03,1625266800.0
3875,5,4,2021-07-04,0,0,0,0,2021-07-04,1625353200.0
3876,5,4,2021-07-05,0,0,0,0,2021-07-05,1625439600.0
3877,5,4,2021-07-06,0,0,0,0,2021-07-06,1625526000.0
3878,5,4,2021-07-07,0,0,0,0,2021-07-07,1625612400.0
3879,5,4,2021-07-08,0,0,0,0,2021-07-08,1625698800.0
3880,6,1,2020-12-27,0,0,0,0,2020-12-27,1609023600.0
3881,6,1,2020-12-28,0,0,0,0,2020-12-28,1609110000.0
3882,6,1,2020-12-29,0,0,0,0,2020-12-29,1609196400.0
3883,6,1,2020-12-30,0,0,0,0,2020-12-30,1609282800.0
3884,6,1,2020-12-31,0,0,0,0,2020-12-31,1609369200.0
3885,6,1,2021-01-01,0,0,0,0,2021-01-01,1609455600.0
3886,6,1,2021-01-02,0,0,0,0,2021-01-02,1609542000.0
3887,6,1,2021-01-03,0,0,0,0,2021-01-03,1609628400.0
3888,6,1,2021-01-04,0,0,0,0,2021-01-04,1609714800.0
3889,6,1,2021-01-05,0,0,0,0,2021-01-05,1609801200.0
3890,6,1,2021-01-06,0,0,0,0,2021-01-06,1609887600.0
3891,6,1,2021-01-07,0,0,0,0,2021-01-07,1609974000.0
3892,6,1,2021-01-08,0,0,0,0,2021-01-08,1610060400.0
3893,6,1,2021-01-09,0,0,0,0,2021-01-09,1610146800.0
3894,6,1,2021-01-10,0,0,0,0,2021-01-10,1610233200.0
3895,6,1,2021-01-11,9,0,9,0,2021-01-11,1610319600.0
3896,6,1,2021-01-12,0,0,9,0,2021-01-12,1610406000.0
3897,6,1,2021-01-13,0,0,9,0,2021-01-13,1610492400.0
3898,6,1,2021-01-14,0,0,9,0,2021-01-14,1610578800.0
3899,6,1,2021-01-15,1,0,10,0,2021-01-15,1610665200.0
3900,6,1,2021-01-16,1,0,11,0,2021-01-16,1610751600.0
3901,6,1,2021-01-17,0,0,11,0,2021-01-17,1610838000.0
3902,6,1,2021-01-18,1,0,12,0,2021-01-18,1610924400.0
3903,6,1,2021-01-19,0,0,12,0,2021-01-19,1611010800.0
3904,6,1,2021-01-20,0,0,12,0,2021-01-20,1611097200.0
3905,6,1,2021-01-21,0,0,12,0,2021-01-21,1611183600.0
3906,6,1,2021-01-22,0,0,12,0,2021-01-22,1611270000.0
3907,6,1,2021-01-23,1,0,13,0,2021-01-23,1611356400.0
3908,6,1,2021-01-24,0,0,13,0,2021-01-24,1611442800.0
3909,6,1,2021-01-25,141,0,154,0,2021-01-25,1611529200.0
3910,6,1,2021-01-26,165,0,319,0,2021-01-26,1611615600.0
3911,6,1,2021-01-27,250,0,569,0,2021-01-27,1611702000.0
3912,6,1,2021-01-28,102,5,671,5,2021-01-28,1611788400.0
3913,6,1,2021-01-29,231,1,902,6,2021-01-29,1611874800.0
3914,6,1,2021-01-30,285,2,1187,8,2021-01-30,1611961200.0
3915,6,1,2021-01-31,1,0,1188,8,2021-01-31,1612047600.0
3916,6,1,2021-02-01,160,0,1348,8,2021-02-01,1612134000.0
3917,6,1,2021-02-02,330,0,1678,8,2021-02-02,1612220400.0
3918,6,1,2021-02-03,228,0,1906,8,2021-02-03,1612306800.0
3919,6,1,2021-02-04,215,3,2121,11,2021-02-04,1612393200.0
3920,6,1,2021-02-05,214,0,2335,11,2021-02-05,1612479600.0
3921,6,1,2021-02-06,83,10,2418,21,2021-02-06,1612566000.0
3922,6,1,2021-02-07,0,0,2418,21,2021-02-07,1612652400.0
3923,6,1,2021-02-08,82,2,2500,23,2021-02-08,1612738800.0
3924,6,1,2021-02-09,194,0,2694,23,2021-02-09,1612825200.0
3925,6,1,2021-02-10,187,1,2881,24,2021-02-10,1612911600.0
3926,6,1,2021-02-11,236,0,3117,24,2021-02-11,1612998000.0
3927,6,1,2021-02-12,287,1,3404,25,2021-02-12,1613084400.0
3928,6,1,2021-02-13,56,0,3460,25,2021-02-13,1613170800.0
3929,6,1,2021-02-14,1,0,3461,25,2021-02-14,1613257200.0
3930,6,1,2021-02-15,359,1,3820,26,2021-02-15,1613343600.0
3931,6,1,2021-02-16,266,3,4086,29,2021-02-16,1613430000.0
3932,6,1,2021-02-17,167,0,4253,29,2021-02-17,1613516400.0
3933,6,1,2021-02-18,217,1,4470,30,2021-02-18,1613602800.0
3934,6,1,2021-02-19,235,14,4705,44,2021-02-19,1613689200.0
3935,6,1,2021-02-20,139,4,4844,48,2021-02-20,1613775600.0
3936,6,1,2021-02-21,0,0,4844,48,2021-02-21,1613862000.0
3937,6,1,2021-02-22,130,118,4974,166,2021-02-22,1613948400.0
3938,6,1,2021-02-23,185,149,5159,315,2021-02-23,1614034800.0
3939,6,1,2021-02-24,176,140,5335,455,2021-02-24,1614121200.0
3940,6,1,2021-02-25,227,280,5562,735,2021-02-25,1614207600.0
3941,6,1,2021-02-26,242,257,5804,992,2021-02-26,1614294000.0
3942,6,1,2021-02-27,0,0,5804,992,2021-02-27,1614380400.0
3943,6,1,2021-02-28,0,0,5804,992,2021-02-28,1614466800.0
3944,6,1,2021-03-01,145,258,5949,1250,2021-03-01,1614553200.0
3945,6,1,2021-03-02,228,255,6177,1505,2021-03-02,1614639600.0
3946,6,1,2021-03-03,202,183,6379,1688,2021-03-03,1614726000.0
3947,6,1,2021-03-04,205,136,6584,1824,2021-03-04,1614812400.0
3948,6,1,2021-03-05,224,109,6808,1933,2021-03-05,1614898800.0
3949,6,1,2021-03-06,1,0,6809,1933,2021-03-06,1614985200.0
3950,6,1,2021-03-07,0,0,6809,1933,2021-03-07,1615071600.0
3951,6,1,2021-03-08,189,124,6998,2057,2021-03-08,1615158000.0
3952,6,1,2021-03-09,391,139,7389,2196,2021-03-09,1615244400.0
3953,6,1,2021-03-10,180,175,7569,2371,2021-03-10,1615330800.0
3954,6,1,2021-03-11,167,204,7736,2575,2021-03-11,1615417200.0
3955,6,1,2021-03-12,238,287,7974,2862,2021-03-12,1615503600.0
3956,6,1,2021-03-13,1,0,7975,2862,2021-03-13,1615590000.0
3957,6,1,2021-03-14,0,0,7975,2862,2021-03-14,1615676400.0
3958,6,1,2021-03-15,157,287,8132,3149,2021-03-15,1615762800.0
3959,6,1,2021-03-16,236,207,8368,3356,2021-03-16,1615849200.0
3960,6,1,2021-03-17,264,130,8632,3486,2021-03-17,1615935600.0
3961,6,1,2021-03-18,172,216,8804,3702,2021-03-18,1616022000.0
3962,6,1,2021-03-19,172,278,8976,3980,2021-03-19,1616108400.0
3963,6,1,2021-03-20,0,0,8976,3980,2021-03-20,1616194800.0
3964,6,1,2021-03-21,0,0,8976,3980,2021-03-21,1616281200.0
3965,6,1,2021-03-22,98,125,9074,4105,2021-03-22,1616367600.0
3966,6,1,2021-03-23,136,234,9210,4339,2021-03-23,1616454000.0
3967,6,1,2021-03-24,160,125,9370,4464,2021-03-24,1616540400.0
3968,6,1,2021-03-25,186,192,9556,4656,2021-03-25,1616626800.0
3969,6,1,2021-03-26,160,204,9716,4860,2021-03-26,1616713200.0
3970,6,1,2021-03-27,18,0,9734,4860,2021-03-27,1616799600.0
3971,6,1,2021-03-28,0,0,9734,4860,2021-03-28,1616886000.0
3972,6,1,2021-03-29,0,2,9734,4862,2021-03-29,1616972400.0
3973,6,1,2021-03-30,272,301,10006,5163,2021-03-30,1617058800.0
3974,6,1,2021-03-31,225,112,10231,5275,2021-03-31,1617145200.0
3975,6,1,2021-04-01,243,86,10474,5361,2021-04-01,1617231600.0
3976,6,1,2021-04-02,286,232,10760,5593,2021-04-02,1617318000.0
3977,6,1,2021-04-03,906,243,11666,5836,2021-04-03,1617404400.0
3978,6,1,2021-04-04,1,0,11667,5836,2021-04-04,1617490800.0
3979,6,1,2021-04-05,1,0,11668,5836,2021-04-05,1617577200.0
3980,6,1,2021-04-06,162,261,11830,6097,2021-04-06,1617663600.0
3981,6,1,2021-04-07,237,241,12067,6338,2021-04-07,1617750000.0
3982,6,1,2021-04-08,286,116,12353,6454,2021-04-08,1617836400.0
3983,6,1,2021-04-09,248,147,12601,6601,2021-04-09,1617922800.0
3984,6,1,2021-04-10,181,87,12782,6688,2021-04-10,1618009200.0
3985,6,1,2021-04-11,7,0,12789,6688,2021-04-11,1618095600.0
3986,6,1,2021-04-12,0,19,12789,6707,2021-04-12,1618185600.0
3987,6,1,2021-04-13,394,318,13183,7025,2021-04-13,1618272000.0
3988,6,1,2021-04-14,239,186,13422,7211,2021-04-14,1618358400.0
3989,6,1,2021-04-15,207,91,13629,7302,2021-04-15,1618444800.0
3990,6,1,2021-04-16,214,103,13843,7405,2021-04-16,1618531200.0
3991,6,1,2021-04-17,226,107,14069,7512,2021-04-17,1618617600.0
3992,6,1,2021-04-18,1,0,14070,7512,2021-04-18,1618704000.0
3993,6,1,2021-04-19,7,1,14077,7513,2021-04-19,1618790400.0
3994,6,1,2021-04-20,368,192,14445,7705,2021-04-20,1618876800.0
3995,6,1,2021-04-21,412,109,14857,7814,2021-04-21,1618963200.0
3996,6,1,2021-04-22,410,110,15267,7924,2021-04-22,1619049600.0
3997,6,1,2021-04-23,367,120,15634,8044,2021-04-23,1619136000.0
3998,6,1,2021-04-24,413,88,16047,8132,2021-04-24,1619222400.0
3999,6,1,2021-04-25,2,0,16049,8132,2021-04-25,1619308800.0
4000,6,1,2021-04-26,54,0,16103,8132,2021-04-26,1619395200.0
4001,6,1,2021-04-27,351,255,16454,8387,2021-04-27,1619481600.0
4002,6,1,2021-04-28,354,472,16808,8859,2021-04-28,1619568000.0
4003,6,1,2021-04-29,558,293,17366,9152,2021-04-29,1619654400.0
4004,6,1,2021-04-30,403,195,17769,9347,2021-04-30,1619740800.0
4005,6,1,2021-05-01,670,209,18439,9556,2021-05-01,1619827200.0
4006,6,1,2021-05-02,0,0,18439,9556,2021-05-02,1619913600.0
4007,6,1,2021-05-03,139,0,18578,9556,2021-05-03,1620000000.0
4008,6,1,2021-05-04,353,380,18931,9936,2021-05-04,1620086400.0
4009,6,1,2021-05-05,447,255,19378,10191,2021-05-05,1620172800.0
4010,6,1,2021-05-06,320,156,19698,10347,2021-05-06,1620259200.0
4011,6,1,2021-05-07,341,90,20039,10437,2021-05-07,1620345600.0
4012,6,1,2021-05-08,300,115,20339,10552,2021-05-08,1620432000.0
4013,6,1,2021-05-09,0,0,20339,10552,2021-05-09,1620518400.0
4014,6,1,2021-05-10,8,9,20347,10561,2021-05-10,1620604800.0
4015,6,1,2021-05-11,360,429,20707,10990,2021-05-11,1620691200.0
4016,6,1,2021-05-12,333,251,21040,11241,2021-05-12,1620777600.0
4017,6,1,2021-05-13,127,71,21167,11312,2021-05-13,1620864000.0
4018,6,1,2021-05-14,0,0,21167,11312,2021-05-14,1620950400.0
4019,6,1,2021-05-15,484,192,21651,11504,2021-05-15,1621036800.0
4020,6,1,2021-05-16,0,0,21651,11504,2021-05-16,1621123200.0
4021,6,1,2021-05-17,121,29,21772,11533,2021-05-17,1621206000.0
4022,6,1,2021-05-18,515,354,22287,11887,2021-05-18,1621292400.0
4023,6,1,2021-05-19,650,565,22937,12452,2021-05-19,1621378800.0
4024,6,1,2021-05-20,1055,350,23992,12802,2021-05-20,1621465200.0
4025,6,1,2021-05-21,1046,195,25038,12997,2021-05-21,1621551600.0
4026,6,1,2021-05-22,1241,173,26279,13170,2021-05-22,1621638000.0
4027,6,1,2021-05-23,0,0,26279,13170,2021-05-23,1621724400.0
4028,6,1,2021-05-24,1,0,26280,13170,2021-05-24,1621810800.0
4029,6,1,2021-05-25,884,522,27164,13692,2021-05-25,1621897200.0
4030,6,1,2021-05-26,1035,716,28199,14408,2021-05-26,1621983600.0
4031,6,1,2021-05-27,1317,351,29516,14759,2021-05-27,1622070000.0
4032,6,1,2021-05-28,954,231,30470,14990,2021-05-28,1622156400.0
4033,6,1,2021-05-29,1130,227,31600,15217,2021-05-29,1622242800.0
4034,6,1,2021-05-30,0,0,31600,15217,2021-05-30,1622329200.0
4035,6,1,2021-05-31,104,3,31704,15220,2021-05-31,1622415600.0
4036,6,1,2021-06-01,1148,487,32852,15707,2021-06-01,1622502000.0
4037,6,1,2021-06-02,1202,295,34054,16002,2021-06-02,1622588400.0
4038,6,1,2021-06-03,804,195,34858,16197,2021-06-03,1622674800.0
4039,6,1,2021-06-04,993,180,35851,16377,2021-06-04,1622761200.0
4040,6,1,2021-06-05,673,210,36524,16587,2021-06-05,1622847600.0
4041,6,1,2021-06-06,1,0,36525,16587,2021-06-06,1622934000.0
4042,6,1,2021-06-07,85,5,36610,16592,2021-06-07,1623020400.0
4043,6,1,2021-06-08,946,320,37556,16912,2021-06-08,1623106800.0
4044,6,1,2021-06-09,965,421,38521,17333,2021-06-09,1623193200.0
4045,6,1,2021-06-10,678,139,39199,17472,2021-06-10,1623279600.0
4046,6,1,2021-06-11,841,252,40040,17724,2021-06-11,1623366000.0
4047,6,1,2021-06-12,578,214,40618,17938,2021-06-12,1623452400.0
4048,6,1,2021-06-13,0,0,40618,17938,2021-06-13,1623538800.0
4049,6,1,2021-06-14,178,84,40796,18022,2021-06-14,1623625200.0
4050,6,1,2021-06-15,399,764,41195,18786,2021-06-15,1623711600.0
4051,6,1,2021-06-16,881,1306,42076,20092,2021-06-16,1623798000.0
4052,6,1,2021-06-17,757,578,42833,20670,2021-06-17,1623884400.0
4053,6,1,2021-06-18,686,524,43519,21194,2021-06-18,1623970800.0
4054,6,1,2021-06-19,527,591,44046,21785,2021-06-19,1624057200.0
4055,6,1,2021-06-20,0,0,44046,21785,2021-06-20,1624143600.0
4056,6,1,2021-06-21,124,115,44170,21900,2021-06-21,1624230000.0
4057,6,1,2021-06-22,424,1084,44594,22984,2021-06-22,1624316400.0
4058,6,1,2021-06-23,647,1103,45241,24087,2021-06-23,1624402800.0
4059,6,1,2021-06-24,456,494,45697,24581,2021-06-24,1624489200.0
4060,6,1,2021-06-25,523,413,46220,24994,2021-06-25,1624575600.0
4061,6,1,2021-06-26,382,641,46602,25635,2021-06-26,1624662000.0
4062,6,1,2021-06-27,0,0,46602,25635,2021-06-27,1624748400.0
4063,6,1,2021-06-28,99,175,46701,25810,2021-06-28,1624834800.0
4064,6,1,2021-06-29,641,919,47342,26729,2021-06-29,1624921200.0
4065,6,1,2021-06-30,630,879,47972,27608,2021-06-30,1625007600.0
4066,6,1,2021-07-01,541,493,48513,28101,2021-07-01,1625094000.0
4067,6,1,2021-07-02,430,381,48943,28482,2021-07-02,1625180400.0
4068,6,1,2021-07-03,434,371,49377,28853,2021-07-03,1625266800.0
4069,6,1,2021-07-04,0,0,49377,28853,2021-07-04,1625353200.0
4070,6,1,2021-07-05,113,208,49490,29061,2021-07-05,1625439600.0
4071,6,1,2021-07-06,493,796,49983,29857,2021-07-06,1625526000.0
4072,6,1,2021-07-07,746,916,50729,30773,2021-07-07,1625612400.0
4073,6,1,2021-07-08,783,564,51512,31337,2021-07-08,1625698800.0
4074,6,2,2020-12-27,0,0,0,0,2020-12-27,1609023600.0
4075,6,2,2020-12-28,0,0,0,0,2020-12-28,1609110000.0
4076,6,2,2020-12-29,0,0,0,0,2020-12-29,1609196400.0
4077,6,2,2020-12-30,0,0,0,0,2020-12-30,1609282800.0
4078,6,2,2020-12-31,0,0,0,0,2020-12-31,1609369200.0
4079,6,2,2021-01-01,0,0,0,0,2021-01-01,1609455600.0
4080,6,2,2021-01-02,0,0,0,0,2021-01-02,1609542000.0
4081,6,2,2021-01-03,0,0,0,0,2021-01-03,1609628400.0
4082,6,2,2021-01-04,0,0,0,0,2021-01-04,1609714800.0
4083,6,2,2021-01-05,0,0,0,0,2021-01-05,1609801200.0
4084,6,2,2021-01-06,0,0,0,0,2021-01-06,1609887600.0
4085,6,2,2021-01-07,0,0,0,0,2021-01-07,1609974000.0
4086,6,2,2021-01-08,0,0,0,0,2021-01-08,1610060400.0
4087,6,2,2021-01-09,0,0,0,0,2021-01-09,1610146800.0
4088,6,2,2021-01-10,0,0,0,0,2021-01-10,1610233200.0
4089,6,2,2021-01-11,0,0,0,0,2021-01-11,1610319600.0
4090,6,2,2021-01-12,0,0,0,0,2021-01-12,1610406000.0
4091,6,2,2021-01-13,0,0,0,0,2021-01-13,1610492400.0
4092,6,2,2021-01-14,0,0,0,0,2021-01-14,1610578800.0
4093,6,2,2021-01-15,0,0,0,0,2021-01-15,1610665200.0
4094,6,2,2021-01-16,0,0,0,0,2021-01-16,1610751600.0
4095,6,2,2021-01-17,0,0,0,0,2021-01-17,1610838000.0
4096,6,2,2021-01-18,0,0,0,0,2021-01-18,1610924400.0
4097,6,2,2021-01-19,0,0,0,0,2021-01-19,1611010800.0
4098,6,2,2021-01-20,0,0,0,0,2021-01-20,1611097200.0
4099,6,2,2021-01-21,0,0,0,0,2021-01-21,1611183600.0
4100,6,2,2021-01-22,0,0,0,0,2021-01-22,1611270000.0
4101,6,2,2021-01-23,0,0,0,0,2021-01-23,1611356400.0
4102,6,2,2021-01-24,0,0,0,0,2021-01-24,1611442800.0
4103,6,2,2021-01-25,0,0,0,0,2021-01-25,1611529200.0
4104,6,2,2021-01-26,0,0,0,0,2021-01-26,1611615600.0
4105,6,2,2021-01-27,0,0,0,0,2021-01-27,1611702000.0
4106,6,2,2021-01-28,0,0,0,0,2021-01-28,1611788400.0
4107,6,2,2021-01-29,0,0,0,0,2021-01-29,1611874800.0
4108,6,2,2021-01-30,0,0,0,0,2021-01-30,1611961200.0
4109,6,2,2021-01-31,0,0,0,0,2021-01-31,1612047600.0
4110,6,2,2021-02-01,0,0,0,0,2021-02-01,1612134000.0
4111,6,2,2021-02-02,0,0,0,0,2021-02-02,1612220400.0
4112,6,2,2021-02-03,0,0,0,0,2021-02-03,1612306800.0
4113,6,2,2021-02-04,0,0,0,0,2021-02-04,1612393200.0
4114,6,2,2021-02-05,0,0,0,0,2021-02-05,1612479600.0
4115,6,2,2021-02-06,0,0,0,0,2021-02-06,1612566000.0
4116,6,2,2021-02-07,0,0,0,0,2021-02-07,1612652400.0
4117,6,2,2021-02-08,0,0,0,0,2021-02-08,1612738800.0
4118,6,2,2021-02-09,0,0,0,0,2021-02-09,1612825200.0
4119,6,2,2021-02-10,0,0,0,0,2021-02-10,1612911600.0
4120,6,2,2021-02-11,0,0,0,0,2021-02-11,1612998000.0
4121,6,2,2021-02-12,0,0,0,0,2021-02-12,1613084400.0
4122,6,2,2021-02-13,0,0,0,0,2021-02-13,1613170800.0
4123,6,2,2021-02-14,0,0,0,0,2021-02-14,1613257200.0
4124,6,2,2021-02-15,0,0,0,0,2021-02-15,1613343600.0
4125,6,2,2021-02-16,0,0,0,0,2021-02-16,1613430000.0
4126,6,2,2021-02-17,0,0,0,0,2021-02-17,1613516400.0
4127,6,2,2021-02-18,0,0,0,0,2021-02-18,1613602800.0
4128,6,2,2021-02-19,0,0,0,0,2021-02-19,1613689200.0
4129,6,2,2021-02-20,0,0,0,0,2021-02-20,1613775600.0
4130,6,2,2021-02-21,0,0,0,0,2021-02-21,1613862000.0
4131,6,2,2021-02-22,0,0,0,0,2021-02-22,1613948400.0
4132,6,2,2021-02-23,0,0,0,0,2021-02-23,1614034800.0
4133,6,2,2021-02-24,0,0,0,0,2021-02-24,1614121200.0
4134,6,2,2021-02-25,0,0,0,0,2021-02-25,1614207600.0
4135,6,2,2021-02-26,0,0,0,0,2021-02-26,1614294000.0
4136,6,2,2021-02-27,0,0,0,0,2021-02-27,1614380400.0
4137,6,2,2021-02-28,0,0,0,0,2021-02-28,1614466800.0
4138,6,2,2021-03-01,0,0,0,0,2021-03-01,1614553200.0
4139,6,2,2021-03-02,0,0,0,0,2021-03-02,1614639600.0
4140,6,2,2021-03-03,0,0,0,0,2021-03-03,1614726000.0
4141,6,2,2021-03-04,0,0,0,0,2021-03-04,1614812400.0
4142,6,2,2021-03-05,0,0,0,0,2021-03-05,1614898800.0
4143,6,2,2021-03-06,0,0,0,0,2021-03-06,1614985200.0
4144,6,2,2021-03-07,0,0,0,0,2021-03-07,1615071600.0
4145,6,2,2021-03-08,0,0,0,0,2021-03-08,1615158000.0
4146,6,2,2021-03-09,0,0,0,0,2021-03-09,1615244400.0
4147,6,2,2021-03-10,0,0,0,0,2021-03-10,1615330800.0
4148,6,2,2021-03-11,0,0,0,0,2021-03-11,1615417200.0
4149,6,2,2021-03-12,0,0,0,0,2021-03-12,1615503600.0
4150,6,2,2021-03-13,0,0,0,0,2021-03-13,1615590000.0
4151,6,2,2021-03-14,0,0,0,0,2021-03-14,1615676400.0
4152,6,2,2021-03-15,0,0,0,0,2021-03-15,1615762800.0
4153,6,2,2021-03-16,0,0,0,0,2021-03-16,1615849200.0
4154,6,2,2021-03-17,0,0,0,0,2021-03-17,1615935600.0
4155,6,2,2021-03-18,0,0,0,0,2021-03-18,1616022000.0
4156,6,2,2021-03-19,0,0,0,0,2021-03-19,1616108400.0
4157,6,2,2021-03-20,0,0,0,0,2021-03-20,1616194800.0
4158,6,2,2021-03-21,0,0,0,0,2021-03-21,1616281200.0
4159,6,2,2021-03-22,0,0,0,0,2021-03-22,1616367600.0
4160,6,2,2021-03-23,0,0,0,0,2021-03-23,1616454000.0
4161,6,2,2021-03-24,0,0,0,0,2021-03-24,1616540400.0
4162,6,2,2021-03-25,0,0,0,0,2021-03-25,1616626800.0
4163,6,2,2021-03-26,0,0,0,0,2021-03-26,1616713200.0
4164,6,2,2021-03-27,0,0,0,0,2021-03-27,1616799600.0
4165,6,2,2021-03-28,0,0,0,0,2021-03-28,1616886000.0
4166,6,2,2021-03-29,0,0,0,0,2021-03-29,1616972400.0
4167,6,2,2021-03-30,0,0,0,0,2021-03-30,1617058800.0
4168,6,2,2021-03-31,0,0,0,0,2021-03-31,1617145200.0
4169,6,2,2021-04-01,0,0,0,0,2021-04-01,1617231600.0
4170,6,2,2021-04-02,0,0,0,0,2021-04-02,1617318000.0
4171,6,2,2021-04-03,0,0,0,0,2021-04-03,1617404400.0
4172,6,2,2021-04-04,0,0,0,0,2021-04-04,1617490800.0
4173,6,2,2021-04-05,0,0,0,0,2021-04-05,1617577200.0
4174,6,2,2021-04-06,0,0,0,0,2021-04-06,1617663600.0
4175,6,2,2021-04-07,0,0,0,0,2021-04-07,1617750000.0
4176,6,2,2021-04-08,0,0,0,0,2021-04-08,1617836400.0
4177,6,2,2021-04-09,0,0,0,0,2021-04-09,1617922800.0
4178,6,2,2021-04-10,0,0,0,0,2021-04-10,1618009200.0
4179,6,2,2021-04-11,0,0,0,0,2021-04-11,1618095600.0
4180,6,2,2021-04-12,0,0,0,0,2021-04-12,1618185600.0
4181,6,2,2021-04-13,0,0,0,0,2021-04-13,1618272000.0
4182,6,2,2021-04-14,0,0,0,0,2021-04-14,1618358400.0
4183,6,2,2021-04-15,0,0,0,0,2021-04-15,1618444800.0
4184,6,2,2021-04-16,0,0,0,0,2021-04-16,1618531200.0
4185,6,2,2021-04-17,0,0,0,0,2021-04-17,1618617600.0
4186,6,2,2021-04-18,0,0,0,0,2021-04-18,1618704000.0
4187,6,2,2021-04-19,0,0,0,0,2021-04-19,1618790400.0
4188,6,2,2021-04-20,0,0,0,0,2021-04-20,1618876800.0
4189,6,2,2021-04-21,0,0,0,0,2021-04-21,1618963200.0
4190,6,2,2021-04-22,0,0,0,0,2021-04-22,1619049600.0
4191,6,2,2021-04-23,0,0,0,0,2021-04-23,1619136000.0
4192,6,2,2021-04-24,0,0,0,0,2021-04-24,1619222400.0
4193,6,2,2021-04-25,0,0,0,0,2021-04-25,1619308800.0
4194,6,2,2021-04-26,0,0,0,0,2021-04-26,1619395200.0
4195,6,2,2021-04-27,0,0,0,0,2021-04-27,1619481600.0
4196,6,2,2021-04-28,0,0,0,0,2021-04-28,1619568000.0
4197,6,2,2021-04-29,0,0,0,0,2021-04-29,1619654400.0
4198,6,2,2021-04-30,0,0,0,0,2021-04-30,1619740800.0
4199,6,2,2021-05-01,0,0,0,0,2021-05-01,1619827200.0
4200,6,2,2021-05-02,0,0,0,0,2021-05-02,1619913600.0
4201,6,2,2021-05-03,0,0,0,0,2021-05-03,1620000000.0
4202,6,2,2021-05-04,0,0,0,0,2021-05-04,1620086400.0
4203,6,2,2021-05-05,0,0,0,0,2021-05-05,1620172800.0
4204,6,2,2021-05-06,0,0,0,0,2021-05-06,1620259200.0
4205,6,2,2021-05-07,0,0,0,0,2021-05-07,1620345600.0
4206,6,2,2021-05-08,0,0,0,0,2021-05-08,1620432000.0
4207,6,2,2021-05-09,0,0,0,0,2021-05-09,1620518400.0
4208,6,2,2021-05-10,0,0,0,0,2021-05-10,1620604800.0
4209,6,2,2021-05-11,0,0,0,0,2021-05-11,1620691200.0
4210,6,2,2021-05-12,0,1,0,1,2021-05-12,1620777600.0
4211,6,2,2021-05-13,0,0,0,1,2021-05-13,1620864000.0
4212,6,2,2021-05-14,0,0,0,1,2021-05-14,1620950400.0
4213,6,2,2021-05-15,0,0,0,1,2021-05-15,1621036800.0
4214,6,2,2021-05-16,0,0,0,1,2021-05-16,1621123200.0
4215,6,2,2021-05-17,1,0,1,1,2021-05-17,1621206000.0
4216,6,2,2021-05-18,0,0,1,1,2021-05-18,1621292400.0
4217,6,2,2021-05-19,0,0,1,1,2021-05-19,1621378800.0
4218,6,2,2021-05-20,0,0,1,1,2021-05-20,1621465200.0
4219,6,2,2021-05-21,0,0,1,1,2021-05-21,1621551600.0
4220,6,2,2021-05-22,0,0,1,1,2021-05-22,1621638000.0
4221,6,2,2021-05-23,0,0,1,1,2021-05-23,1621724400.0
4222,6,2,2021-05-24,0,0,1,1,2021-05-24,1621810800.0
4223,6,2,2021-05-25,0,0,1,1,2021-05-25,1621897200.0
4224,6,2,2021-05-26,0,0,1,1,2021-05-26,1621983600.0
4225,6,2,2021-05-27,0,0,1,1,2021-05-27,1622070000.0
4226,6,2,2021-05-28,0,0,1,1,2021-05-28,1622156400.0
4227,6,2,2021-05-29,0,0,1,1,2021-05-29,1622242800.0
4228,6,2,2021-05-30,0,0,1,1,2021-05-30,1622329200.0
4229,6,2,2021-05-31,0,0,1,1,2021-05-31,1622415600.0
4230,6,2,2021-06-01,0,0,1,1,2021-06-01,1622502000.0
4231,6,2,2021-06-02,0,0,1,1,2021-06-02,1622588400.0
4232,6,2,2021-06-03,0,0,1,1,2021-06-03,1622674800.0
4233,6,2,2021-06-04,0,0,1,1,2021-06-04,1622761200.0
4234,6,2,2021-06-05,0,0,1,1,2021-06-05,1622847600.0
4235,6,2,2021-06-06,0,0,1,1,2021-06-06,1622934000.0
4236,6,2,2021-06-07,0,0,1,1,2021-06-07,1623020400.0
4237,6,2,2021-06-08,0,0,1,1,2021-06-08,1623106800.0
4238,6,2,2021-06-09,0,0,1,1,2021-06-09,1623193200.0
4239,6,2,2021-06-10,0,0,1,1,2021-06-10,1623279600.0
4240,6,2,2021-06-11,0,0,1,1,2021-06-11,1623366000.0
4241,6,2,2021-06-12,0,0,1,1,2021-06-12,1623452400.0
4242,6,2,2021-06-13,0,0,1,1,2021-06-13,1623538800.0
4243,6,2,2021-06-14,0,0,1,1,2021-06-14,1623625200.0
4244,6,2,2021-06-15,0,0,1,1,2021-06-15,1623711600.0
4245,6,2,2021-06-16,0,0,1,1,2021-06-16,1623798000.0
4246,6,2,2021-06-17,0,0,1,1,2021-06-17,1623884400.0
4247,6,2,2021-06-18,0,0,1,1,2021-06-18,1623970800.0
4248,6,2,2021-06-19,0,0,1,1,2021-06-19,1624057200.0
4249,6,2,2021-06-20,0,0,1,1,2021-06-20,1624143600.0
4250,6,2,2021-06-21,0,0,1,1,2021-06-21,1624230000.0
4251,6,2,2021-06-22,0,0,1,1,2021-06-22,1624316400.0
4252,6,2,2021-06-23,0,0,1,1,2021-06-23,1624402800.0
4253,6,2,2021-06-24,0,0,1,1,2021-06-24,1624489200.0
4254,6,2,2021-06-25,0,0,1,1,2021-06-25,1624575600.0
4255,6,2,2021-06-26,0,0,1,1,2021-06-26,1624662000.0
4256,6,2,2021-06-27,0,0,1,1,2021-06-27,1624748400.0
4257,6,2,2021-06-28,0,0,1,1,2021-06-28,1624834800.0
4258,6,2,2021-06-29,0,0,1,1,2021-06-29,1624921200.0
4259,6,2,2021-06-30,0,0,1,1,2021-06-30,1625007600.0
4260,6,2,2021-07-01,0,0,1,1,2021-07-01,1625094000.0
4261,6,2,2021-07-02,0,0,1,1,2021-07-02,1625180400.0
4262,6,2,2021-07-03,0,0,1,1,2021-07-03,1625266800.0
4263,6,2,2021-07-04,0,0,1,1,2021-07-04,1625353200.0
4264,6,2,2021-07-05,0,0,1,1,2021-07-05,1625439600.0
4265,6,2,2021-07-06,0,0,1,1,2021-07-06,1625526000.0
4266,6,2,2021-07-07,0,0,1,1,2021-07-07,1625612400.0
4267,6,2,2021-07-08,0,0,1,1,2021-07-08,1625698800.0
4268,6,3,2020-12-27,0,0,0,0,2020-12-27,1609023600.0
4269,6,3,2020-12-28,0,0,0,0,2020-12-28,1609110000.0
4270,6,3,2020-12-29,0,0,0,0,2020-12-29,1609196400.0
4271,6,3,2020-12-30,0,0,0,0,2020-12-30,1609282800.0
4272,6,3,2020-12-31,0,0,0,0,2020-12-31,1609369200.0
4273,6,3,2021-01-01,0,0,0,0,2021-01-01,1609455600.0
4274,6,3,2021-01-02,0,0,0,0,2021-01-02,1609542000.0
4275,6,3,2021-01-03,0,0,0,0,2021-01-03,1609628400.0
4276,6,3,2021-01-04,0,0,0,0,2021-01-04,1609714800.0
4277,6,3,2021-01-05,0,0,0,0,2021-01-05,1609801200.0
4278,6,3,2021-01-06,0,0,0,0,2021-01-06,1609887600.0
4279,6,3,2021-01-07,0,0,0,0,2021-01-07,1609974000.0
4280,6,3,2021-01-08,0,0,0,0,2021-01-08,1610060400.0
4281,6,3,2021-01-09,0,0,0,0,2021-01-09,1610146800.0
4282,6,3,2021-01-10,0,0,0,0,2021-01-10,1610233200.0
4283,6,3,2021-01-11,0,0,0,0,2021-01-11,1610319600.0
4284,6,3,2021-01-12,0,0,0,0,2021-01-12,1610406000.0
4285,6,3,2021-01-13,0,0,0,0,2021-01-13,1610492400.0
4286,6,3,2021-01-14,0,0,0,0,2021-01-14,1610578800.0
4287,6,3,2021-01-15,0,0,0,0,2021-01-15,1610665200.0
4288,6,3,2021-01-16,0,0,0,0,2021-01-16,1610751600.0
4289,6,3,2021-01-17,0,0,0,0,2021-01-17,1610838000.0
4290,6,3,2021-01-18,0,0,0,0,2021-01-18,1610924400.0
4291,6,3,2021-01-19,0,0,0,0,2021-01-19,1611010800.0
4292,6,3,2021-01-20,0,0,0,0,2021-01-20,1611097200.0
4293,6,3,2021-01-21,0,0,0,0,2021-01-21,1611183600.0
4294,6,3,2021-01-22,0,0,0,0,2021-01-22,1611270000.0
4295,6,3,2021-01-23,0,0,0,0,2021-01-23,1611356400.0
4296,6,3,2021-01-24,0,0,0,0,2021-01-24,1611442800.0
4297,6,3,2021-01-25,0,0,0,0,2021-01-25,1611529200.0
4298,6,3,2021-01-26,0,0,0,0,2021-01-26,1611615600.0
4299,6,3,2021-01-27,0,0,0,0,2021-01-27,1611702000.0
4300,6,3,2021-01-28,0,0,0,0,2021-01-28,1611788400.0
4301,6,3,2021-01-29,0,0,0,0,2021-01-29,1611874800.0
4302,6,3,2021-01-30,0,0,0,0,2021-01-30,1611961200.0
4303,6,3,2021-01-31,0,0,0,0,2021-01-31,1612047600.0
4304,6,3,2021-02-01,0,0,0,0,2021-02-01,1612134000.0
4305,6,3,2021-02-02,0,0,0,0,2021-02-02,1612220400.0
4306,6,3,2021-02-03,0,0,0,0,2021-02-03,1612306800.0
4307,6,3,2021-02-04,0,0,0,0,2021-02-04,1612393200.0
4308,6,3,2021-02-05,0,0,0,0,2021-02-05,1612479600.0
4309,6,3,2021-02-06,0,0,0,0,2021-02-06,1612566000.0
4310,6,3,2021-02-07,0,0,0,0,2021-02-07,1612652400.0
4311,6,3,2021-02-08,0,0,0,0,2021-02-08,1612738800.0
4312,6,3,2021-02-09,0,0,0,0,2021-02-09,1612825200.0
4313,6,3,2021-02-10,0,0,0,0,2021-02-10,1612911600.0
4314,6,3,2021-02-11,0,0,0,0,2021-02-11,1612998000.0
4315,6,3,2021-02-12,0,0,0,0,2021-02-12,1613084400.0
4316,6,3,2021-02-13,0,0,0,0,2021-02-13,1613170800.0
4317,6,3,2021-02-14,0,0,0,0,2021-02-14,1613257200.0
4318,6,3,2021-02-15,0,0,0,0,2021-02-15,1613343600.0
4319,6,3,2021-02-16,0,0,0,0,2021-02-16,1613430000.0
4320,6,3,2021-02-17,0,0,0,0,2021-02-17,1613516400.0
4321,6,3,2021-02-18,0,0,0,0,2021-02-18,1613602800.0
4322,6,3,2021-02-19,0,0,0,0,2021-02-19,1613689200.0
4323,6,3,2021-02-20,0,0,0,0,2021-02-20,1613775600.0
4324,6,3,2021-02-21,0,0,0,0,2021-02-21,1613862000.0
4325,6,3,2021-02-22,0,0,0,0,2021-02-22,1613948400.0
4326,6,3,2021-02-23,0,0,0,0,2021-02-23,1614034800.0
4327,6,3,2021-02-24,0,0,0,0,2021-02-24,1614121200.0
4328,6,3,2021-02-25,0,0,0,0,2021-02-25,1614207600.0
4329,6,3,2021-02-26,0,0,0,0,2021-02-26,1614294000.0
4330,6,3,2021-02-27,0,0,0,0,2021-02-27,1614380400.0
4331,6,3,2021-02-28,0,0,0,0,2021-02-28,1614466800.0
4332,6,3,2021-03-01,0,0,0,0,2021-03-01,1614553200.0
4333,6,3,2021-03-02,0,0,0,0,2021-03-02,1614639600.0
4334,6,3,2021-03-03,0,0,0,0,2021-03-03,1614726000.0
4335,6,3,2021-03-04,0,0,0,0,2021-03-04,1614812400.0
4336,6,3,2021-03-05,0,0,0,0,2021-03-05,1614898800.0
4337,6,3,2021-03-06,0,0,0,0,2021-03-06,1614985200.0
4338,6,3,2021-03-07,0,0,0,0,2021-03-07,1615071600.0
4339,6,3,2021-03-08,0,0,0,0,2021-03-08,1615158000.0
4340,6,3,2021-03-09,0,0,0,0,2021-03-09,1615244400.0
4341,6,3,2021-03-10,0,0,0,0,2021-03-10,1615330800.0
4342,6,3,2021-03-11,0,0,0,0,2021-03-11,1615417200.0
4343,6,3,2021-03-12,0,0,0,0,2021-03-12,1615503600.0
4344,6,3,2021-03-13,1,0,1,0,2021-03-13,1615590000.0
4345,6,3,2021-03-14,0,0,1,0,2021-03-14,1615676400.0
4346,6,3,2021-03-15,0,0,1,0,2021-03-15,1615762800.0
4347,6,3,2021-03-16,0,0,1,0,2021-03-16,1615849200.0
4348,6,3,2021-03-17,0,0,1,0,2021-03-17,1615935600.0
4349,6,3,2021-03-18,0,0,1,0,2021-03-18,1616022000.0
4350,6,3,2021-03-19,0,0,1,0,2021-03-19,1616108400.0
4351,6,3,2021-03-20,0,0,1,0,2021-03-20,1616194800.0
4352,6,3,2021-03-21,0,0,1,0,2021-03-21,1616281200.0
4353,6,3,2021-03-22,0,0,1,0,2021-03-22,1616367600.0
4354,6,3,2021-03-23,0,0,1,0,2021-03-23,1616454000.0
4355,6,3,2021-03-24,0,0,1,0,2021-03-24,1616540400.0
4356,6,3,2021-03-25,0,0,1,0,2021-03-25,1616626800.0
4357,6,3,2021-03-26,0,0,1,0,2021-03-26,1616713200.0
4358,6,3,2021-03-27,0,0,1,0,2021-03-27,1616799600.0
4359,6,3,2021-03-28,0,0,1,0,2021-03-28,1616886000.0
4360,6,3,2021-03-29,0,0,1,0,2021-03-29,1616972400.0
4361,6,3,2021-03-30,0,0,1,0,2021-03-30,1617058800.0
4362,6,3,2021-03-31,0,0,1,0,2021-03-31,1617145200.0
4363,6,3,2021-04-01,0,0,1,0,2021-04-01,1617231600.0
4364,6,3,2021-04-02,0,0,1,0,2021-04-02,1617318000.0
4365,6,3,2021-04-03,0,0,1,0,2021-04-03,1617404400.0
4366,6,3,2021-04-04,0,0,1,0,2021-04-04,1617490800.0
4367,6,3,2021-04-05,0,0,1,0,2021-04-05,1617577200.0
4368,6,3,2021-04-06,0,0,1,0,2021-04-06,1617663600.0
4369,6,3,2021-04-07,0,0,1,0,2021-04-07,1617750000.0
4370,6,3,2021-04-08,0,0,1,0,2021-04-08,1617836400.0
4371,6,3,2021-04-09,0,0,1,0,2021-04-09,1617922800.0
4372,6,3,2021-04-10,0,0,1,0,2021-04-10,1618009200.0
4373,6,3,2021-04-11,0,0,1,0,2021-04-11,1618095600.0
4374,6,3,2021-04-12,0,0,1,0,2021-04-12,1618185600.0
4375,6,3,2021-04-13,0,0,1,0,2021-04-13,1618272000.0
4376,6,3,2021-04-14,0,0,1,0,2021-04-14,1618358400.0
4377,6,3,2021-04-15,0,0,1,0,2021-04-15,1618444800.0
4378,6,3,2021-04-16,0,0,1,0,2021-04-16,1618531200.0
4379,6,3,2021-04-17,0,0,1,0,2021-04-17,1618617600.0
4380,6,3,2021-04-18,0,0,1,0,2021-04-18,1618704000.0
4381,6,3,2021-04-19,0,0,1,0,2021-04-19,1618790400.0
4382,6,3,2021-04-20,0,0,1,0,2021-04-20,1618876800.0
4383,6,3,2021-04-21,0,0,1,0,2021-04-21,1618963200.0
4384,6,3,2021-04-22,0,0,1,0,2021-04-22,1619049600.0
4385,6,3,2021-04-23,0,0,1,0,2021-04-23,1619136000.0
4386,6,3,2021-04-24,0,0,1,0,2021-04-24,1619222400.0
4387,6,3,2021-04-25,0,0,1,0,2021-04-25,1619308800.0
4388,6,3,2021-04-26,0,0,1,0,2021-04-26,1619395200.0
4389,6,3,2021-04-27,0,0,1,0,2021-04-27,1619481600.0
4390,6,3,2021-04-28,1,0,2,0,2021-04-28,1619568000.0
4391,6,3,2021-04-29,0,0,2,0,2021-04-29,1619654400.0
4392,6,3,2021-04-30,0,0,2,0,2021-04-30,1619740800.0
4393,6,3,2021-05-01,0,0,2,0,2021-05-01,1619827200.0
4394,6,3,2021-05-02,0,0,2,0,2021-05-02,1619913600.0
4395,6,3,2021-05-03,0,0,2,0,2021-05-03,1620000000.0
4396,6,3,2021-05-04,0,0,2,0,2021-05-04,1620086400.0
4397,6,3,2021-05-05,0,0,2,0,2021-05-05,1620172800.0
4398,6,3,2021-05-06,0,0,2,0,2021-05-06,1620259200.0
4399,6,3,2021-05-07,0,0,2,0,2021-05-07,1620345600.0
4400,6,3,2021-05-08,0,0,2,0,2021-05-08,1620432000.0
4401,6,3,2021-05-09,0,0,2,0,2021-05-09,1620518400.0
4402,6,3,2021-05-10,0,0,2,0,2021-05-10,1620604800.0
4403,6,3,2021-05-11,0,0,2,0,2021-05-11,1620691200.0
4404,6,3,2021-05-12,0,0,2,0,2021-05-12,1620777600.0
4405,6,3,2021-05-13,0,0,2,0,2021-05-13,1620864000.0
4406,6,3,2021-05-14,0,0,2,0,2021-05-14,1620950400.0
4407,6,3,2021-05-15,0,0,2,0,2021-05-15,1621036800.0
4408,6,3,2021-05-16,0,0,2,0,2021-05-16,1621123200.0
4409,6,3,2021-05-17,0,0,2,0,2021-05-17,1621206000.0
4410,6,3,2021-05-18,0,0,2,0,2021-05-18,1621292400.0
4411,6,3,2021-05-19,0,0,2,0,2021-05-19,1621378800.0
4412,6,3,2021-05-20,0,0,2,0,2021-05-20,1621465200.0
4413,6,3,2021-05-21,0,0,2,0,2021-05-21,1621551600.0
4414,6,3,2021-05-22,0,0,2,0,2021-05-22,1621638000.0
4415,6,3,2021-05-23,0,0,2,0,2021-05-23,1621724400.0
4416,6,3,2021-05-24,0,0,2,0,2021-05-24,1621810800.0
4417,6,3,2021-05-25,1,0,3,0,2021-05-25,1621897200.0
4418,6,3,2021-05-26,0,0,3,0,2021-05-26,1621983600.0
4419,6,3,2021-05-27,0,0,3,0,2021-05-27,1622070000.0
4420,6,3,2021-05-28,0,0,3,0,2021-05-28,1622156400.0
4421,6,3,2021-05-29,0,0,3,0,2021-05-29,1622242800.0
4422,6,3,2021-05-30,0,1,3,1,2021-05-30,1622329200.0
4423,6,3,2021-05-31,0,0,3,1,2021-05-31,1622415600.0
4424,6,3,2021-06-01,0,0,3,1,2021-06-01,1622502000.0
4425,6,3,2021-06-02,0,0,3,1,2021-06-02,1622588400.0
4426,6,3,2021-06-03,0,0,3,1,2021-06-03,1622674800.0
4427,6,3,2021-06-04,0,0,3,1,2021-06-04,1622761200.0
4428,6,3,2021-06-05,0,0,3,1,2021-06-05,1622847600.0
4429,6,3,2021-06-06,0,0,3,1,2021-06-06,1622934000.0
4430,6,3,2021-06-07,0,0,3,1,2021-06-07,1623020400.0
4431,6,3,2021-06-08,0,0,3,1,2021-06-08,1623106800.0
4432,6,3,2021-06-09,0,0,3,1,2021-06-09,1623193200.0
4433,6,3,2021-06-10,0,0,3,1,2021-06-10,1623279600.0
4434,6,3,2021-06-11,0,0,3,1,2021-06-11,1623366000.0
4435,6,3,2021-06-12,0,0,3,1,2021-06-12,1623452400.0
4436,6,3,2021-06-13,0,0,3,1,2021-06-13,1623538800.0
4437,6,3,2021-06-14,0,0,3,1,2021-06-14,1623625200.0
4438,6,3,2021-06-15,0,0,3,1,2021-06-15,1623711600.0
4439,6,3,2021-06-16,0,0,3,1,2021-06-16,1623798000.0
4440,6,3,2021-06-17,0,0,3,1,2021-06-17,1623884400.0
4441,6,3,2021-06-18,0,0,3,1,2021-06-18,1623970800.0
4442,6,3,2021-06-19,0,0,3,1,2021-06-19,1624057200.0
4443,6,3,2021-06-20,0,0,3,1,2021-06-20,1624143600.0
4444,6,3,2021-06-21,0,0,3,1,2021-06-21,1624230000.0
4445,6,3,2021-06-22,0,0,3,1,2021-06-22,1624316400.0
4446,6,3,2021-06-23,0,0,3,1,2021-06-23,1624402800.0
4447,6,3,2021-06-24,0,0,3,1,2021-06-24,1624489200.0
4448,6,3,2021-06-25,0,0,3,1,2021-06-25,1624575600.0
4449,6,3,2021-06-26,0,0,3,1,2021-06-26,1624662000.0
4450,6,3,2021-06-27,0,0,3,1,2021-06-27,1624748400.0
4451,6,3,2021-06-28,0,0,3,1,2021-06-28,1624834800.0
4452,6,3,2021-06-29,0,0,3,1,2021-06-29,1624921200.0
4453,6,3,2021-06-30,0,0,3,1,2021-06-30,1625007600.0
4454,6,3,2021-07-01,0,0,3,1,2021-07-01,1625094000.0
4455,6,3,2021-07-02,0,0,3,1,2021-07-02,1625180400.0
4456,6,3,2021-07-03,0,0,3,1,2021-07-03,1625266800.0
4457,6,3,2021-07-04,0,0,3,1,2021-07-04,1625353200.0
4458,6,3,2021-07-05,0,0,3,1,2021-07-05,1625439600.0
4459,6,3,2021-07-06,0,0,3,1,2021-07-06,1625526000.0
4460,6,3,2021-07-07,0,0,3,1,2021-07-07,1625612400.0
4461,6,3,2021-07-08,0,0,3,1,2021-07-08,1625698800.0
4462,6,4,2020-12-27,0,0,0,0,2020-12-27,1609023600.0
4463,6,4,2020-12-28,0,0,0,0,2020-12-28,1609110000.0
4464,6,4,2020-12-29,0,0,0,0,2020-12-29,1609196400.0
4465,6,4,2020-12-30,0,0,0,0,2020-12-30,1609282800.0
4466,6,4,2020-12-31,0,0,0,0,2020-12-31,1609369200.0
4467,6,4,2021-01-01,0,0,0,0,2021-01-01,1609455600.0
4468,6,4,2021-01-02,0,0,0,0,2021-01-02,1609542000.0
4469,6,4,2021-01-03,0,0,0,0,2021-01-03,1609628400.0
4470,6,4,2021-01-04,0,0,0,0,2021-01-04,1609714800.0
4471,6,4,2021-01-05,0,0,0,0,2021-01-05,1609801200.0
4472,6,4,2021-01-06,0,0,0,0,2021-01-06,1609887600.0
4473,6,4,2021-01-07,0,0,0,0,2021-01-07,1609974000.0
4474,6,4,2021-01-08,0,0,0,0,2021-01-08,1610060400.0
4475,6,4,2021-01-09,0,0,0,0,2021-01-09,1610146800.0
4476,6,4,2021-01-10,0,0,0,0,2021-01-10,1610233200.0
4477,6,4,2021-01-11,0,0,0,0,2021-01-11,1610319600.0
4478,6,4,2021-01-12,0,0,0,0,2021-01-12,1610406000.0
4479,6,4,2021-01-13,0,0,0,0,2021-01-13,1610492400.0
4480,6,4,2021-01-14,0,0,0,0,2021-01-14,1610578800.0
4481,6,4,2021-01-15,0,0,0,0,2021-01-15,1610665200.0
4482,6,4,2021-01-16,0,0,0,0,2021-01-16,1610751600.0
4483,6,4,2021-01-17,0,0,0,0,2021-01-17,1610838000.0
4484,6,4,2021-01-18,0,0,0,0,2021-01-18,1610924400.0
4485,6,4,2021-01-19,0,0,0,0,2021-01-19,1611010800.0
4486,6,4,2021-01-20,0,0,0,0,2021-01-20,1611097200.0
4487,6,4,2021-01-21,0,0,0,0,2021-01-21,1611183600.0
4488,6,4,2021-01-22,0,0,0,0,2021-01-22,1611270000.0
4489,6,4,2021-01-23,0,0,0,0,2021-01-23,1611356400.0
4490,6,4,2021-01-24,0,0,0,0,2021-01-24,1611442800.0
4491,6,4,2021-01-25,0,0,0,0,2021-01-25,1611529200.0
4492,6,4,2021-01-26,0,0,0,0,2021-01-26,1611615600.0
4493,6,4,2021-01-27,0,0,0,0,2021-01-27,1611702000.0
4494,6,4,2021-01-28,0,0,0,0,2021-01-28,1611788400.0
4495,6,4,2021-01-29,0,0,0,0,2021-01-29,1611874800.0
4496,6,4,2021-01-30,0,0,0,0,2021-01-30,1611961200.0
4497,6,4,2021-01-31,0,0,0,0,2021-01-31,1612047600.0
4498,6,4,2021-02-01,0,0,0,0,2021-02-01,1612134000.0
4499,6,4,2021-02-02,0,0,0,0,2021-02-02,1612220400.0
4500,6,4,2021-02-03,0,0,0,0,2021-02-03,1612306800.0
4501,6,4,2021-02-04,0,0,0,0,2021-02-04,1612393200.0
4502,6,4,2021-02-05,0,0,0,0,2021-02-05,1612479600.0
4503,6,4,2021-02-06,0,0,0,0,2021-02-06,1612566000.0
4504,6,4,2021-02-07,0,0,0,0,2021-02-07,1612652400.0
4505,6,4,2021-02-08,0,0,0,0,2021-02-08,1612738800.0
4506,6,4,2021-02-09,0,0,0,0,2021-02-09,1612825200.0
4507,6,4,2021-02-10,0,0,0,0,2021-02-10,1612911600.0
4508,6,4,2021-02-11,0,0,0,0,2021-02-11,1612998000.0
4509,6,4,2021-02-12,0,0,0,0,2021-02-12,1613084400.0
4510,6,4,2021-02-13,0,0,0,0,2021-02-13,1613170800.0
4511,6,4,2021-02-14,0,0,0,0,2021-02-14,1613257200.0
4512,6,4,2021-02-15,0,0,0,0,2021-02-15,1613343600.0
4513,6,4,2021-02-16,0,0,0,0,2021-02-16,1613430000.0
4514,6,4,2021-02-17,0,0,0,0,2021-02-17,1613516400.0
4515,6,4,2021-02-18,0,0,0,0,2021-02-18,1613602800.0
4516,6,4,2021-02-19,0,0,0,0,2021-02-19,1613689200.0
4517,6,4,2021-02-20,0,0,0,0,2021-02-20,1613775600.0
4518,6,4,2021-02-21,0,0,0,0,2021-02-21,1613862000.0
4519,6,4,2021-02-22,0,0,0,0,2021-02-22,1613948400.0
4520,6,4,2021-02-23,0,0,0,0,2021-02-23,1614034800.0
4521,6,4,2021-02-24,0,0,0,0,2021-02-24,1614121200.0
4522,6,4,2021-02-25,0,0,0,0,2021-02-25,1614207600.0
4523,6,4,2021-02-26,0,0,0,0,2021-02-26,1614294000.0
4524,6,4,2021-02-27,0,0,0,0,2021-02-27,1614380400.0
4525,6,4,2021-02-28,0,0,0,0,2021-02-28,1614466800.0
4526,6,4,2021-03-01,0,0,0,0,2021-03-01,1614553200.0
4527,6,4,2021-03-02,0,0,0,0,2021-03-02,1614639600.0
4528,6,4,2021-03-03,0,0,0,0,2021-03-03,1614726000.0
4529,6,4,2021-03-04,0,0,0,0,2021-03-04,1614812400.0
4530,6,4,2021-03-05,0,0,0,0,2021-03-05,1614898800.0
4531,6,4,2021-03-06,0,0,0,0,2021-03-06,1614985200.0
4532,6,4,2021-03-07,0,0,0,0,2021-03-07,1615071600.0
4533,6,4,2021-03-08,0,0,0,0,2021-03-08,1615158000.0
4534,6,4,2021-03-09,0,0,0,0,2021-03-09,1615244400.0
4535,6,4,2021-03-10,0,0,0,0,2021-03-10,1615330800.0
4536,6,4,2021-03-11,0,0,0,0,2021-03-11,1615417200.0
4537,6,4,2021-03-12,0,0,0,0,2021-03-12,1615503600.0
4538,6,4,2021-03-13,0,0,0,0,2021-03-13,1615590000.0
4539,6,4,2021-03-14,0,0,0,0,2021-03-14,1615676400.0
4540,6,4,2021-03-15,0,0,0,0,2021-03-15,1615762800.0
4541,6,4,2021-03-16,0,0,0,0,2021-03-16,1615849200.0
4542,6,4,2021-03-17,0,0,0,0,2021-03-17,1615935600.0
4543,6,4,2021-03-18,0,0,0,0,2021-03-18,1616022000.0
4544,6,4,2021-03-19,0,0,0,0,2021-03-19,1616108400.0
4545,6,4,2021-03-20,0,0,0,0,2021-03-20,1616194800.0
4546,6,4,2021-03-21,0,0,0,0,2021-03-21,1616281200.0
4547,6,4,2021-03-22,0,0,0,0,2021-03-22,1616367600.0
4548,6,4,2021-03-23,0,0,0,0,2021-03-23,1616454000.0
4549,6,4,2021-03-24,0,0,0,0,2021-03-24,1616540400.0
4550,6,4,2021-03-25,0,0,0,0,2021-03-25,1616626800.0
4551,6,4,2021-03-26,0,0,0,0,2021-03-26,1616713200.0
4552,6,4,2021-03-27,0,0,0,0,2021-03-27,1616799600.0
4553,6,4,2021-03-28,0,0,0,0,2021-03-28,1616886000.0
4554,6,4,2021-03-29,0,0,0,0,2021-03-29,1616972400.0
4555,6,4,2021-03-30,0,0,0,0,2021-03-30,1617058800.0
4556,6,4,2021-03-31,0,0,0,0,2021-03-31,1617145200.0
4557,6,4,2021-04-01,0,0,0,0,2021-04-01,1617231600.0
4558,6,4,2021-04-02,0,0,0,0,2021-04-02,1617318000.0
4559,6,4,2021-04-03,0,0,0,0,2021-04-03,1617404400.0
4560,6,4,2021-04-04,0,0,0,0,2021-04-04,1617490800.0
4561,6,4,2021-04-05,0,0,0,0,2021-04-05,1617577200.0
4562,6,4,2021-04-06,0,0,0,0,2021-04-06,1617663600.0
4563,6,4,2021-04-07,0,0,0,0,2021-04-07,1617750000.0
4564,6,4,2021-04-08,0,0,0,0,2021-04-08,1617836400.0
4565,6,4,2021-04-09,0,0,0,0,2021-04-09,1617922800.0
4566,6,4,2021-04-10,0,0,0,0,2021-04-10,1618009200.0
4567,6,4,2021-04-11,0,0,0,0,2021-04-11,1618095600.0
4568,6,4,2021-04-12,0,0,0,0,2021-04-12,1618185600.0
4569,6,4,2021-04-13,0,0,0,0,2021-04-13,1618272000.0
4570,6,4,2021-04-14,0,0,0,0,2021-04-14,1618358400.0
4571,6,4,2021-04-15,0,0,0,0,2021-04-15,1618444800.0
4572,6,4,2021-04-16,0,0,0,0,2021-04-16,1618531200.0
4573,6,4,2021-04-17,0,0,0,0,2021-04-17,1618617600.0
4574,6,4,2021-04-18,0,0,0,0,2021-04-18,1618704000.0
4575,6,4,2021-04-19,0,0,0,0,2021-04-19,1618790400.0
4576,6,4,2021-04-20,0,0,0,0,2021-04-20,1618876800.0
4577,6,4,2021-04-21,0,0,0,0,2021-04-21,1618963200.0
4578,6,4,2021-04-22,0,0,0,0,2021-04-22,1619049600.0
4579,6,4,2021-04-23,0,0,0,0,2021-04-23,1619136000.0
4580,6,4,2021-04-24,0,0,0,0,2021-04-24,1619222400.0
4581,6,4,2021-04-25,0,0,0,0,2021-04-25,1619308800.0
4582,6,4,2021-04-26,0,0,0,0,2021-04-26,1619395200.0
4583,6,4,2021-04-27,0,0,0,0,2021-04-27,1619481600.0
4584,6,4,2021-04-28,0,0,0,0,2021-04-28,1619568000.0
4585,6,4,2021-04-29,0,0,0,0,2021-04-29,1619654400.0
4586,6,4,2021-04-30,0,0,0,0,2021-04-30,1619740800.0
4587,6,4,2021-05-01,0,0,0,0,2021-05-01,1619827200.0
4588,6,4,2021-05-02,0,0,0,0,2021-05-02,1619913600.0
4589,6,4,2021-05-03,0,0,0,0,2021-05-03,1620000000.0
4590,6,4,2021-05-04,0,0,0,0,2021-05-04,1620086400.0
4591,6,4,2021-05-05,0,0,0,0,2021-05-05,1620172800.0
4592,6,4,2021-05-06,0,0,0,0,2021-05-06,1620259200.0
4593,6,4,2021-05-07,0,0,0,0,2021-05-07,1620345600.0
4594,6,4,2021-05-08,0,0,0,0,2021-05-08,1620432000.0
4595,6,4,2021-05-09,0,0,0,0,2021-05-09,1620518400.0
4596,6,4,2021-05-10,0,0,0,0,2021-05-10,1620604800.0
4597,6,4,2021-05-11,0,0,0,0,2021-05-11,1620691200.0
4598,6,4,2021-05-12,0,0,0,0,2021-05-12,1620777600.0
4599,6,4,2021-05-13,0,0,0,0,2021-05-13,1620864000.0
4600,6,4,2021-05-14,0,0,0,0,2021-05-14,1620950400.0
4601,6,4,2021-05-15,0,0,0,0,2021-05-15,1621036800.0
4602,6,4,2021-05-16,0,0,0,0,2021-05-16,1621123200.0
4603,6,4,2021-05-17,0,0,0,0,2021-05-17,1621206000.0
4604,6,4,2021-05-18,1,0,1,0,2021-05-18,1621292400.0
4605,6,4,2021-05-19,0,0,1,0,2021-05-19,1621378800.0
4606,6,4,2021-05-20,0,0,1,0,2021-05-20,1621465200.0
4607,6,4,2021-05-21,0,0,1,0,2021-05-21,1621551600.0
4608,6,4,2021-05-22,0,0,1,0,2021-05-22,1621638000.0
4609,6,4,2021-05-23,0,0,1,0,2021-05-23,1621724400.0
4610,6,4,2021-05-24,0,0,1,0,2021-05-24,1621810800.0
4611,6,4,2021-05-25,0,0,1,0,2021-05-25,1621897200.0
4612,6,4,2021-05-26,0,0,1,0,2021-05-26,1621983600.0
4613,6,4,2021-05-27,0,0,1,0,2021-05-27,1622070000.0
4614,6,4,2021-05-28,0,0,1,0,2021-05-28,1622156400.0
4615,6,4,2021-05-29,0,0,1,0,2021-05-29,1622242800.0
4616,6,4,2021-05-30,0,0,1,0,2021-05-30,1622329200.0
4617,6,4,2021-05-31,0,0,1,0,2021-05-31,1622415600.0
4618,6,4,2021-06-01,0,0,1,0,2021-06-01,1622502000.0
4619,6,4,2021-06-02,0,0,1,0,2021-06-02,1622588400.0
4620,6,4,2021-06-03,0,0,1,0,2021-06-03,1622674800.0
4621,6,4,2021-06-04,0,0,1,0,2021-06-04,1622761200.0
4622,6,4,2021-06-05,0,0,1,0,2021-06-05,1622847600.0
4623,6,4,2021-06-06,0,0,1,0,2021-06-06,1622934000.0
4624,6,4,2021-06-07,0,0,1,0,2021-06-07,1623020400.0
4625,6,4,2021-06-08,0,0,1,0,2021-06-08,1623106800.0
4626,6,4,2021-06-09,0,0,1,0,2021-06-09,1623193200.0
4627,6,4,2021-06-10,0,0,1,0,2021-06-10,1623279600.0
4628,6,4,2021-06-11,0,0,1,0,2021-06-11,1623366000.0
4629,6,4,2021-06-12,0,0,1,0,2021-06-12,1623452400.0
4630,6,4,2021-06-13,0,0,1,0,2021-06-13,1623538800.0
4631,6,4,2021-06-14,0,0,1,0,2021-06-14,1623625200.0
4632,6,4,2021-06-15,0,0,1,0,2021-06-15,1623711600.0
4633,6,4,2021-06-16,0,0,1,0,2021-06-16,1623798000.0
4634,6,4,2021-06-17,0,0,1,0,2021-06-17,1623884400.0
4635,6,4,2021-06-18,0,0,1,0,2021-06-18,1623970800.0
4636,6,4,2021-06-19,0,0,1,0,2021-06-19,1624057200.0
4637,6,4,2021-06-20,0,0,1,0,2021-06-20,1624143600.0
4638,6,4,2021-06-21,0,0,1,0,2021-06-21,1624230000.0
4639,6,4,2021-06-22,0,0,1,0,2021-06-22,1624316400.0
4640,6,4,2021-06-23,0,0,1,0,2021-06-23,1624402800.0
4641,6,4,2021-06-24,0,0,1,0,2021-06-24,1624489200.0
4642,6,4,2021-06-25,0,0,1,0,2021-06-25,1624575600.0
4643,6,4,2021-06-26,0,0,1,0,2021-06-26,1624662000.0
4644,6,4,2021-06-27,0,0,1,0,2021-06-27,1624748400.0
4645,6,4,2021-06-28,0,0,1,0,2021-06-28,1624834800.0
4646,6,4,2021-06-29,0,0,1,0,2021-06-29,1624921200.0
4647,6,4,2021-06-30,0,0,1,0,2021-06-30,1625007600.0
4648,6,4,2021-07-01,0,0,1,0,2021-07-01,1625094000.0
4649,6,4,2021-07-02,0,0,1,0,2021-07-02,1625180400.0
4650,6,4,2021-07-03,0,0,1,0,2021-07-03,1625266800.0
4651,6,4,2021-07-04,0,0,1,0,2021-07-04,1625353200.0
4652,6,4,2021-07-05,0,0,1,0,2021-07-05,1625439600.0
4653,6,4,2021-07-06,0,0,1,0,2021-07-06,1625526000.0
4654,6,4,2021-07-07,0,0,1,0,2021-07-07,1625612400.0
4655,6,4,2021-07-08,0,0,1,0,2021-07-08,1625698800.0
4656,7,1,2020-12-27,0,0,0,0,2020-12-27,1609023600.0
4657,7,1,2020-12-28,0,0,0,0,2020-12-28,1609110000.0
4658,7,1,2020-12-29,0,0,0,0,2020-12-29,1609196400.0
4659,7,1,2020-12-30,0,0,0,0,2020-12-30,1609282800.0
4660,7,1,2020-12-31,0,0,0,0,2020-12-31,1609369200.0
4661,7,1,2021-01-01,0,0,0,0,2021-01-01,1609455600.0
4662,7,1,2021-01-02,0,0,0,0,2021-01-02,1609542000.0
4663,7,1,2021-01-03,0,0,0,0,2021-01-03,1609628400.0
4664,7,1,2021-01-04,0,0,0,0,2021-01-04,1609714800.0
4665,7,1,2021-01-05,0,0,0,0,2021-01-05,1609801200.0
4666,7,1,2021-01-06,0,0,0,0,2021-01-06,1609887600.0
4667,7,1,2021-01-07,0,0,0,0,2021-01-07,1609974000.0
4668,7,1,2021-01-08,0,0,0,0,2021-01-08,1610060400.0
4669,7,1,2021-01-09,0,0,0,0,2021-01-09,1610146800.0
4670,7,1,2021-01-10,0,0,0,0,2021-01-10,1610233200.0
4671,7,1,2021-01-11,0,0,0,0,2021-01-11,1610319600.0
4672,7,1,2021-01-12,0,0,0,0,2021-01-12,1610406000.0
4673,7,1,2021-01-13,0,0,0,0,2021-01-13,1610492400.0
4674,7,1,2021-01-14,0,0,0,0,2021-01-14,1610578800.0
4675,7,1,2021-01-15,0,0,0,0,2021-01-15,1610665200.0
4676,7,1,2021-01-16,0,0,0,0,2021-01-16,1610751600.0
4677,7,1,2021-01-17,0,0,0,0,2021-01-17,1610838000.0
4678,7,1,2021-01-18,1,0,1,0,2021-01-18,1610924400.0
4679,7,1,2021-01-19,0,0,1,0,2021-01-19,1611010800.0
4680,7,1,2021-01-20,0,0,1,0,2021-01-20,1611097200.0
4681,7,1,2021-01-21,12,0,13,0,2021-01-21,1611183600.0
4682,7,1,2021-01-22,12,0,25,0,2021-01-22,1611270000.0
4683,7,1,2021-01-23,0,0,25,0,2021-01-23,1611356400.0
4684,7,1,2021-01-24,0,0,25,0,2021-01-24,1611442800.0
4685,7,1,2021-01-25,0,0,25,0,2021-01-25,1611529200.0
4686,7,1,2021-01-26,0,0,25,0,2021-01-26,1611615600.0
4687,7,1,2021-01-27,12,0,37,0,2021-01-27,1611702000.0
4688,7,1,2021-01-28,1,0,38,0,2021-01-28,1611788400.0
4689,7,1,2021-01-29,6,0,44,0,2021-01-29,1611874800.0
4690,7,1,2021-01-30,0,0,44,0,2021-01-30,1611961200.0
4691,7,1,2021-01-31,0,0,44,0,2021-01-31,1612047600.0
4692,7,1,2021-02-01,0,0,44,0,2021-02-01,1612134000.0
4693,7,1,2021-02-02,0,0,44,0,2021-02-02,1612220400.0
4694,7,1,2021-02-03,11,0,55,0,2021-02-03,1612306800.0
4695,7,1,2021-02-04,12,0,67,0,2021-02-04,1612393200.0
4696,7,1,2021-02-05,11,0,78,0,2021-02-05,1612479600.0
4697,7,1,2021-02-06,0,0,78,0,2021-02-06,1612566000.0
4698,7,1,2021-02-07,0,0,78,0,2021-02-07,1612652400.0
4699,7,1,2021-02-08,0,0,78,0,2021-02-08,1612738800.0
4700,7,1,2021-02-09,13,0,91,0,2021-02-09,1612825200.0
4701,7,1,2021-02-10,0,0,91,0,2021-02-10,1612911600.0
4702,7,1,2021-02-11,17,0,108,0,2021-02-11,1612998000.0
4703,7,1,2021-02-12,45,0,153,0,2021-02-12,1613084400.0
4704,7,1,2021-02-13,0,0,153,0,2021-02-13,1613170800.0
4705,7,1,2021-02-14,0,0,153,0,2021-02-14,1613257200.0
4706,7,1,2021-02-15,0,0,153,0,2021-02-15,1613343600.0
4707,7,1,2021-02-16,0,0,153,0,2021-02-16,1613430000.0
4708,7,1,2021-02-17,0,0,153,0,2021-02-17,1613516400.0
4709,7,1,2021-02-18,18,0,171,0,2021-02-18,1613602800.0
4710,7,1,2021-02-19,34,0,205,0,2021-02-19,1613689200.0
4711,7,1,2021-02-20,0,0,205,0,2021-02-20,1613775600.0
4712,7,1,2021-02-21,0,0,205,0,2021-02-21,1613862000.0
4713,7,1,2021-02-22,0,0,205,0,2021-02-22,1613948400.0
4714,7,1,2021-02-23,0,22,205,22,2021-02-23,1614034800.0
4715,7,1,2021-02-24,0,0,205,22,2021-02-24,1614121200.0
4716,7,1,2021-02-25,15,10,220,32,2021-02-25,1614207600.0
4717,7,1,2021-02-26,33,19,253,51,2021-02-26,1614294000.0
4718,7,1,2021-02-27,0,0,253,51,2021-02-27,1614380400.0
4719,7,1,2021-02-28,0,0,253,51,2021-02-28,1614466800.0
4720,7,1,2021-03-01,0,0,253,51,2021-03-01,1614553200.0
4721,7,1,2021-03-02,17,11,270,62,2021-03-02,1614639600.0
4722,7,1,2021-03-03,0,0,270,62,2021-03-03,1614726000.0
4723,7,1,2021-03-04,16,11,286,73,2021-03-04,1614812400.0
4724,7,1,2021-03-05,31,19,317,92,2021-03-05,1614898800.0
4725,7,1,2021-03-06,0,0,317,92,2021-03-06,1614985200.0
4726,7,1,2021-03-07,0,0,317,92,2021-03-07,1615071600.0
4727,7,1,2021-03-08,0,0,317,92,2021-03-08,1615158000.0
4728,7,1,2021-03-09,1,0,318,92,2021-03-09,1615244400.0
4729,7,1,2021-03-10,0,0,318,92,2021-03-10,1615330800.0
4730,7,1,2021-03-11,20,30,338,122,2021-03-11,1615417200.0
4731,7,1,2021-03-12,62,42,400,164,2021-03-12,1615503600.0
4732,7,1,2021-03-13,0,0,400,164,2021-03-13,1615590000.0
4733,7,1,2021-03-14,0,0,400,164,2021-03-14,1615676400.0
4734,7,1,2021-03-15,0,0,400,164,2021-03-15,1615762800.0
4735,7,1,2021-03-16,30,9,430,173,2021-03-16,1615849200.0
4736,7,1,2021-03-17,0,0,430,173,2021-03-17,1615935600.0
4737,7,1,2021-03-18,29,16,459,189,2021-03-18,1616022000.0
4738,7,1,2021-03-19,56,31,515,220,2021-03-19,1616108400.0
4739,7,1,2021-03-20,0,0,515,220,2021-03-20,1616194800.0
4740,7,1,2021-03-21,0,0,515,220,2021-03-21,1616281200.0
4741,7,1,2021-03-22,0,0,515,220,2021-03-22,1616367600.0
4742,7,1,2021-03-23,0,0,515,220,2021-03-23,1616454000.0
4743,7,1,2021-03-24,0,0,515,220,2021-03-24,1616540400.0
4744,7,1,2021-03-25,65,13,580,233,2021-03-25,1616626800.0
4745,7,1,2021-03-26,73,24,653,257,2021-03-26,1616713200.0
4746,7,1,2021-03-27,0,0,653,257,2021-03-27,1616799600.0
4747,7,1,2021-03-28,0,0,653,257,2021-03-28,1616886000.0
4748,7,1,2021-03-29,0,0,653,257,2021-03-29,1616972400.0
4749,7,1,2021-03-30,40,17,693,274,2021-03-30,1617058800.0
4750,7,1,2021-03-31,26,14,719,288,2021-03-31,1617145200.0
4751,7,1,2021-04-01,25,30,744,318,2021-04-01,1617231600.0
4752,7,1,2021-04-02,0,0,744,318,2021-04-02,1617318000.0
4753,7,1,2021-04-03,0,0,744,318,2021-04-03,1617404400.0
4754,7,1,2021-04-04,0,0,744,318,2021-04-04,1617490800.0
4755,7,1,2021-04-05,0,0,744,318,2021-04-05,1617577200.0
4756,7,1,2021-04-06,0,0,744,318,2021-04-06,1617663600.0
4757,7,1,2021-04-07,0,0,744,318,2021-04-07,1617750000.0
4758,7,1,2021-04-08,57,46,801,364,2021-04-08,1617836400.0
4759,7,1,2021-04-09,59,31,860,395,2021-04-09,1617922800.0
4760,7,1,2021-04-10,0,0,860,395,2021-04-10,1618009200.0
4761,7,1,2021-04-11,0,0,860,395,2021-04-11,1618095600.0
4762,7,1,2021-04-12,0,0,860,395,2021-04-12,1618185600.0
4763,7,1,2021-04-13,0,0,860,395,2021-04-13,1618272000.0
4764,7,1,2021-04-14,3,6,863,401,2021-04-14,1618358400.0
4765,7,1,2021-04-15,55,67,918,468,2021-04-15,1618444800.0
4766,7,1,2021-04-16,90,33,1008,501,2021-04-16,1618531200.0
4767,7,1,2021-04-17,0,1,1008,502,2021-04-17,1618617600.0
4768,7,1,2021-04-18,0,0,1008,502,2021-04-18,1618704000.0
4769,7,1,2021-04-19,1,0,1009,502,2021-04-19,1618790400.0
4770,7,1,2021-04-20,333,53,1342,555,2021-04-20,1618876800.0
4771,7,1,2021-04-21,337,11,1679,566,2021-04-21,1618963200.0
4772,7,1,2021-04-22,284,27,1963,593,2021-04-22,1619049600.0
4773,7,1,2021-04-23,258,38,2221,631,2021-04-23,1619136000.0
4774,7,1,2021-04-24,231,1,2452,632,2021-04-24,1619222400.0
4775,7,1,2021-04-25,0,0,2452,632,2021-04-25,1619308800.0
4776,7,1,2021-04-26,282,9,2734,641,2021-04-26,1619395200.0
4777,7,1,2021-04-27,223,41,2957,682,2021-04-27,1619481600.0
4778,7,1,2021-04-28,192,9,3149,691,2021-04-28,1619568000.0
4779,7,1,2021-04-29,170,14,3319,705,2021-04-29,1619654400.0
4780,7,1,2021-04-30,172,11,3491,716,2021-04-30,1619740800.0
4781,7,1,2021-05-01,201,9,3692,725,2021-05-01,1619827200.0
4782,7,1,2021-05-02,0,0,3692,725,2021-05-02,1619913600.0
4783,7,1,2021-05-03,135,6,3827,731,2021-05-03,1620000000.0
4784,7,1,2021-05-04,161,36,3988,767,2021-05-04,1620086400.0
4785,7,1,2021-05-05,221,10,4209,777,2021-05-05,1620172800.0
4786,7,1,2021-05-06,175,25,4384,802,2021-05-06,1620259200.0
4787,7,1,2021-05-07,149,21,4533,823,2021-05-07,1620345600.0
4788,7,1,2021-05-08,1,0,4534,823,2021-05-08,1620432000.0
4789,7,1,2021-05-09,0,0,4534,823,2021-05-09,1620518400.0
4790,7,1,2021-05-10,0,0,4534,823,2021-05-10,1620604800.0
4791,7,1,2021-05-11,2,41,4536,864,2021-05-11,1620691200.0
4792,7,1,2021-05-12,6,36,4542,900,2021-05-12,1620777600.0
4793,7,1,2021-05-13,0,0,4542,900,2021-05-13,1620864000.0
4794,7,1,2021-05-14,28,97,4570,997,2021-05-14,1620950400.0
4795,7,1,2021-05-15,0,0,4570,997,2021-05-15,1621036800.0
4796,7,1,2021-05-16,1,0,4571,997,2021-05-16,1621123200.0
4797,7,1,2021-05-17,1,13,4572,1010,2021-05-17,1621206000.0
4798,7,1,2021-05-18,17,28,4589,1038,2021-05-18,1621292400.0
4799,7,1,2021-05-19,0,1,4589,1039,2021-05-19,1621378800.0
4800,7,1,2021-05-20,0,8,4589,1047,2021-05-20,1621465200.0
4801,7,1,2021-05-21,12,30,4601,1077,2021-05-21,1621551600.0
4802,7,1,2021-05-22,0,0,4601,1077,2021-05-22,1621638000.0
4803,7,1,2021-05-23,0,0,4601,1077,2021-05-23,1621724400.0
4804,7,1,2021-05-24,0,0,4601,1077,2021-05-24,1621810800.0
4805,7,1,2021-05-25,50,327,4651,1404,2021-05-25,1621897200.0
4806,7,1,2021-05-26,54,348,4705,1752,2021-05-26,1621983600.0
4807,7,1,2021-05-27,34,316,4739,2068,2021-05-27,1622070000.0
4808,7,1,2021-05-28,27,251,4766,2319,2021-05-28,1622156400.0
4809,7,1,2021-05-29,35,371,4801,2690,2021-05-29,1622242800.0
4810,7,1,2021-05-30,0,0,4801,2690,2021-05-30,1622329200.0
4811,7,1,2021-05-31,45,213,4846,2903,2021-05-31,1622415600.0
4812,7,1,2021-06-01,46,221,4892,3124,2021-06-01,1622502000.0
4813,7,1,2021-06-02,69,262,4961,3386,2021-06-02,1622588400.0
4814,7,1,2021-06-03,41,243,5002,3629,2021-06-03,1622674800.0
4815,7,1,2021-06-04,70,262,5072,3891,2021-06-04,1622761200.0
4816,7,1,2021-06-05,0,0,5072,3891,2021-06-05,1622847600.0
4817,7,1,2021-06-06,0,0,5072,3891,2021-06-06,1622934000.0
4818,7,1,2021-06-07,0,1,5072,3892,2021-06-07,1623020400.0
4819,7,1,2021-06-08,0,0,5072,3892,2021-06-08,1623106800.0
4820,7,1,2021-06-09,0,0,5072,3892,2021-06-09,1623193200.0
4821,7,1,2021-06-10,0,1,5072,3893,2021-06-10,1623279600.0
4822,7,1,2021-06-11,0,1,5072,3894,2021-06-11,1623366000.0
4823,7,1,2021-06-12,16,56,5088,3950,2021-06-12,1623452400.0
4824,7,1,2021-06-13,0,0,5088,3950,2021-06-13,1623538800.0
4825,7,1,2021-06-14,0,0,5088,3950,2021-06-14,1623625200.0
4826,7,1,2021-06-15,0,1,5088,3951,2021-06-15,1623711600.0
4827,7,1,2021-06-16,0,0,5088,3951,2021-06-16,1623798000.0
4828,7,1,2021-06-17,2,5,5090,3956,2021-06-17,1623884400.0
4829,7,1,2021-06-18,0,0,5090,3956,2021-06-18,1623970800.0
4830,7,1,2021-06-19,25,47,5115,4003,2021-06-19,1624057200.0
4831,7,1,2021-06-20,0,0,5115,4003,2021-06-20,1624143600.0
4832,7,1,2021-06-21,0,2,5115,4005,2021-06-21,1624230000.0
4833,7,1,2021-06-22,0,0,5115,4005,2021-06-22,1624316400.0
4834,7,1,2021-06-23,5,0,5120,4005,2021-06-23,1624402800.0
4835,7,1,2021-06-24,0,4,5120,4009,2021-06-24,1624489200.0
4836,7,1,2021-06-25,0,0,5120,4009,2021-06-25,1624575600.0
4837,7,1,2021-06-26,28,39,5148,4048,2021-06-26,1624662000.0
4838,7,1,2021-06-27,0,0,5148,4048,2021-06-27,1624748400.0
4839,7,1,2021-06-28,0,1,5148,4049,2021-06-28,1624834800.0
4840,7,1,2021-06-29,0,0,5148,4049,2021-06-29,1624921200.0
4841,7,1,2021-06-30,0,0,5148,4049,2021-06-30,1625007600.0
4842,7,1,2021-07-01,26,22,5174,4071,2021-07-01,1625094000.0
4843,7,1,2021-07-02,26,22,5200,4093,2021-07-02,1625180400.0
4844,7,1,2021-07-03,27,206,5227,4299,2021-07-03,1625266800.0
4845,7,1,2021-07-04,0,0,5227,4299,2021-07-04,1625353200.0
4846,7,1,2021-07-05,0,3,5227,4302,2021-07-05,1625439600.0
4847,7,1,2021-07-06,0,0,5227,4302,2021-07-06,1625526000.0
4848,7,1,2021-07-07,7,0,5234,4302,2021-07-07,1625612400.0
4849,7,1,2021-07-08,33,16,5267,4318,2021-07-08,1625698800.0
4850,7,2,2020-12-27,0,0,0,0,2020-12-27,1609023600.0
4851,7,2,2020-12-28,0,0,0,0,2020-12-28,1609110000.0
4852,7,2,2020-12-29,0,0,0,0,2020-12-29,1609196400.0
4853,7,2,2020-12-30,0,0,0,0,2020-12-30,1609282800.0
4854,7,2,2020-12-31,0,0,0,0,2020-12-31,1609369200.0
4855,7,2,2021-01-01,0,0,0,0,2021-01-01,1609455600.0
4856,7,2,2021-01-02,0,0,0,0,2021-01-02,1609542000.0
4857,7,2,2021-01-03,0,0,0,0,2021-01-03,1609628400.0
4858,7,2,2021-01-04,0,0,0,0,2021-01-04,1609714800.0
4859,7,2,2021-01-05,0,0,0,0,2021-01-05,1609801200.0
4860,7,2,2021-01-06,0,0,0,0,2021-01-06,1609887600.0
4861,7,2,2021-01-07,0,0,0,0,2021-01-07,1609974000.0
4862,7,2,2021-01-08,0,0,0,0,2021-01-08,1610060400.0
4863,7,2,2021-01-09,0,0,0,0,2021-01-09,1610146800.0
4864,7,2,2021-01-10,0,0,0,0,2021-01-10,1610233200.0
4865,7,2,2021-01-11,0,0,0,0,2021-01-11,1610319600.0
4866,7,2,2021-01-12,0,0,0,0,2021-01-12,1610406000.0
4867,7,2,2021-01-13,0,0,0,0,2021-01-13,1610492400.0
4868,7,2,2021-01-14,0,0,0,0,2021-01-14,1610578800.0
4869,7,2,2021-01-15,0,0,0,0,2021-01-15,1610665200.0
4870,7,2,2021-01-16,0,0,0,0,2021-01-16,1610751600.0
4871,7,2,2021-01-17,0,0,0,0,2021-01-17,1610838000.0
4872,7,2,2021-01-18,0,0,0,0,2021-01-18,1610924400.0
4873,7,2,2021-01-19,0,0,0,0,2021-01-19,1611010800.0
4874,7,2,2021-01-20,0,0,0,0,2021-01-20,1611097200.0
4875,7,2,2021-01-21,0,0,0,0,2021-01-21,1611183600.0
4876,7,2,2021-01-22,0,0,0,0,2021-01-22,1611270000.0
4877,7,2,2021-01-23,0,0,0,0,2021-01-23,1611356400.0
4878,7,2,2021-01-24,0,0,0,0,2021-01-24,1611442800.0
4879,7,2,2021-01-25,0,0,0,0,2021-01-25,1611529200.0
4880,7,2,2021-01-26,0,0,0,0,2021-01-26,1611615600.0
4881,7,2,2021-01-27,0,0,0,0,2021-01-27,1611702000.0
4882,7,2,2021-01-28,0,0,0,0,2021-01-28,1611788400.0
4883,7,2,2021-01-29,0,0,0,0,2021-01-29,1611874800.0
4884,7,2,2021-01-30,0,0,0,0,2021-01-30,1611961200.0
4885,7,2,2021-01-31,0,0,0,0,2021-01-31,1612047600.0
4886,7,2,2021-02-01,0,0,0,0,2021-02-01,1612134000.0
4887,7,2,2021-02-02,0,0,0,0,2021-02-02,1612220400.0
4888,7,2,2021-02-03,0,0,0,0,2021-02-03,1612306800.0
4889,7,2,2021-02-04,0,0,0,0,2021-02-04,1612393200.0
4890,7,2,2021-02-05,0,0,0,0,2021-02-05,1612479600.0
4891,7,2,2021-02-06,0,0,0,0,2021-02-06,1612566000.0
4892,7,2,2021-02-07,0,0,0,0,2021-02-07,1612652400.0
4893,7,2,2021-02-08,0,0,0,0,2021-02-08,1612738800.0
4894,7,2,2021-02-09,0,0,0,0,2021-02-09,1612825200.0
4895,7,2,2021-02-10,0,0,0,0,2021-02-10,1612911600.0
4896,7,2,2021-02-11,0,0,0,0,2021-02-11,1612998000.0
4897,7,2,2021-02-12,0,0,0,0,2021-02-12,1613084400.0
4898,7,2,2021-02-13,0,0,0,0,2021-02-13,1613170800.0
4899,7,2,2021-02-14,0,0,0,0,2021-02-14,1613257200.0
4900,7,2,2021-02-15,0,0,0,0,2021-02-15,1613343600.0
4901,7,2,2021-02-16,0,0,0,0,2021-02-16,1613430000.0
4902,7,2,2021-02-17,0,0,0,0,2021-02-17,1613516400.0
4903,7,2,2021-02-18,0,0,0,0,2021-02-18,1613602800.0
4904,7,2,2021-02-19,0,0,0,0,2021-02-19,1613689200.0
4905,7,2,2021-02-20,0,0,0,0,2021-02-20,1613775600.0
4906,7,2,2021-02-21,0,0,0,0,2021-02-21,1613862000.0
4907,7,2,2021-02-22,0,0,0,0,2021-02-22,1613948400.0
4908,7,2,2021-02-23,0,0,0,0,2021-02-23,1614034800.0
4909,7,2,2021-02-24,0,0,0,0,2021-02-24,1614121200.0
4910,7,2,2021-02-25,0,0,0,0,2021-02-25,1614207600.0
4911,7,2,2021-02-26,0,0,0,0,2021-02-26,1614294000.0
4912,7,2,2021-02-27,0,0,0,0,2021-02-27,1614380400.0
4913,7,2,2021-02-28,0,0,0,0,2021-02-28,1614466800.0
4914,7,2,2021-03-01,0,0,0,0,2021-03-01,1614553200.0
4915,7,2,2021-03-02,0,0,0,0,2021-03-02,1614639600.0
4916,7,2,2021-03-03,0,0,0,0,2021-03-03,1614726000.0
4917,7,2,2021-03-04,0,0,0,0,2021-03-04,1614812400.0
4918,7,2,2021-03-05,0,0,0,0,2021-03-05,1614898800.0
4919,7,2,2021-03-06,0,0,0,0,2021-03-06,1614985200.0
4920,7,2,2021-03-07,0,0,0,0,2021-03-07,1615071600.0
4921,7,2,2021-03-08,0,0,0,0,2021-03-08,1615158000.0
4922,7,2,2021-03-09,0,0,0,0,2021-03-09,1615244400.0
4923,7,2,2021-03-10,0,0,0,0,2021-03-10,1615330800.0
4924,7,2,2021-03-11,0,0,0,0,2021-03-11,1615417200.0
4925,7,2,2021-03-12,0,0,0,0,2021-03-12,1615503600.0
4926,7,2,2021-03-13,0,0,0,0,2021-03-13,1615590000.0
4927,7,2,2021-03-14,0,0,0,0,2021-03-14,1615676400.0
4928,7,2,2021-03-15,0,0,0,0,2021-03-15,1615762800.0
4929,7,2,2021-03-16,0,0,0,0,2021-03-16,1615849200.0
4930,7,2,2021-03-17,0,0,0,0,2021-03-17,1615935600.0
4931,7,2,2021-03-18,0,0,0,0,2021-03-18,1616022000.0
4932,7,2,2021-03-19,0,0,0,0,2021-03-19,1616108400.0
4933,7,2,2021-03-20,0,0,0,0,2021-03-20,1616194800.0
4934,7,2,2021-03-21,0,0,0,0,2021-03-21,1616281200.0
4935,7,2,2021-03-22,0,0,0,0,2021-03-22,1616367600.0
4936,7,2,2021-03-23,0,0,0,0,2021-03-23,1616454000.0
4937,7,2,2021-03-24,0,0,0,0,2021-03-24,1616540400.0
4938,7,2,2021-03-25,0,0,0,0,2021-03-25,1616626800.0
4939,7,2,2021-03-26,0,0,0,0,2021-03-26,1616713200.0
4940,7,2,2021-03-27,0,0,0,0,2021-03-27,1616799600.0
4941,7,2,2021-03-28,0,0,0,0,2021-03-28,1616886000.0
4942,7,2,2021-03-29,0,0,0,0,2021-03-29,1616972400.0
4943,7,2,2021-03-30,0,0,0,0,2021-03-30,1617058800.0
4944,7,2,2021-03-31,0,0,0,0,2021-03-31,1617145200.0
4945,7,2,2021-04-01,0,0,0,0,2021-04-01,1617231600.0
4946,7,2,2021-04-02,0,0,0,0,2021-04-02,1617318000.0
4947,7,2,2021-04-03,0,0,0,0,2021-04-03,1617404400.0
4948,7,2,2021-04-04,0,0,0,0,2021-04-04,1617490800.0
4949,7,2,2021-04-05,0,0,0,0,2021-04-05,1617577200.0
4950,7,2,2021-04-06,0,0,0,0,2021-04-06,1617663600.0
4951,7,2,2021-04-07,0,0,0,0,2021-04-07,1617750000.0
4952,7,2,2021-04-08,0,0,0,0,2021-04-08,1617836400.0
4953,7,2,2021-04-09,0,0,0,0,2021-04-09,1617922800.0
4954,7,2,2021-04-10,0,0,0,0,2021-04-10,1618009200.0
4955,7,2,2021-04-11,0,0,0,0,2021-04-11,1618095600.0
4956,7,2,2021-04-12,0,0,0,0,2021-04-12,1618185600.0
4957,7,2,2021-04-13,0,0,0,0,2021-04-13,1618272000.0
4958,7,2,2021-04-14,1,0,1,0,2021-04-14,1618358400.0
4959,7,2,2021-04-15,0,0,1,0,2021-04-15,1618444800.0
4960,7,2,2021-04-16,0,0,1,0,2021-04-16,1618531200.0
4961,7,2,2021-04-17,0,0,1,0,2021-04-17,1618617600.0
4962,7,2,2021-04-18,0,0,1,0,2021-04-18,1618704000.0
4963,7,2,2021-04-19,0,0,1,0,2021-04-19,1618790400.0
4964,7,2,2021-04-20,0,0,1,0,2021-04-20,1618876800.0
4965,7,2,2021-04-21,0,0,1,0,2021-04-21,1618963200.0
4966,7,2,2021-04-22,0,0,1,0,2021-04-22,1619049600.0
4967,7,2,2021-04-23,0,0,1,0,2021-04-23,1619136000.0
4968,7,2,2021-04-24,0,0,1,0,2021-04-24,1619222400.0
4969,7,2,2021-04-25,0,0,1,0,2021-04-25,1619308800.0
4970,7,2,2021-04-26,0,0,1,0,2021-04-26,1619395200.0
4971,7,2,2021-04-27,0,0,1,0,2021-04-27,1619481600.0
4972,7,2,2021-04-28,0,0,1,0,2021-04-28,1619568000.0
4973,7,2,2021-04-29,0,0,1,0,2021-04-29,1619654400.0
4974,7,2,2021-04-30,0,0,1,0,2021-04-30,1619740800.0
4975,7,2,2021-05-01,0,0,1,0,2021-05-01,1619827200.0
4976,7,2,2021-05-02,0,0,1,0,2021-05-02,1619913600.0
4977,7,2,2021-05-03,0,0,1,0,2021-05-03,1620000000.0
4978,7,2,2021-05-04,0,0,1,0,2021-05-04,1620086400.0
4979,7,2,2021-05-05,0,0,1,0,2021-05-05,1620172800.0
4980,7,2,2021-05-06,0,0,1,0,2021-05-06,1620259200.0
4981,7,2,2021-05-07,0,0,1,0,2021-05-07,1620345600.0
4982,7,2,2021-05-08,0,0,1,0,2021-05-08,1620432000.0
4983,7,2,2021-05-09,0,0,1,0,2021-05-09,1620518400.0
4984,7,2,2021-05-10,0,0,1,0,2021-05-10,1620604800.0
4985,7,2,2021-05-11,0,0,1,0,2021-05-11,1620691200.0
4986,7,2,2021-05-12,0,0,1,0,2021-05-12,1620777600.0
4987,7,2,2021-05-13,0,0,1,0,2021-05-13,1620864000.0
4988,7,2,2021-05-14,0,0,1,0,2021-05-14,1620950400.0
4989,7,2,2021-05-15,0,0,1,0,2021-05-15,1621036800.0
4990,7,2,2021-05-16,0,0,1,0,2021-05-16,1621123200.0
4991,7,2,2021-05-17,0,0,1,0,2021-05-17,1621206000.0
4992,7,2,2021-05-18,0,0,1,0,2021-05-18,1621292400.0
4993,7,2,2021-05-19,0,0,1,0,2021-05-19,1621378800.0
4994,7,2,2021-05-20,0,0,1,0,2021-05-20,1621465200.0
4995,7,2,2021-05-21,0,0,1,0,2021-05-21,1621551600.0
4996,7,2,2021-05-22,0,0,1,0,2021-05-22,1621638000.0
4997,7,2,2021-05-23,0,0,1,0,2021-05-23,1621724400.0
4998,7,2,2021-05-24,0,0,1,0,2021-05-24,1621810800.0
4999,7,2,2021-05-25,0,0,1,0,2021-05-25,1621897200.0
5000,7,2,2021-05-26,0,0,1,0,2021-05-26,1621983600.0
5001,7,2,2021-05-27,0,0,1,0,2021-05-27,1622070000.0
5002,7,2,2021-05-28,0,0,1,0,2021-05-28,1622156400.0
5003,7,2,2021-05-29,0,0,1,0,2021-05-29,1622242800.0
5004,7,2,2021-05-30,0,0,1,0,2021-05-30,1622329200.0
5005,7,2,2021-05-31,0,0,1,0,2021-05-31,1622415600.0
5006,7,2,2021-06-01,0,0,1,0,2021-06-01,1622502000.0
5007,7,2,2021-06-02,0,0,1,0,2021-06-02,1622588400.0
5008,7,2,2021-06-03,0,0,1,0,2021-06-03,1622674800.0
5009,7,2,2021-06-04,4,0,5,0,2021-06-04,1622761200.0
5010,7,2,2021-06-05,0,0,5,0,2021-06-05,1622847600.0
5011,7,2,2021-06-06,0,0,5,0,2021-06-06,1622934000.0
5012,7,2,2021-06-07,0,0,5,0,2021-06-07,1623020400.0
5013,7,2,2021-06-08,0,0,5,0,2021-06-08,1623106800.0
5014,7,2,2021-06-09,0,0,5,0,2021-06-09,1623193200.0
5015,7,2,2021-06-10,6,0,11,0,2021-06-10,1623279600.0
5016,7,2,2021-06-11,0,0,11,0,2021-06-11,1623366000.0
5017,7,2,2021-06-12,0,0,11,0,2021-06-12,1623452400.0
5018,7,2,2021-06-13,0,0,11,0,2021-06-13,1623538800.0
5019,7,2,2021-06-14,0,0,11,0,2021-06-14,1623625200.0
5020,7,2,2021-06-15,0,0,11,0,2021-06-15,1623711600.0
5021,7,2,2021-06-16,0,0,11,0,2021-06-16,1623798000.0
5022,7,2,2021-06-17,0,0,11,0,2021-06-17,1623884400.0
5023,7,2,2021-06-18,0,0,11,0,2021-06-18,1623970800.0
5024,7,2,2021-06-19,0,0,11,0,2021-06-19,1624057200.0
5025,7,2,2021-06-20,0,0,11,0,2021-06-20,1624143600.0
5026,7,2,2021-06-21,0,0,11,0,2021-06-21,1624230000.0
5027,7,2,2021-06-22,8,0,19,0,2021-06-22,1624316400.0
5028,7,2,2021-06-23,10,0,29,0,2021-06-23,1624402800.0
5029,7,2,2021-06-24,0,0,29,0,2021-06-24,1624489200.0
5030,7,2,2021-06-25,0,0,29,0,2021-06-25,1624575600.0
5031,7,2,2021-06-26,0,0,29,0,2021-06-26,1624662000.0
5032,7,2,2021-06-27,0,0,29,0,2021-06-27,1624748400.0
5033,7,2,2021-06-28,0,0,29,0,2021-06-28,1624834800.0
5034,7,2,2021-06-29,0,0,29,0,2021-06-29,1624921200.0
5035,7,2,2021-06-30,0,0,29,0,2021-06-30,1625007600.0
5036,7,2,2021-07-01,0,0,29,0,2021-07-01,1625094000.0
5037,7,2,2021-07-02,0,0,29,0,2021-07-02,1625180400.0
5038,7,2,2021-07-03,0,0,29,0,2021-07-03,1625266800.0
5039,7,2,2021-07-04,0,0,29,0,2021-07-04,1625353200.0
5040,7,2,2021-07-05,4,5,33,5,2021-07-05,1625439600.0
5041,7,2,2021-07-06,0,0,33,5,2021-07-06,1625526000.0
5042,7,2,2021-07-07,0,0,33,5,2021-07-07,1625612400.0
5043,7,2,2021-07-08,0,0,33,5,2021-07-08,1625698800.0
5044,7,3,2020-12-27,0,0,0,0,2020-12-27,1609023600.0
5045,7,3,2020-12-28,0,0,0,0,2020-12-28,1609110000.0
5046,7,3,2020-12-29,0,0,0,0,2020-12-29,1609196400.0
5047,7,3,2020-12-30,0,0,0,0,2020-12-30,1609282800.0
5048,7,3,2020-12-31,0,0,0,0,2020-12-31,1609369200.0
5049,7,3,2021-01-01,0,0,0,0,2021-01-01,1609455600.0
5050,7,3,2021-01-02,0,0,0,0,2021-01-02,1609542000.0
5051,7,3,2021-01-03,0,0,0,0,2021-01-03,1609628400.0
5052,7,3,2021-01-04,0,0,0,0,2021-01-04,1609714800.0
5053,7,3,2021-01-05,0,0,0,0,2021-01-05,1609801200.0
5054,7,3,2021-01-06,0,0,0,0,2021-01-06,1609887600.0
5055,7,3,2021-01-07,0,0,0,0,2021-01-07,1609974000.0
5056,7,3,2021-01-08,0,0,0,0,2021-01-08,1610060400.0
5057,7,3,2021-01-09,0,0,0,0,2021-01-09,1610146800.0
5058,7,3,2021-01-10,0,0,0,0,2021-01-10,1610233200.0
5059,7,3,2021-01-11,0,0,0,0,2021-01-11,1610319600.0
5060,7,3,2021-01-12,0,0,0,0,2021-01-12,1610406000.0
5061,7,3,2021-01-13,0,0,0,0,2021-01-13,1610492400.0
5062,7,3,2021-01-14,0,0,0,0,2021-01-14,1610578800.0
5063,7,3,2021-01-15,0,0,0,0,2021-01-15,1610665200.0
5064,7,3,2021-01-16,0,0,0,0,2021-01-16,1610751600.0
5065,7,3,2021-01-17,0,0,0,0,2021-01-17,1610838000.0
5066,7,3,2021-01-18,0,0,0,0,2021-01-18,1610924400.0
5067,7,3,2021-01-19,0,0,0,0,2021-01-19,1611010800.0
5068,7,3,2021-01-20,0,0,0,0,2021-01-20,1611097200.0
5069,7,3,2021-01-21,0,0,0,0,2021-01-21,1611183600.0
5070,7,3,2021-01-22,0,0,0,0,2021-01-22,1611270000.0
5071,7,3,2021-01-23,0,0,0,0,2021-01-23,1611356400.0
5072,7,3,2021-01-24,0,0,0,0,2021-01-24,1611442800.0
5073,7,3,2021-01-25,0,0,0,0,2021-01-25,1611529200.0
5074,7,3,2021-01-26,0,0,0,0,2021-01-26,1611615600.0
5075,7,3,2021-01-27,0,0,0,0,2021-01-27,1611702000.0
5076,7,3,2021-01-28,0,0,0,0,2021-01-28,1611788400.0
5077,7,3,2021-01-29,0,0,0,0,2021-01-29,1611874800.0
5078,7,3,2021-01-30,0,0,0,0,2021-01-30,1611961200.0
5079,7,3,2021-01-31,0,0,0,0,2021-01-31,1612047600.0
5080,7,3,2021-02-01,0,0,0,0,2021-02-01,1612134000.0
5081,7,3,2021-02-02,0,0,0,0,2021-02-02,1612220400.0
5082,7,3,2021-02-03,0,0,0,0,2021-02-03,1612306800.0
5083,7,3,2021-02-04,0,0,0,0,2021-02-04,1612393200.0
5084,7,3,2021-02-05,0,0,0,0,2021-02-05,1612479600.0
5085,7,3,2021-02-06,0,0,0,0,2021-02-06,1612566000.0
5086,7,3,2021-02-07,0,0,0,0,2021-02-07,1612652400.0
5087,7,3,2021-02-08,0,0,0,0,2021-02-08,1612738800.0
5088,7,3,2021-02-09,0,0,0,0,2021-02-09,1612825200.0
5089,7,3,2021-02-10,0,0,0,0,2021-02-10,1612911600.0
5090,7,3,2021-02-11,0,0,0,0,2021-02-11,1612998000.0
5091,7,3,2021-02-12,0,0,0,0,2021-02-12,1613084400.0
5092,7,3,2021-02-13,0,0,0,0,2021-02-13,1613170800.0
5093,7,3,2021-02-14,0,0,0,0,2021-02-14,1613257200.0
5094,7,3,2021-02-15,0,0,0,0,2021-02-15,1613343600.0
5095,7,3,2021-02-16,0,0,0,0,2021-02-16,1613430000.0
5096,7,3,2021-02-17,0,0,0,0,2021-02-17,1613516400.0
5097,7,3,2021-02-18,0,0,0,0,2021-02-18,1613602800.0
5098,7,3,2021-02-19,0,0,0,0,2021-02-19,1613689200.0
5099,7,3,2021-02-20,0,0,0,0,2021-02-20,1613775600.0
5100,7,3,2021-02-21,0,0,0,0,2021-02-21,1613862000.0
5101,7,3,2021-02-22,0,0,0,0,2021-02-22,1613948400.0
5102,7,3,2021-02-23,0,0,0,0,2021-02-23,1614034800.0
5103,7,3,2021-02-24,0,0,0,0,2021-02-24,1614121200.0
5104,7,3,2021-02-25,0,0,0,0,2021-02-25,1614207600.0
5105,7,3,2021-02-26,0,0,0,0,2021-02-26,1614294000.0
5106,7,3,2021-02-27,0,0,0,0,2021-02-27,1614380400.0
5107,7,3,2021-02-28,0,0,0,0,2021-02-28,1614466800.0
5108,7,3,2021-03-01,0,0,0,0,2021-03-01,1614553200.0
5109,7,3,2021-03-02,0,0,0,0,2021-03-02,1614639600.0
5110,7,3,2021-03-03,0,0,0,0,2021-03-03,1614726000.0
5111,7,3,2021-03-04,0,0,0,0,2021-03-04,1614812400.0
5112,7,3,2021-03-05,2,0,2,0,2021-03-05,1614898800.0
5113,7,3,2021-03-06,0,0,2,0,2021-03-06,1614985200.0
5114,7,3,2021-03-07,0,0,2,0,2021-03-07,1615071600.0
5115,7,3,2021-03-08,0,0,2,0,2021-03-08,1615158000.0
5116,7,3,2021-03-09,0,0,2,0,2021-03-09,1615244400.0
5117,7,3,2021-03-10,0,0,2,0,2021-03-10,1615330800.0
5118,7,3,2021-03-11,0,0,2,0,2021-03-11,1615417200.0
5119,7,3,2021-03-12,0,0,2,0,2021-03-12,1615503600.0
5120,7,3,2021-03-13,0,0,2,0,2021-03-13,1615590000.0
5121,7,3,2021-03-14,0,0,2,0,2021-03-14,1615676400.0
5122,7,3,2021-03-15,0,0,2,0,2021-03-15,1615762800.0
5123,7,3,2021-03-16,0,0,2,0,2021-03-16,1615849200.0
5124,7,3,2021-03-17,0,0,2,0,2021-03-17,1615935600.0
5125,7,3,2021-03-18,0,0,2,0,2021-03-18,1616022000.0
5126,7,3,2021-03-19,0,0,2,0,2021-03-19,1616108400.0
5127,7,3,2021-03-20,0,0,2,0,2021-03-20,1616194800.0
5128,7,3,2021-03-21,0,0,2,0,2021-03-21,1616281200.0
5129,7,3,2021-03-22,0,0,2,0,2021-03-22,1616367600.0
5130,7,3,2021-03-23,0,0,2,0,2021-03-23,1616454000.0
5131,7,3,2021-03-24,0,0,2,0,2021-03-24,1616540400.0
5132,7,3,2021-03-25,0,0,2,0,2021-03-25,1616626800.0
5133,7,3,2021-03-26,0,0,2,0,2021-03-26,1616713200.0
5134,7,3,2021-03-27,0,0,2,0,2021-03-27,1616799600.0
5135,7,3,2021-03-28,0,0,2,0,2021-03-28,1616886000.0
5136,7,3,2021-03-29,0,0,2,0,2021-03-29,1616972400.0
5137,7,3,2021-03-30,0,0,2,0,2021-03-30,1617058800.0
5138,7,3,2021-03-31,0,0,2,0,2021-03-31,1617145200.0
5139,7,3,2021-04-01,0,0,2,0,2021-04-01,1617231600.0
5140,7,3,2021-04-02,0,0,2,0,2021-04-02,1617318000.0
5141,7,3,2021-04-03,0,0,2,0,2021-04-03,1617404400.0
5142,7,3,2021-04-04,0,0,2,0,2021-04-04,1617490800.0
5143,7,3,2021-04-05,9,0,11,0,2021-04-05,1617577200.0
5144,7,3,2021-04-06,0,0,11,0,2021-04-06,1617663600.0
5145,7,3,2021-04-07,0,0,11,0,2021-04-07,1617750000.0
5146,7,3,2021-04-08,0,0,11,0,2021-04-08,1617836400.0
5147,7,3,2021-04-09,0,0,11,0,2021-04-09,1617922800.0
5148,7,3,2021-04-10,0,0,11,0,2021-04-10,1618009200.0
5149,7,3,2021-04-11,0,0,11,0,2021-04-11,1618095600.0
5150,7,3,2021-04-12,0,0,11,0,2021-04-12,1618185600.0
5151,7,3,2021-04-13,0,0,11,0,2021-04-13,1618272000.0
5152,7,3,2021-04-14,1,0,12,0,2021-04-14,1618358400.0
5153,7,3,2021-04-15,1,0,13,0,2021-04-15,1618444800.0
5154,7,3,2021-04-16,0,0,13,0,2021-04-16,1618531200.0
5155,7,3,2021-04-17,0,0,13,0,2021-04-17,1618617600.0
5156,7,3,2021-04-18,0,0,13,0,2021-04-18,1618704000.0
5157,7,3,2021-04-19,0,0,13,0,2021-04-19,1618790400.0
5158,7,3,2021-04-20,2,0,15,0,2021-04-20,1618876800.0
5159,7,3,2021-04-21,0,0,15,0,2021-04-21,1618963200.0
5160,7,3,2021-04-22,0,0,15,0,2021-04-22,1619049600.0
5161,7,3,2021-04-23,0,0,15,0,2021-04-23,1619136000.0
5162,7,3,2021-04-24,0,0,15,0,2021-04-24,1619222400.0
5163,7,3,2021-04-25,0,0,15,0,2021-04-25,1619308800.0
5164,7,3,2021-04-26,1,0,16,0,2021-04-26,1619395200.0
5165,7,3,2021-04-27,1,0,17,0,2021-04-27,1619481600.0
5166,7,3,2021-04-28,0,0,17,0,2021-04-28,1619568000.0
5167,7,3,2021-04-29,0,0,17,0,2021-04-29,1619654400.0
5168,7,3,2021-04-30,0,1,17,1,2021-04-30,1619740800.0
5169,7,3,2021-05-01,0,0,17,1,2021-05-01,1619827200.0
5170,7,3,2021-05-02,0,0,17,1,2021-05-02,1619913600.0
5171,7,3,2021-05-03,0,0,17,1,2021-05-03,1620000000.0
5172,7,3,2021-05-04,0,0,17,1,2021-05-04,1620086400.0
5173,7,3,2021-05-05,0,0,17,1,2021-05-05,1620172800.0
5174,7,3,2021-05-06,0,0,17,1,2021-05-06,1620259200.0
5175,7,3,2021-05-07,0,0,17,1,2021-05-07,1620345600.0
5176,7,3,2021-05-08,0,0,17,1,2021-05-08,1620432000.0
5177,7,3,2021-05-09,0,2,17,3,2021-05-09,1620518400.0
5178,7,3,2021-05-10,0,0,17,3,2021-05-10,1620604800.0
5179,7,3,2021-05-11,0,0,17,3,2021-05-11,1620691200.0
5180,7,3,2021-05-12,0,0,17,3,2021-05-12,1620777600.0
5181,7,3,2021-05-13,0,0,17,3,2021-05-13,1620864000.0
5182,7,3,2021-05-14,0,0,17,3,2021-05-14,1620950400.0
5183,7,3,2021-05-15,0,0,17,3,2021-05-15,1621036800.0
5184,7,3,2021-05-16,0,0,17,3,2021-05-16,1621123200.0
5185,7,3,2021-05-17,0,0,17,3,2021-05-17,1621206000.0
5186,7,3,2021-05-18,0,0,17,3,2021-05-18,1621292400.0
5187,7,3,2021-05-19,0,0,17,3,2021-05-19,1621378800.0
5188,7,3,2021-05-20,0,0,17,3,2021-05-20,1621465200.0
5189,7,3,2021-05-21,0,0,17,3,2021-05-21,1621551600.0
5190,7,3,2021-05-22,0,0,17,3,2021-05-22,1621638000.0
5191,7,3,2021-05-23,0,0,17,3,2021-05-23,1621724400.0
5192,7,3,2021-05-24,0,0,17,3,2021-05-24,1621810800.0
5193,7,3,2021-05-25,0,0,17,3,2021-05-25,1621897200.0
5194,7,3,2021-05-26,0,1,17,4,2021-05-26,1621983600.0
5195,7,3,2021-05-27,0,0,17,4,2021-05-27,1622070000.0
5196,7,3,2021-05-28,0,0,17,4,2021-05-28,1622156400.0
5197,7,3,2021-05-29,0,0,17,4,2021-05-29,1622242800.0
5198,7,3,2021-05-30,0,0,17,4,2021-05-30,1622329200.0
5199,7,3,2021-05-31,0,0,17,4,2021-05-31,1622415600.0
5200,7,3,2021-06-01,1,2,18,6,2021-06-01,1622502000.0
5201,7,3,2021-06-02,0,0,18,6,2021-06-02,1622588400.0
5202,7,3,2021-06-03,0,0,18,6,2021-06-03,1622674800.0
5203,7,3,2021-06-04,0,0,18,6,2021-06-04,1622761200.0
5204,7,3,2021-06-05,1,0,19,6,2021-06-05,1622847600.0
5205,7,3,2021-06-06,0,0,19,6,2021-06-06,1622934000.0
5206,7,3,2021-06-07,1,0,20,6,2021-06-07,1623020400.0
5207,7,3,2021-06-08,3,2,23,8,2021-06-08,1623106800.0
5208,7,3,2021-06-09,0,3,23,11,2021-06-09,1623193200.0
5209,7,3,2021-06-10,2,0,25,11,2021-06-10,1623279600.0
5210,7,3,2021-06-11,3,5,28,16,2021-06-11,1623366000.0
5211,7,3,2021-06-12,0,0,28,16,2021-06-12,1623452400.0
5212,7,3,2021-06-13,0,0,28,16,2021-06-13,1623538800.0
5213,7,3,2021-06-14,0,0,28,16,2021-06-14,1623625200.0
5214,7,3,2021-06-15,0,0,28,16,2021-06-15,1623711600.0
5215,7,3,2021-06-16,0,0,28,16,2021-06-16,1623798000.0
5216,7,3,2021-06-17,0,1,28,17,2021-06-17,1623884400.0
5217,7,3,2021-06-18,0,2,28,19,2021-06-18,1623970800.0
5218,7,3,2021-06-19,0,0,28,19,2021-06-19,1624057200.0
5219,7,3,2021-06-20,0,0,28,19,2021-06-20,1624143600.0
5220,7,3,2021-06-21,0,0,28,19,2021-06-21,1624230000.0
5221,7,3,2021-06-22,0,0,28,19,2021-06-22,1624316400.0
5222,7,3,2021-06-23,0,2,28,21,2021-06-23,1624402800.0
5223,7,3,2021-06-24,10,1,38,22,2021-06-24,1624489200.0
5224,7,3,2021-06-25,0,0,38,22,2021-06-25,1624575600.0
5225,7,3,2021-06-26,0,0,38,22,2021-06-26,1624662000.0
5226,7,3,2021-06-27,0,0,38,22,2021-06-27,1624748400.0
5227,7,3,2021-06-28,0,0,38,22,2021-06-28,1624834800.0
5228,7,3,2021-06-29,0,0,38,22,2021-06-29,1624921200.0
5229,7,3,2021-06-30,0,0,38,22,2021-06-30,1625007600.0
5230,7,3,2021-07-01,0,0,38,22,2021-07-01,1625094000.0
5231,7,3,2021-07-02,0,0,38,22,2021-07-02,1625180400.0
5232,7,3,2021-07-03,0,0,38,22,2021-07-03,1625266800.0
5233,7,3,2021-07-04,0,0,38,22,2021-07-04,1625353200.0
5234,7,3,2021-07-05,0,0,38,22,2021-07-05,1625439600.0
5235,7,3,2021-07-06,0,0,38,22,2021-07-06,1625526000.0
5236,7,3,2021-07-07,1,0,39,22,2021-07-07,1625612400.0
5237,7,3,2021-07-08,0,0,39,22,2021-07-08,1625698800.0
5238,7,4,2020-12-27,0,0,0,0,2020-12-27,1609023600.0
5239,7,4,2020-12-28,0,0,0,0,2020-12-28,1609110000.0
5240,7,4,2020-12-29,0,0,0,0,2020-12-29,1609196400.0
5241,7,4,2020-12-30,0,0,0,0,2020-12-30,1609282800.0
5242,7,4,2020-12-31,0,0,0,0,2020-12-31,1609369200.0
5243,7,4,2021-01-01,0,0,0,0,2021-01-01,1609455600.0
5244,7,4,2021-01-02,0,0,0,0,2021-01-02,1609542000.0
5245,7,4,2021-01-03,0,0,0,0,2021-01-03,1609628400.0
5246,7,4,2021-01-04,0,0,0,0,2021-01-04,1609714800.0
5247,7,4,2021-01-05,0,0,0,0,2021-01-05,1609801200.0
5248,7,4,2021-01-06,0,0,0,0,2021-01-06,1609887600.0
5249,7,4,2021-01-07,0,0,0,0,2021-01-07,1609974000.0
5250,7,4,2021-01-08,0,0,0,0,2021-01-08,1610060400.0
5251,7,4,2021-01-09,0,0,0,0,2021-01-09,1610146800.0
5252,7,4,2021-01-10,0,0,0,0,2021-01-10,1610233200.0
5253,7,4,2021-01-11,0,0,0,0,2021-01-11,1610319600.0
5254,7,4,2021-01-12,0,0,0,0,2021-01-12,1610406000.0
5255,7,4,2021-01-13,0,0,0,0,2021-01-13,1610492400.0
5256,7,4,2021-01-14,0,0,0,0,2021-01-14,1610578800.0
5257,7,4,2021-01-15,0,0,0,0,2021-01-15,1610665200.0
5258,7,4,2021-01-16,0,0,0,0,2021-01-16,1610751600.0
5259,7,4,2021-01-17,0,0,0,0,2021-01-17,1610838000.0
5260,7,4,2021-01-18,0,0,0,0,2021-01-18,1610924400.0
5261,7,4,2021-01-19,0,0,0,0,2021-01-19,1611010800.0
5262,7,4,2021-01-20,0,0,0,0,2021-01-20,1611097200.0
5263,7,4,2021-01-21,0,0,0,0,2021-01-21,1611183600.0
5264,7,4,2021-01-22,0,0,0,0,2021-01-22,1611270000.0
5265,7,4,2021-01-23,0,0,0,0,2021-01-23,1611356400.0
5266,7,4,2021-01-24,0,0,0,0,2021-01-24,1611442800.0
5267,7,4,2021-01-25,0,0,0,0,2021-01-25,1611529200.0
5268,7,4,2021-01-26,0,0,0,0,2021-01-26,1611615600.0
5269,7,4,2021-01-27,0,0,0,0,2021-01-27,1611702000.0
5270,7,4,2021-01-28,0,0,0,0,2021-01-28,1611788400.0
5271,7,4,2021-01-29,0,0,0,0,2021-01-29,1611874800.0
5272,7,4,2021-01-30,0,0,0,0,2021-01-30,1611961200.0
5273,7,4,2021-01-31,0,0,0,0,2021-01-31,1612047600.0
5274,7,4,2021-02-01,0,0,0,0,2021-02-01,1612134000.0
5275,7,4,2021-02-02,0,0,0,0,2021-02-02,1612220400.0
5276,7,4,2021-02-03,0,0,0,0,2021-02-03,1612306800.0
5277,7,4,2021-02-04,0,0,0,0,2021-02-04,1612393200.0
5278,7,4,2021-02-05,0,0,0,0,2021-02-05,1612479600.0
5279,7,4,2021-02-06,0,0,0,0,2021-02-06,1612566000.0
5280,7,4,2021-02-07,0,0,0,0,2021-02-07,1612652400.0
5281,7,4,2021-02-08,0,0,0,0,2021-02-08,1612738800.0
5282,7,4,2021-02-09,0,0,0,0,2021-02-09,1612825200.0
5283,7,4,2021-02-10,0,0,0,0,2021-02-10,1612911600.0
5284,7,4,2021-02-11,0,0,0,0,2021-02-11,1612998000.0
5285,7,4,2021-02-12,0,0,0,0,2021-02-12,1613084400.0
5286,7,4,2021-02-13,0,0,0,0,2021-02-13,1613170800.0
5287,7,4,2021-02-14,0,0,0,0,2021-02-14,1613257200.0
5288,7,4,2021-02-15,0,0,0,0,2021-02-15,1613343600.0
5289,7,4,2021-02-16,0,0,0,0,2021-02-16,1613430000.0
5290,7,4,2021-02-17,0,0,0,0,2021-02-17,1613516400.0
5291,7,4,2021-02-18,0,0,0,0,2021-02-18,1613602800.0
5292,7,4,2021-02-19,0,0,0,0,2021-02-19,1613689200.0
5293,7,4,2021-02-20,0,0,0,0,2021-02-20,1613775600.0
5294,7,4,2021-02-21,0,0,0,0,2021-02-21,1613862000.0
5295,7,4,2021-02-22,0,0,0,0,2021-02-22,1613948400.0
5296,7,4,2021-02-23,0,0,0,0,2021-02-23,1614034800.0
5297,7,4,2021-02-24,0,0,0,0,2021-02-24,1614121200.0
5298,7,4,2021-02-25,0,0,0,0,2021-02-25,1614207600.0
5299,7,4,2021-02-26,0,0,0,0,2021-02-26,1614294000.0
5300,7,4,2021-02-27,0,0,0,0,2021-02-27,1614380400.0
5301,7,4,2021-02-28,0,0,0,0,2021-02-28,1614466800.0
5302,7,4,2021-03-01,0,0,0,0,2021-03-01,1614553200.0
5303,7,4,2021-03-02,0,0,0,0,2021-03-02,1614639600.0
5304,7,4,2021-03-03,0,0,0,0,2021-03-03,1614726000.0
5305,7,4,2021-03-04,0,0,0,0,2021-03-04,1614812400.0
5306,7,4,2021-03-05,0,0,0,0,2021-03-05,1614898800.0
5307,7,4,2021-03-06,0,0,0,0,2021-03-06,1614985200.0
5308,7,4,2021-03-07,0,0,0,0,2021-03-07,1615071600.0
5309,7,4,2021-03-08,0,0,0,0,2021-03-08,1615158000.0
5310,7,4,2021-03-09,0,0,0,0,2021-03-09,1615244400.0
5311,7,4,2021-03-10,0,0,0,0,2021-03-10,1615330800.0
5312,7,4,2021-03-11,0,0,0,0,2021-03-11,1615417200.0
5313,7,4,2021-03-12,0,0,0,0,2021-03-12,1615503600.0
5314,7,4,2021-03-13,0,0,0,0,2021-03-13,1615590000.0
5315,7,4,2021-03-14,0,0,0,0,2021-03-14,1615676400.0
5316,7,4,2021-03-15,0,0,0,0,2021-03-15,1615762800.0
5317,7,4,2021-03-16,0,0,0,0,2021-03-16,1615849200.0
5318,7,4,2021-03-17,0,0,0,0,2021-03-17,1615935600.0
5319,7,4,2021-03-18,0,0,0,0,2021-03-18,1616022000.0
5320,7,4,2021-03-19,0,0,0,0,2021-03-19,1616108400.0
5321,7,4,2021-03-20,0,0,0,0,2021-03-20,1616194800.0
5322,7,4,2021-03-21,0,0,0,0,2021-03-21,1616281200.0
5323,7,4,2021-03-22,0,0,0,0,2021-03-22,1616367600.0
5324,7,4,2021-03-23,0,0,0,0,2021-03-23,1616454000.0
5325,7,4,2021-03-24,0,0,0,0,2021-03-24,1616540400.0
5326,7,4,2021-03-25,0,0,0,0,2021-03-25,1616626800.0
5327,7,4,2021-03-26,0,0,0,0,2021-03-26,1616713200.0
5328,7,4,2021-03-27,0,0,0,0,2021-03-27,1616799600.0
5329,7,4,2021-03-28,0,0,0,0,2021-03-28,1616886000.0
5330,7,4,2021-03-29,0,0,0,0,2021-03-29,1616972400.0
5331,7,4,2021-03-30,0,0,0,0,2021-03-30,1617058800.0
5332,7,4,2021-03-31,0,0,0,0,2021-03-31,1617145200.0
5333,7,4,2021-04-01,0,0,0,0,2021-04-01,1617231600.0
5334,7,4,2021-04-02,0,0,0,0,2021-04-02,1617318000.0
5335,7,4,2021-04-03,0,0,0,0,2021-04-03,1617404400.0
5336,7,4,2021-04-04,0,0,0,0,2021-04-04,1617490800.0
5337,7,4,2021-04-05,0,0,0,0,2021-04-05,1617577200.0
5338,7,4,2021-04-06,0,0,0,0,2021-04-06,1617663600.0
5339,7,4,2021-04-07,0,0,0,0,2021-04-07,1617750000.0
5340,7,4,2021-04-08,0,0,0,0,2021-04-08,1617836400.0
5341,7,4,2021-04-09,0,0,0,0,2021-04-09,1617922800.0
5342,7,4,2021-04-10,0,0,0,0,2021-04-10,1618009200.0
5343,7,4,2021-04-11,0,0,0,0,2021-04-11,1618095600.0
5344,7,4,2021-04-12,0,0,0,0,2021-04-12,1618185600.0
5345,7,4,2021-04-13,0,0,0,0,2021-04-13,1618272000.0
5346,7,4,2021-04-14,0,0,0,0,2021-04-14,1618358400.0
5347,7,4,2021-04-15,0,0,0,0,2021-04-15,1618444800.0
5348,7,4,2021-04-16,0,0,0,0,2021-04-16,1618531200.0
5349,7,4,2021-04-17,0,0,0,0,2021-04-17,1618617600.0
5350,7,4,2021-04-18,0,0,0,0,2021-04-18,1618704000.0
5351,7,4,2021-04-19,0,0,0,0,2021-04-19,1618790400.0
5352,7,4,2021-04-20,0,0,0,0,2021-04-20,1618876800.0
5353,7,4,2021-04-21,0,0,0,0,2021-04-21,1618963200.0
5354,7,4,2021-04-22,0,0,0,0,2021-04-22,1619049600.0
5355,7,4,2021-04-23,0,0,0,0,2021-04-23,1619136000.0
5356,7,4,2021-04-24,0,0,0,0,2021-04-24,1619222400.0
5357,7,4,2021-04-25,0,0,0,0,2021-04-25,1619308800.0
5358,7,4,2021-04-26,0,0,0,0,2021-04-26,1619395200.0
5359,7,4,2021-04-27,0,0,0,0,2021-04-27,1619481600.0
5360,7,4,2021-04-28,0,0,0,0,2021-04-28,1619568000.0
5361,7,4,2021-04-29,0,0,0,0,2021-04-29,1619654400.0
5362,7,4,2021-04-30,0,0,0,0,2021-04-30,1619740800.0
5363,7,4,2021-05-01,0,0,0,0,2021-05-01,1619827200.0
5364,7,4,2021-05-02,0,0,0,0,2021-05-02,1619913600.0
5365,7,4,2021-05-03,0,0,0,0,2021-05-03,1620000000.0
5366,7,4,2021-05-04,0,0,0,0,2021-05-04,1620086400.0
5367,7,4,2021-05-05,0,0,0,0,2021-05-05,1620172800.0
5368,7,4,2021-05-06,0,0,0,0,2021-05-06,1620259200.0
5369,7,4,2021-05-07,0,0,0,0,2021-05-07,1620345600.0
5370,7,4,2021-05-08,0,0,0,0,2021-05-08,1620432000.0
5371,7,4,2021-05-09,0,0,0,0,2021-05-09,1620518400.0
5372,7,4,2021-05-10,0,0,0,0,2021-05-10,1620604800.0
5373,7,4,2021-05-11,0,0,0,0,2021-05-11,1620691200.0
5374,7,4,2021-05-12,0,0,0,0,2021-05-12,1620777600.0
5375,7,4,2021-05-13,0,0,0,0,2021-05-13,1620864000.0
5376,7,4,2021-05-14,0,0,0,0,2021-05-14,1620950400.0
5377,7,4,2021-05-15,0,0,0,0,2021-05-15,1621036800.0
5378,7,4,2021-05-16,0,0,0,0,2021-05-16,1621123200.0
5379,7,4,2021-05-17,0,0,0,0,2021-05-17,1621206000.0
5380,7,4,2021-05-18,0,0,0,0,2021-05-18,1621292400.0
5381,7,4,2021-05-19,0,0,0,0,2021-05-19,1621378800.0
5382,7,4,2021-05-20,0,0,0,0,2021-05-20,1621465200.0
5383,7,4,2021-05-21,0,0,0,0,2021-05-21,1621551600.0
5384,7,4,2021-05-22,0,0,0,0,2021-05-22,1621638000.0
5385,7,4,2021-05-23,0,0,0,0,2021-05-23,1621724400.0
5386,7,4,2021-05-24,0,0,0,0,2021-05-24,1621810800.0
5387,7,4,2021-05-25,0,0,0,0,2021-05-25,1621897200.0
5388,7,4,2021-05-26,0,0,0,0,2021-05-26,1621983600.0
5389,7,4,2021-05-27,0,0,0,0,2021-05-27,1622070000.0
5390,7,4,2021-05-28,0,0,0,0,2021-05-28,1622156400.0
5391,7,4,2021-05-29,0,0,0,0,2021-05-29,1622242800.0
5392,7,4,2021-05-30,0,0,0,0,2021-05-30,1622329200.0
5393,7,4,2021-05-31,0,0,0,0,2021-05-31,1622415600.0
5394,7,4,2021-06-01,0,0,0,0,2021-06-01,1622502000.0
5395,7,4,2021-06-02,0,0,0,0,2021-06-02,1622588400.0
5396,7,4,2021-06-03,0,0,0,0,2021-06-03,1622674800.0
5397,7,4,2021-06-04,0,0,0,0,2021-06-04,1622761200.0
5398,7,4,2021-06-05,0,0,0,0,2021-06-05,1622847600.0
5399,7,4,2021-06-06,0,0,0,0,2021-06-06,1622934000.0
5400,7,4,2021-06-07,0,0,0,0,2021-06-07,1623020400.0
5401,7,4,2021-06-08,0,0,0,0,2021-06-08,1623106800.0
5402,7,4,2021-06-09,0,0,0,0,2021-06-09,1623193200.0
5403,7,4,2021-06-10,0,0,0,0,2021-06-10,1623279600.0
5404,7,4,2021-06-11,0,0,0,0,2021-06-11,1623366000.0
5405,7,4,2021-06-12,0,0,0,0,2021-06-12,1623452400.0
5406,7,4,2021-06-13,0,0,0,0,2021-06-13,1623538800.0
5407,7,4,2021-06-14,0,0,0,0,2021-06-14,1623625200.0
5408,7,4,2021-06-15,0,0,0,0,2021-06-15,1623711600.0
5409,7,4,2021-06-16,0,0,0,0,2021-06-16,1623798000.0
5410,7,4,2021-06-17,0,0,0,0,2021-06-17,1623884400.0
5411,7,4,2021-06-18,0,0,0,0,2021-06-18,1623970800.0
5412,7,4,2021-06-19,0,0,0,0,2021-06-19,1624057200.0
5413,7,4,2021-06-20,0,0,0,0,2021-06-20,1624143600.0
5414,7,4,2021-06-21,0,0,0,0,2021-06-21,1624230000.0
5415,7,4,2021-06-22,0,0,0,0,2021-06-22,1624316400.0
5416,7,4,2021-06-23,0,0,0,0,2021-06-23,1624402800.0
5417,7,4,2021-06-24,0,0,0,0,2021-06-24,1624489200.0
5418,7,4,2021-06-25,0,0,0,0,2021-06-25,1624575600.0
5419,7,4,2021-06-26,0,0,0,0,2021-06-26,1624662000.0
5420,7,4,2021-06-27,0,0,0,0,2021-06-27,1624748400.0
5421,7,4,2021-06-28,0,0,0,0,2021-06-28,1624834800.0
5422,7,4,2021-06-29,0,0,0,0,2021-06-29,1624921200.0
5423,7,4,2021-06-30,0,0,0,0,2021-06-30,1625007600.0
5424,7,4,2021-07-01,0,0,0,0,2021-07-01,1625094000.0
5425,7,4,2021-07-02,0,0,0,0,2021-07-02,1625180400.0
5426,7,4,2021-07-03,0,0,0,0,2021-07-03,1625266800.0
5427,7,4,2021-07-04,0,0,0,0,2021-07-04,1625353200.0
5428,7,4,2021-07-05,0,0,0,0,2021-07-05,1625439600.0
5429,7,4,2021-07-06,0,0,0,0,2021-07-06,1625526000.0
5430,7,4,2021-07-07,0,0,0,0,2021-07-07,1625612400.0
5431,7,4,2021-07-08,0,0,0,0,2021-07-08,1625698800.0
5432,8,1,2020-12-27,0,0,0,0,2020-12-27,1609023600.0
5433,8,1,2020-12-28,0,0,0,0,2020-12-28,1609110000.0
5434,8,1,2020-12-29,0,0,0,0,2020-12-29,1609196400.0
5435,8,1,2020-12-30,0,0,0,0,2020-12-30,1609282800.0
5436,8,1,2020-12-31,0,0,0,0,2020-12-31,1609369200.0
5437,8,1,2021-01-01,0,0,0,0,2021-01-01,1609455600.0
5438,8,1,2021-01-02,0,0,0,0,2021-01-02,1609542000.0
5439,8,1,2021-01-03,0,0,0,0,2021-01-03,1609628400.0
5440,8,1,2021-01-04,0,0,0,0,2021-01-04,1609714800.0
5441,8,1,2021-01-05,0,0,0,0,2021-01-05,1609801200.0
5442,8,1,2021-01-06,0,0,0,0,2021-01-06,1609887600.0
5443,8,1,2021-01-07,0,0,0,0,2021-01-07,1609974000.0
5444,8,1,2021-01-08,0,0,0,0,2021-01-08,1610060400.0
5445,8,1,2021-01-09,0,0,0,0,2021-01-09,1610146800.0
5446,8,1,2021-01-10,0,0,0,0,2021-01-10,1610233200.0
5447,8,1,2021-01-11,0,0,0,0,2021-01-11,1610319600.0
5448,8,1,2021-01-12,0,0,0,0,2021-01-12,1610406000.0
5449,8,1,2021-01-13,10,0,10,0,2021-01-13,1610492400.0
5450,8,1,2021-01-14,12,0,22,0,2021-01-14,1610578800.0
5451,8,1,2021-01-15,9,0,31,0,2021-01-15,1610665200.0
5452,8,1,2021-01-16,0,0,31,0,2021-01-16,1610751600.0
5453,8,1,2021-01-17,0,0,31,0,2021-01-17,1610838000.0
5454,8,1,2021-01-18,0,0,31,0,2021-01-18,1610924400.0
5455,8,1,2021-01-19,12,0,43,0,2021-01-19,1611010800.0
5456,8,1,2021-01-20,12,0,55,0,2021-01-20,1611097200.0
5457,8,1,2021-01-21,6,0,61,0,2021-01-21,1611183600.0
5458,8,1,2021-01-22,0,0,61,0,2021-01-22,1611270000.0
5459,8,1,2021-01-23,0,0,61,0,2021-01-23,1611356400.0
5460,8,1,2021-01-24,0,0,61,0,2021-01-24,1611442800.0
5461,8,1,2021-01-25,0,0,61,0,2021-01-25,1611529200.0
5462,8,1,2021-01-26,9,0,70,0,2021-01-26,1611615600.0
5463,8,1,2021-01-27,10,0,80,0,2021-01-27,1611702000.0
5464,8,1,2021-01-28,6,0,86,0,2021-01-28,1611788400.0
5465,8,1,2021-01-29,0,0,86,0,2021-01-29,1611874800.0
5466,8,1,2021-01-30,0,0,86,0,2021-01-30,1611961200.0
5467,8,1,2021-01-31,0,0,86,0,2021-01-31,1612047600.0
5468,8,1,2021-02-01,0,0,86,0,2021-02-01,1612134000.0
5469,8,1,2021-02-02,38,0,124,0,2021-02-02,1612220400.0
5470,8,1,2021-02-03,10,0,134,0,2021-02-03,1612306800.0
5471,8,1,2021-02-04,29,1,163,1,2021-02-04,1612393200.0
5472,8,1,2021-02-05,6,0,169,1,2021-02-05,1612479600.0
5473,8,1,2021-02-06,0,0,169,1,2021-02-06,1612566000.0
5474,8,1,2021-02-07,0,0,169,1,2021-02-07,1612652400.0
5475,8,1,2021-02-08,0,0,169,1,2021-02-08,1612738800.0
5476,8,1,2021-02-09,38,0,207,1,2021-02-09,1612825200.0
5477,8,1,2021-02-10,27,0,234,1,2021-02-10,1612911600.0
5478,8,1,2021-02-11,0,0,234,1,2021-02-11,1612998000.0
5479,8,1,2021-02-12,36,0,270,1,2021-02-12,1613084400.0
5480,8,1,2021-02-13,0,0,270,1,2021-02-13,1613170800.0
5481,8,1,2021-02-14,0,0,270,1,2021-02-14,1613257200.0
5482,8,1,2021-02-15,50,0,320,1,2021-02-15,1613343600.0
5483,8,1,2021-02-16,0,0,320,1,2021-02-16,1613430000.0
5484,8,1,2021-02-17,0,0,320,1,2021-02-17,1613516400.0
5485,8,1,2021-02-18,27,0,347,1,2021-02-18,1613602800.0
5486,8,1,2021-02-19,44,0,391,1,2021-02-19,1613689200.0
5487,8,1,2021-02-20,0,0,391,1,2021-02-20,1613775600.0
5488,8,1,2021-02-21,0,0,391,1,2021-02-21,1613862000.0
5489,8,1,2021-02-22,45,2,436,3,2021-02-22,1613948400.0
5490,8,1,2021-02-23,41,29,477,32,2021-02-23,1614034800.0
5491,8,1,2021-02-24,35,1,512,33,2021-02-24,1614121200.0
5492,8,1,2021-02-25,55,35,567,68,2021-02-25,1614207600.0
5493,8,1,2021-02-26,39,2,606,70,2021-02-26,1614294000.0
5494,8,1,2021-02-27,0,0,606,70,2021-02-27,1614380400.0
5495,8,1,2021-02-28,0,0,606,70,2021-02-28,1614466800.0
5496,8,1,2021-03-01,48,5,654,75,2021-03-01,1614553200.0
5497,8,1,2021-03-02,6,27,660,102,2021-03-02,1614639600.0
5498,8,1,2021-03-03,38,27,698,129,2021-03-03,1614726000.0
5499,8,1,2021-03-04,30,26,728,155,2021-03-04,1614812400.0
5500,8,1,2021-03-05,46,9,774,164,2021-03-05,1614898800.0
5501,8,1,2021-03-06,0,0,774,164,2021-03-06,1614985200.0
5502,8,1,2021-03-07,0,0,774,164,2021-03-07,1615071600.0
5503,8,1,2021-03-08,30,7,804,171,2021-03-08,1615158000.0
5504,8,1,2021-03-09,19,27,823,198,2021-03-09,1615244400.0
5505,8,1,2021-03-10,22,27,845,225,2021-03-10,1615330800.0
5506,8,1,2021-03-11,0,0,845,225,2021-03-11,1615417200.0
5507,8,1,2021-03-12,51,21,896,246,2021-03-12,1615503600.0
5508,8,1,2021-03-13,0,0,896,246,2021-03-13,1615590000.0
5509,8,1,2021-03-14,0,0,896,246,2021-03-14,1615676400.0
5510,8,1,2021-03-15,31,42,927,288,2021-03-15,1615762800.0
5511,8,1,2021-03-16,73,3,1000,291,2021-03-16,1615849200.0
5512,8,1,2021-03-17,67,13,1067,304,2021-03-17,1615935600.0
5513,8,1,2021-03-18,82,39,1149,343,2021-03-18,1616022000.0
5514,8,1,2021-03-19,30,46,1179,389,2021-03-19,1616108400.0
5515,8,1,2021-03-20,0,0,1179,389,2021-03-20,1616194800.0
5516,8,1,2021-03-21,0,0,1179,389,2021-03-21,1616281200.0
5517,8,1,2021-03-22,33,45,1212,434,2021-03-22,1616367600.0
5518,8,1,2021-03-23,30,43,1242,477,2021-03-23,1616454000.0
5519,8,1,2021-03-24,38,42,1280,519,2021-03-24,1616540400.0
5520,8,1,2021-03-25,66,31,1346,550,2021-03-25,1616626800.0
5521,8,1,2021-03-26,44,32,1390,582,2021-03-26,1616713200.0
5522,8,1,2021-03-27,0,0,1390,582,2021-03-27,1616799600.0
5523,8,1,2021-03-28,0,0,1390,582,2021-03-28,1616886000.0
5524,8,1,2021-03-29,61,47,1451,629,2021-03-29,1616972400.0
5525,8,1,2021-03-30,93,19,1544,648,2021-03-30,1617058800.0
5526,8,1,2021-03-31,73,44,1617,692,2021-03-31,1617145200.0
5527,8,1,2021-04-01,56,45,1673,737,2021-04-01,1617231600.0
5528,8,1,2021-04-02,0,0,1673,737,2021-04-02,1617318000.0
5529,8,1,2021-04-03,0,0,1673,737,2021-04-03,1617404400.0
5530,8,1,2021-04-04,0,0,1673,737,2021-04-04,1617490800.0
5531,8,1,2021-04-05,0,0,1673,737,2021-04-05,1617577200.0
5532,8,1,2021-04-06,49,61,1722,798,2021-04-06,1617663600.0
5533,8,1,2021-04-07,91,28,1813,826,2021-04-07,1617750000.0
5534,8,1,2021-04-08,119,3,1932,829,2021-04-08,1617836400.0
5535,8,1,2021-04-09,89,27,2021,856,2021-04-09,1617922800.0
5536,8,1,2021-04-10,0,0,2021,856,2021-04-10,1618009200.0
5537,8,1,2021-04-11,0,0,2021,856,2021-04-11,1618095600.0
5538,8,1,2021-04-12,41,72,2062,928,2021-04-12,1618185600.0
5539,8,1,2021-04-13,46,71,2108,999,2021-04-13,1618272000.0
5540,8,1,2021-04-14,73,43,2181,1042,2021-04-14,1618358400.0
5541,8,1,2021-04-15,89,20,2270,1062,2021-04-15,1618444800.0
5542,8,1,2021-04-16,75,38,2345,1100,2021-04-16,1618531200.0
5543,8,1,2021-04-17,0,0,2345,1100,2021-04-17,1618617600.0
5544,8,1,2021-04-18,0,0,2345,1100,2021-04-18,1618704000.0
5545,8,1,2021-04-19,48,64,2393,1164,2021-04-19,1618790400.0
5546,8,1,2021-04-20,81,27,2474,1191,2021-04-20,1618876800.0
5547,8,1,2021-04-21,91,24,2565,1215,2021-04-21,1618963200.0
5548,8,1,2021-04-22,100,18,2665,1233,2021-04-22,1619049600.0
5549,8,1,2021-04-23,44,65,2709,1298,2021-04-23,1619136000.0
5550,8,1,2021-04-24,0,0,2709,1298,2021-04-24,1619222400.0
5551,8,1,2021-04-25,0,0,2709,1298,2021-04-25,1619308800.0
5552,8,1,2021-04-26,27,88,2736,1386,2021-04-26,1619395200.0
5553,8,1,2021-04-27,59,61,2795,1447,2021-04-27,1619481600.0
5554,8,1,2021-04-28,88,34,2883,1481,2021-04-28,1619568000.0
5555,8,1,2021-04-29,89,30,2972,1511,2021-04-29,1619654400.0
5556,8,1,2021-04-30,104,9,3076,1520,2021-04-30,1619740800.0
5557,8,1,2021-05-01,0,0,3076,1520,2021-05-01,1619827200.0
5558,8,1,2021-05-02,0,0,3076,1520,2021-05-02,1619913600.0
5559,8,1,2021-05-03,24,92,3100,1612,2021-05-03,1620000000.0
5560,8,1,2021-05-04,158,93,3258,1705,2021-05-04,1620086400.0
5561,8,1,2021-05-05,140,49,3398,1754,2021-05-05,1620172800.0
5562,8,1,2021-05-06,200,30,3598,1784,2021-05-06,1620259200.0
5563,8,1,2021-05-07,127,64,3725,1848,2021-05-07,1620345600.0
5564,8,1,2021-05-08,58,0,3783,1848,2021-05-08,1620432000.0
5565,8,1,2021-05-09,0,0,3783,1848,2021-05-09,1620518400.0
5566,8,1,2021-05-10,124,92,3907,1940,2021-05-10,1620604800.0
5567,8,1,2021-05-11,132,73,4039,2013,2021-05-11,1620691200.0
5568,8,1,2021-05-12,156,56,4195,2069,2021-05-12,1620777600.0
5569,8,1,2021-05-13,83,0,4278,2069,2021-05-13,1620864000.0
5570,8,1,2021-05-14,129,49,4407,2118,2021-05-14,1620950400.0
5571,8,1,2021-05-15,86,2,4493,2120,2021-05-15,1621036800.0
5572,8,1,2021-05-16,0,0,4493,2120,2021-05-16,1621123200.0
5573,8,1,2021-05-17,146,100,4639,2220,2021-05-17,1621206000.0
5574,8,1,2021-05-18,151,83,4790,2303,2021-05-18,1621292400.0
5575,8,1,2021-05-19,84,52,4874,2355,2021-05-19,1621378800.0
5576,8,1,2021-05-20,104,19,4978,2374,2021-05-20,1621465200.0
5577,8,1,2021-05-21,95,36,5073,2410,2021-05-21,1621551600.0
5578,8,1,2021-05-22,100,0,5173,2410,2021-05-22,1621638000.0
5579,8,1,2021-05-23,0,0,5173,2410,2021-05-23,1621724400.0
5580,8,1,2021-05-24,33,0,5206,2410,2021-05-24,1621810800.0
5581,8,1,2021-05-25,119,66,5325,2476,2021-05-25,1621897200.0
5582,8,1,2021-05-26,110,33,5435,2509,2021-05-26,1621983600.0
5583,8,1,2021-05-27,111,25,5546,2534,2021-05-27,1622070000.0
5584,8,1,2021-05-28,33,1,5579,2535,2021-05-28,1622156400.0
5585,8,1,2021-05-29,58,5,5637,2540,2021-05-29,1622242800.0
5586,8,1,2021-05-30,0,0,5637,2540,2021-05-30,1622329200.0
5587,8,1,2021-05-31,109,55,5746,2595,2021-05-31,1622415600.0
5588,8,1,2021-06-01,112,50,5858,2645,2021-06-01,1622502000.0
5589,8,1,2021-06-02,131,24,5989,2669,2021-06-02,1622588400.0
5590,8,1,2021-06-03,101,28,6090,2697,2021-06-03,1622674800.0
5591,8,1,2021-06-04,127,59,6217,2756,2021-06-04,1622761200.0
5592,8,1,2021-06-05,82,10,6299,2766,2021-06-05,1622847600.0
5593,8,1,2021-06-06,0,0,6299,2766,2021-06-06,1622934000.0
5594,8,1,2021-06-07,96,86,6395,2852,2021-06-07,1623020400.0
5595,8,1,2021-06-08,70,80,6465,2932,2021-06-08,1623106800.0
5596,8,1,2021-06-09,97,65,6562,2997,2021-06-09,1623193200.0
5597,8,1,2021-06-10,111,43,6673,3040,2021-06-10,1623279600.0
5598,8,1,2021-06-11,110,84,6783,3124,2021-06-11,1623366000.0
5599,8,1,2021-06-12,57,23,6840,3147,2021-06-12,1623452400.0
5600,8,1,2021-06-13,0,0,6840,3147,2021-06-13,1623538800.0
5601,8,1,2021-06-14,106,107,6946,3254,2021-06-14,1623625200.0
5602,8,1,2021-06-15,86,108,7032,3362,2021-06-15,1623711600.0
5603,8,1,2021-06-16,103,139,7135,3501,2021-06-16,1623798000.0
5604,8,1,2021-06-17,84,62,7219,3563,2021-06-17,1623884400.0
5605,8,1,2021-06-18,66,92,7285,3655,2021-06-18,1623970800.0
5606,8,1,2021-06-19,62,69,7347,3724,2021-06-19,1624057200.0
5607,8,1,2021-06-20,0,0,7347,3724,2021-06-20,1624143600.0
5608,8,1,2021-06-21,73,138,7420,3862,2021-06-21,1624230000.0
5609,8,1,2021-06-22,70,94,7490,3956,2021-06-22,1624316400.0
5610,8,1,2021-06-23,68,108,7558,4064,2021-06-23,1624402800.0
5611,8,1,2021-06-24,42,69,7600,4133,2021-06-24,1624489200.0
5612,8,1,2021-06-25,63,88,7663,4221,2021-06-25,1624575600.0
5613,8,1,2021-06-26,35,58,7698,4279,2021-06-26,1624662000.0
5614,8,1,2021-06-27,0,0,7698,4279,2021-06-27,1624748400.0
5615,8,1,2021-06-28,70,125,7768,4404,2021-06-28,1624834800.0
5616,8,1,2021-06-29,55,91,7823,4495,2021-06-29,1624921200.0
5617,8,1,2021-06-30,56,105,7879,4600,2021-06-30,1625007600.0
5618,8,1,2021-07-01,41,80,7920,4680,2021-07-01,1625094000.0
5619,8,1,2021-07-02,52,89,7972,4769,2021-07-02,1625180400.0
5620,8,1,2021-07-03,40,86,8012,4855,2021-07-03,1625266800.0
5621,8,1,2021-07-04,0,0,8012,4855,2021-07-04,1625353200.0
5622,8,1,2021-07-05,66,90,8078,4945,2021-07-05,1625439600.0
5623,8,1,2021-07-06,55,71,8133,5016,2021-07-06,1625526000.0
5624,8,1,2021-07-07,51,117,8184,5133,2021-07-07,1625612400.0
5625,8,1,2021-07-08,42,104,8226,5237,2021-07-08,1625698800.0
5626,8,2,2020-12-27,0,0,0,0,2020-12-27,1609023600.0
5627,8,2,2020-12-28,0,0,0,0,2020-12-28,1609110000.0
5628,8,2,2020-12-29,0,0,0,0,2020-12-29,1609196400.0
5629,8,2,2020-12-30,0,0,0,0,2020-12-30,1609282800.0
5630,8,2,2020-12-31,0,0,0,0,2020-12-31,1609369200.0
5631,8,2,2021-01-01,0,0,0,0,2021-01-01,1609455600.0
5632,8,2,2021-01-02,0,0,0,0,2021-01-02,1609542000.0
5633,8,2,2021-01-03,0,0,0,0,2021-01-03,1609628400.0
5634,8,2,2021-01-04,0,0,0,0,2021-01-04,1609714800.0
5635,8,2,2021-01-05,0,0,0,0,2021-01-05,1609801200.0
5636,8,2,2021-01-06,0,0,0,0,2021-01-06,1609887600.0
5637,8,2,2021-01-07,0,0,0,0,2021-01-07,1609974000.0
5638,8,2,2021-01-08,0,0,0,0,2021-01-08,1610060400.0
5639,8,2,2021-01-09,0,0,0,0,2021-01-09,1610146800.0
5640,8,2,2021-01-10,0,0,0,0,2021-01-10,1610233200.0
5641,8,2,2021-01-11,0,0,0,0,2021-01-11,1610319600.0
5642,8,2,2021-01-12,0,0,0,0,2021-01-12,1610406000.0
5643,8,2,2021-01-13,0,0,0,0,2021-01-13,1610492400.0
5644,8,2,2021-01-14,0,0,0,0,2021-01-14,1610578800.0
5645,8,2,2021-01-15,0,0,0,0,2021-01-15,1610665200.0
5646,8,2,2021-01-16,0,0,0,0,2021-01-16,1610751600.0
5647,8,2,2021-01-17,0,0,0,0,2021-01-17,1610838000.0
5648,8,2,2021-01-18,0,0,0,0,2021-01-18,1610924400.0
5649,8,2,2021-01-19,0,0,0,0,2021-01-19,1611010800.0
5650,8,2,2021-01-20,0,0,0,0,2021-01-20,1611097200.0
5651,8,2,2021-01-21,0,0,0,0,2021-01-21,1611183600.0
5652,8,2,2021-01-22,0,0,0,0,2021-01-22,1611270000.0
5653,8,2,2021-01-23,0,0,0,0,2021-01-23,1611356400.0
5654,8,2,2021-01-24,0,0,0,0,2021-01-24,1611442800.0
5655,8,2,2021-01-25,0,0,0,0,2021-01-25,1611529200.0
5656,8,2,2021-01-26,0,0,0,0,2021-01-26,1611615600.0
5657,8,2,2021-01-27,0,0,0,0,2021-01-27,1611702000.0
5658,8,2,2021-01-28,0,0,0,0,2021-01-28,1611788400.0
5659,8,2,2021-01-29,0,0,0,0,2021-01-29,1611874800.0
5660,8,2,2021-01-30,0,0,0,0,2021-01-30,1611961200.0
5661,8,2,2021-01-31,0,0,0,0,2021-01-31,1612047600.0
5662,8,2,2021-02-01,0,0,0,0,2021-02-01,1612134000.0
5663,8,2,2021-02-02,0,0,0,0,2021-02-02,1612220400.0
5664,8,2,2021-02-03,0,0,0,0,2021-02-03,1612306800.0
5665,8,2,2021-02-04,0,0,0,0,2021-02-04,1612393200.0
5666,8,2,2021-02-05,0,0,0,0,2021-02-05,1612479600.0
5667,8,2,2021-02-06,0,0,0,0,2021-02-06,1612566000.0
5668,8,2,2021-02-07,0,0,0,0,2021-02-07,1612652400.0
5669,8,2,2021-02-08,0,0,0,0,2021-02-08,1612738800.0
5670,8,2,2021-02-09,0,0,0,0,2021-02-09,1612825200.0
5671,8,2,2021-02-10,0,0,0,0,2021-02-10,1612911600.0
5672,8,2,2021-02-11,0,0,0,0,2021-02-11,1612998000.0
5673,8,2,2021-02-12,0,0,0,0,2021-02-12,1613084400.0
5674,8,2,2021-02-13,0,0,0,0,2021-02-13,1613170800.0
5675,8,2,2021-02-14,0,0,0,0,2021-02-14,1613257200.0
5676,8,2,2021-02-15,0,0,0,0,2021-02-15,1613343600.0
5677,8,2,2021-02-16,0,0,0,0,2021-02-16,1613430000.0
5678,8,2,2021-02-17,0,0,0,0,2021-02-17,1613516400.0
5679,8,2,2021-02-18,0,0,0,0,2021-02-18,1613602800.0
5680,8,2,2021-02-19,0,0,0,0,2021-02-19,1613689200.0
5681,8,2,2021-02-20,0,0,0,0,2021-02-20,1613775600.0
5682,8,2,2021-02-21,0,0,0,0,2021-02-21,1613862000.0
5683,8,2,2021-02-22,0,0,0,0,2021-02-22,1613948400.0
5684,8,2,2021-02-23,0,0,0,0,2021-02-23,1614034800.0
5685,8,2,2021-02-24,0,0,0,0,2021-02-24,1614121200.0
5686,8,2,2021-02-25,0,0,0,0,2021-02-25,1614207600.0
5687,8,2,2021-02-26,0,0,0,0,2021-02-26,1614294000.0
5688,8,2,2021-02-27,0,0,0,0,2021-02-27,1614380400.0
5689,8,2,2021-02-28,0,0,0,0,2021-02-28,1614466800.0
5690,8,2,2021-03-01,0,0,0,0,2021-03-01,1614553200.0
5691,8,2,2021-03-02,0,0,0,0,2021-03-02,1614639600.0
5692,8,2,2021-03-03,0,0,0,0,2021-03-03,1614726000.0
5693,8,2,2021-03-04,0,0,0,0,2021-03-04,1614812400.0
5694,8,2,2021-03-05,0,0,0,0,2021-03-05,1614898800.0
5695,8,2,2021-03-06,0,0,0,0,2021-03-06,1614985200.0
5696,8,2,2021-03-07,0,0,0,0,2021-03-07,1615071600.0
5697,8,2,2021-03-08,0,0,0,0,2021-03-08,1615158000.0
5698,8,2,2021-03-09,0,0,0,0,2021-03-09,1615244400.0
5699,8,2,2021-03-10,0,0,0,0,2021-03-10,1615330800.0
5700,8,2,2021-03-11,0,0,0,0,2021-03-11,1615417200.0
5701,8,2,2021-03-12,0,0,0,0,2021-03-12,1615503600.0
5702,8,2,2021-03-13,0,0,0,0,2021-03-13,1615590000.0
5703,8,2,2021-03-14,0,0,0,0,2021-03-14,1615676400.0
5704,8,2,2021-03-15,0,0,0,0,2021-03-15,1615762800.0
5705,8,2,2021-03-16,0,0,0,0,2021-03-16,1615849200.0
5706,8,2,2021-03-17,0,0,0,0,2021-03-17,1615935600.0
5707,8,2,2021-03-18,0,0,0,0,2021-03-18,1616022000.0
5708,8,2,2021-03-19,0,0,0,0,2021-03-19,1616108400.0
5709,8,2,2021-03-20,0,0,0,0,2021-03-20,1616194800.0
5710,8,2,2021-03-21,0,0,0,0,2021-03-21,1616281200.0
5711,8,2,2021-03-22,1,0,1,0,2021-03-22,1616367600.0
5712,8,2,2021-03-23,0,0,1,0,2021-03-23,1616454000.0
5713,8,2,2021-03-24,0,0,1,0,2021-03-24,1616540400.0
5714,8,2,2021-03-25,0,0,1,0,2021-03-25,1616626800.0
5715,8,2,2021-03-26,0,0,1,0,2021-03-26,1616713200.0
5716,8,2,2021-03-27,87,0,88,0,2021-03-27,1616799600.0
5717,8,2,2021-03-28,0,0,88,0,2021-03-28,1616886000.0
5718,8,2,2021-03-29,0,0,88,0,2021-03-29,1616972400.0
5719,8,2,2021-03-30,0,0,88,0,2021-03-30,1617058800.0
5720,8,2,2021-03-31,0,0,88,0,2021-03-31,1617145200.0
5721,8,2,2021-04-01,0,0,88,0,2021-04-01,1617231600.0
5722,8,2,2021-04-02,0,0,88,0,2021-04-02,1617318000.0
5723,8,2,2021-04-03,0,0,88,0,2021-04-03,1617404400.0
5724,8,2,2021-04-04,0,0,88,0,2021-04-04,1617490800.0
5725,8,2,2021-04-05,0,0,88,0,2021-04-05,1617577200.0
5726,8,2,2021-04-06,0,0,88,0,2021-04-06,1617663600.0
5727,8,2,2021-04-07,0,0,88,0,2021-04-07,1617750000.0
5728,8,2,2021-04-08,1,0,89,0,2021-04-08,1617836400.0
5729,8,2,2021-04-09,0,0,89,0,2021-04-09,1617922800.0
5730,8,2,2021-04-10,164,1,253,1,2021-04-10,1618009200.0
5731,8,2,2021-04-11,0,0,253,1,2021-04-11,1618095600.0
5732,8,2,2021-04-12,0,0,253,1,2021-04-12,1618185600.0
5733,8,2,2021-04-13,0,0,253,1,2021-04-13,1618272000.0
5734,8,2,2021-04-14,1,0,254,1,2021-04-14,1618358400.0
5735,8,2,2021-04-15,0,0,254,1,2021-04-15,1618444800.0
5736,8,2,2021-04-16,0,0,254,1,2021-04-16,1618531200.0
5737,8,2,2021-04-17,165,0,419,1,2021-04-17,1618617600.0
5738,8,2,2021-04-18,0,0,419,1,2021-04-18,1618704000.0
5739,8,2,2021-04-19,0,0,419,1,2021-04-19,1618790400.0
5740,8,2,2021-04-20,0,0,419,1,2021-04-20,1618876800.0
5741,8,2,2021-04-21,0,0,419,1,2021-04-21,1618963200.0
5742,8,2,2021-04-22,0,0,419,1,2021-04-22,1619049600.0
5743,8,2,2021-04-23,0,0,419,1,2021-04-23,1619136000.0
5744,8,2,2021-04-24,99,72,518,73,2021-04-24,1619222400.0
5745,8,2,2021-04-25,0,0,518,73,2021-04-25,1619308800.0
5746,8,2,2021-04-26,1,0,519,73,2021-04-26,1619395200.0
5747,8,2,2021-04-27,0,0,519,73,2021-04-27,1619481600.0
5748,8,2,2021-04-28,0,0,519,73,2021-04-28,1619568000.0
5749,8,2,2021-04-29,0,0,519,73,2021-04-29,1619654400.0
5750,8,2,2021-04-30,0,0,519,73,2021-04-30,1619740800.0
5751,8,2,2021-05-01,0,0,519,73,2021-05-01,1619827200.0
5752,8,2,2021-05-02,0,0,519,73,2021-05-02,1619913600.0
5753,8,2,2021-05-03,0,0,519,73,2021-05-03,1620000000.0
5754,8,2,2021-05-04,0,0,519,73,2021-05-04,1620086400.0
5755,8,2,2021-05-05,1,0,520,73,2021-05-05,1620172800.0
5756,8,2,2021-05-06,0,0,520,73,2021-05-06,1620259200.0
5757,8,2,2021-05-07,0,0,520,73,2021-05-07,1620345600.0
5758,8,2,2021-05-08,11,120,531,193,2021-05-08,1620432000.0
5759,8,2,2021-05-09,0,0,531,193,2021-05-09,1620518400.0
5760,8,2,2021-05-10,0,0,531,193,2021-05-10,1620604800.0
5761,8,2,2021-05-11,0,0,531,193,2021-05-11,1620691200.0
5762,8,2,2021-05-12,0,2,531,195,2021-05-12,1620777600.0
5763,8,2,2021-05-13,0,0,531,195,2021-05-13,1620864000.0
5764,8,2,2021-05-14,0,0,531,195,2021-05-14,1620950400.0
5765,8,2,2021-05-15,0,0,531,195,2021-05-15,1621036800.0
5766,8,2,2021-05-16,0,0,531,195,2021-05-16,1621123200.0
5767,8,2,2021-05-17,0,0,531,195,2021-05-17,1621206000.0
5768,8,2,2021-05-18,0,0,531,195,2021-05-18,1621292400.0
5769,8,2,2021-05-19,0,16,531,211,2021-05-19,1621378800.0
5770,8,2,2021-05-20,0,0,531,211,2021-05-20,1621465200.0
5771,8,2,2021-05-21,0,0,531,211,2021-05-21,1621551600.0
5772,8,2,2021-05-22,0,0,531,211,2021-05-22,1621638000.0
5773,8,2,2021-05-23,0,0,531,211,2021-05-23,1621724400.0
5774,8,2,2021-05-24,0,0,531,211,2021-05-24,1621810800.0
5775,8,2,2021-05-25,0,0,531,211,2021-05-25,1621897200.0
5776,8,2,2021-05-26,0,0,531,211,2021-05-26,1621983600.0
5777,8,2,2021-05-27,0,10,531,221,2021-05-27,1622070000.0
5778,8,2,2021-05-28,0,0,531,221,2021-05-28,1622156400.0
5779,8,2,2021-05-29,1,206,532,427,2021-05-29,1622242800.0
5780,8,2,2021-05-30,0,0,532,427,2021-05-30,1622329200.0
5781,8,2,2021-05-31,0,0,532,427,2021-05-31,1622415600.0
5782,8,2,2021-06-01,0,0,532,427,2021-06-01,1622502000.0
5783,8,2,2021-06-02,0,0,532,427,2021-06-02,1622588400.0
5784,8,2,2021-06-03,0,0,532,427,2021-06-03,1622674800.0
5785,8,2,2021-06-04,0,0,532,427,2021-06-04,1622761200.0
5786,8,2,2021-06-05,0,7,532,434,2021-06-05,1622847600.0
5787,8,2,2021-06-06,0,0,532,434,2021-06-06,1622934000.0
5788,8,2,2021-06-07,0,0,532,434,2021-06-07,1623020400.0
5789,8,2,2021-06-08,10,2,542,436,2021-06-08,1623106800.0
5790,8,2,2021-06-09,1,1,543,437,2021-06-09,1623193200.0
5791,8,2,2021-06-10,0,0,543,437,2021-06-10,1623279600.0
5792,8,2,2021-06-11,1,1,544,438,2021-06-11,1623366000.0
5793,8,2,2021-06-12,0,0,544,438,2021-06-12,1623452400.0
5794,8,2,2021-06-13,0,0,544,438,2021-06-13,1623538800.0
5795,8,2,2021-06-14,0,0,544,438,2021-06-14,1623625200.0
5796,8,2,2021-06-15,0,0,544,438,2021-06-15,1623711600.0
5797,8,2,2021-06-16,0,1,544,439,2021-06-16,1623798000.0
5798,8,2,2021-06-17,0,0,544,439,2021-06-17,1623884400.0
5799,8,2,2021-06-18,0,0,544,439,2021-06-18,1623970800.0
5800,8,2,2021-06-19,0,1,544,440,2021-06-19,1624057200.0
5801,8,2,2021-06-20,0,0,544,440,2021-06-20,1624143600.0
5802,8,2,2021-06-21,5,2,549,442,2021-06-21,1624230000.0
5803,8,2,2021-06-22,0,1,549,443,2021-06-22,1624316400.0
5804,8,2,2021-06-23,0,0,549,443,2021-06-23,1624402800.0
5805,8,2,2021-06-24,0,0,549,443,2021-06-24,1624489200.0
5806,8,2,2021-06-25,0,0,549,443,2021-06-25,1624575600.0
5807,8,2,2021-06-26,0,0,549,443,2021-06-26,1624662000.0
5808,8,2,2021-06-27,0,0,549,443,2021-06-27,1624748400.0
5809,8,2,2021-06-28,0,0,549,443,2021-06-28,1624834800.0
5810,8,2,2021-06-29,4,4,553,447,2021-06-29,1624921200.0
5811,8,2,2021-06-30,0,1,553,448,2021-06-30,1625007600.0
5812,8,2,2021-07-01,0,0,553,448,2021-07-01,1625094000.0
5813,8,2,2021-07-02,0,0,553,448,2021-07-02,1625180400.0
5814,8,2,2021-07-03,0,0,553,448,2021-07-03,1625266800.0
5815,8,2,2021-07-04,0,1,553,449,2021-07-04,1625353200.0
5816,8,2,2021-07-05,0,0,553,449,2021-07-05,1625439600.0
5817,8,2,2021-07-06,0,0,553,449,2021-07-06,1625526000.0
5818,8,2,2021-07-07,4,3,557,452,2021-07-07,1625612400.0
5819,8,2,2021-07-08,10,0,567,452,2021-07-08,1625698800.0
5820,8,3,2020-12-27,0,0,0,0,2020-12-27,1609023600.0
5821,8,3,2020-12-28,0,0,0,0,2020-12-28,1609110000.0
5822,8,3,2020-12-29,0,0,0,0,2020-12-29,1609196400.0
5823,8,3,2020-12-30,0,0,0,0,2020-12-30,1609282800.0
5824,8,3,2020-12-31,0,0,0,0,2020-12-31,1609369200.0
5825,8,3,2021-01-01,0,0,0,0,2021-01-01,1609455600.0
5826,8,3,2021-01-02,0,0,0,0,2021-01-02,1609542000.0
5827,8,3,2021-01-03,0,0,0,0,2021-01-03,1609628400.0
5828,8,3,2021-01-04,0,0,0,0,2021-01-04,1609714800.0
5829,8,3,2021-01-05,0,0,0,0,2021-01-05,1609801200.0
5830,8,3,2021-01-06,0,0,0,0,2021-01-06,1609887600.0
5831,8,3,2021-01-07,0,0,0,0,2021-01-07,1609974000.0
5832,8,3,2021-01-08,0,0,0,0,2021-01-08,1610060400.0
5833,8,3,2021-01-09,0,0,0,0,2021-01-09,1610146800.0
5834,8,3,2021-01-10,0,0,0,0,2021-01-10,1610233200.0
5835,8,3,2021-01-11,0,0,0,0,2021-01-11,1610319600.0
5836,8,3,2021-01-12,0,0,0,0,2021-01-12,1610406000.0
5837,8,3,2021-01-13,0,0,0,0,2021-01-13,1610492400.0
5838,8,3,2021-01-14,0,0,0,0,2021-01-14,1610578800.0
5839,8,3,2021-01-15,0,0,0,0,2021-01-15,1610665200.0
5840,8,3,2021-01-16,0,0,0,0,2021-01-16,1610751600.0
5841,8,3,2021-01-17,0,0,0,0,2021-01-17,1610838000.0
5842,8,3,2021-01-18,0,0,0,0,2021-01-18,1610924400.0
5843,8,3,2021-01-19,0,0,0,0,2021-01-19,1611010800.0
5844,8,3,2021-01-20,0,0,0,0,2021-01-20,1611097200.0
5845,8,3,2021-01-21,0,0,0,0,2021-01-21,1611183600.0
5846,8,3,2021-01-22,0,0,0,0,2021-01-22,1611270000.0
5847,8,3,2021-01-23,0,0,0,0,2021-01-23,1611356400.0
5848,8,3,2021-01-24,0,0,0,0,2021-01-24,1611442800.0
5849,8,3,2021-01-25,0,0,0,0,2021-01-25,1611529200.0
5850,8,3,2021-01-26,0,0,0,0,2021-01-26,1611615600.0
5851,8,3,2021-01-27,0,0,0,0,2021-01-27,1611702000.0
5852,8,3,2021-01-28,0,0,0,0,2021-01-28,1611788400.0
5853,8,3,2021-01-29,0,0,0,0,2021-01-29,1611874800.0
5854,8,3,2021-01-30,0,0,0,0,2021-01-30,1611961200.0
5855,8,3,2021-01-31,0,0,0,0,2021-01-31,1612047600.0
5856,8,3,2021-02-01,0,0,0,0,2021-02-01,1612134000.0
5857,8,3,2021-02-02,0,0,0,0,2021-02-02,1612220400.0
5858,8,3,2021-02-03,0,0,0,0,2021-02-03,1612306800.0
5859,8,3,2021-02-04,0,0,0,0,2021-02-04,1612393200.0
5860,8,3,2021-02-05,0,0,0,0,2021-02-05,1612479600.0
5861,8,3,2021-02-06,0,0,0,0,2021-02-06,1612566000.0
5862,8,3,2021-02-07,0,0,0,0,2021-02-07,1612652400.0
5863,8,3,2021-02-08,0,0,0,0,2021-02-08,1612738800.0
5864,8,3,2021-02-09,0,0,0,0,2021-02-09,1612825200.0
5865,8,3,2021-02-10,0,0,0,0,2021-02-10,1612911600.0
5866,8,3,2021-02-11,0,0,0,0,2021-02-11,1612998000.0
5867,8,3,2021-02-12,0,0,0,0,2021-02-12,1613084400.0
5868,8,3,2021-02-13,0,0,0,0,2021-02-13,1613170800.0
5869,8,3,2021-02-14,0,0,0,0,2021-02-14,1613257200.0
5870,8,3,2021-02-15,0,0,0,0,2021-02-15,1613343600.0
5871,8,3,2021-02-16,0,0,0,0,2021-02-16,1613430000.0
5872,8,3,2021-02-17,0,0,0,0,2021-02-17,1613516400.0
5873,8,3,2021-02-18,0,0,0,0,2021-02-18,1613602800.0
5874,8,3,2021-02-19,0,0,0,0,2021-02-19,1613689200.0
5875,8,3,2021-02-20,0,0,0,0,2021-02-20,1613775600.0
5876,8,3,2021-02-21,0,0,0,0,2021-02-21,1613862000.0
5877,8,3,2021-02-22,0,0,0,0,2021-02-22,1613948400.0
5878,8,3,2021-02-23,0,0,0,0,2021-02-23,1614034800.0
5879,8,3,2021-02-24,0,0,0,0,2021-02-24,1614121200.0
5880,8,3,2021-02-25,0,0,0,0,2021-02-25,1614207600.0
5881,8,3,2021-02-26,0,0,0,0,2021-02-26,1614294000.0
5882,8,3,2021-02-27,0,0,0,0,2021-02-27,1614380400.0
5883,8,3,2021-02-28,0,0,0,0,2021-02-28,1614466800.0
5884,8,3,2021-03-01,0,0,0,0,2021-03-01,1614553200.0
5885,8,3,2021-03-02,1,0,1,0,2021-03-02,1614639600.0
5886,8,3,2021-03-03,0,0,1,0,2021-03-03,1614726000.0
5887,8,3,2021-03-04,0,0,1,0,2021-03-04,1614812400.0
5888,8,3,2021-03-05,0,0,1,0,2021-03-05,1614898800.0
5889,8,3,2021-03-06,0,0,1,0,2021-03-06,1614985200.0
5890,8,3,2021-03-07,0,0,1,0,2021-03-07,1615071600.0
5891,8,3,2021-03-08,0,0,1,0,2021-03-08,1615158000.0
5892,8,3,2021-03-09,0,0,1,0,2021-03-09,1615244400.0
5893,8,3,2021-03-10,10,0,11,0,2021-03-10,1615330800.0
5894,8,3,2021-03-11,2,0,13,0,2021-03-11,1615417200.0
5895,8,3,2021-03-12,1,0,14,0,2021-03-12,1615503600.0
5896,8,3,2021-03-13,11,0,25,0,2021-03-13,1615590000.0
5897,8,3,2021-03-14,0,0,25,0,2021-03-14,1615676400.0
5898,8,3,2021-03-15,0,0,25,0,2021-03-15,1615762800.0
5899,8,3,2021-03-16,0,0,25,0,2021-03-16,1615849200.0
5900,8,3,2021-03-17,0,0,25,0,2021-03-17,1615935600.0
5901,8,3,2021-03-18,0,0,25,0,2021-03-18,1616022000.0
5902,8,3,2021-03-19,0,0,25,0,2021-03-19,1616108400.0
5903,8,3,2021-03-20,0,0,25,0,2021-03-20,1616194800.0
5904,8,3,2021-03-21,0,0,25,0,2021-03-21,1616281200.0
5905,8,3,2021-03-22,0,0,25,0,2021-03-22,1616367600.0
5906,8,3,2021-03-23,0,0,25,0,2021-03-23,1616454000.0
5907,8,3,2021-03-24,0,0,25,0,2021-03-24,1616540400.0
5908,8,3,2021-03-25,26,0,51,0,2021-03-25,1616626800.0
5909,8,3,2021-03-26,1,0,52,0,2021-03-26,1616713200.0
5910,8,3,2021-03-27,7,0,59,0,2021-03-27,1616799600.0
5911,8,3,2021-03-28,0,0,59,0,2021-03-28,1616886000.0
5912,8,3,2021-03-29,8,0,67,0,2021-03-29,1616972400.0
5913,8,3,2021-03-30,5,0,72,0,2021-03-30,1617058800.0
5914,8,3,2021-03-31,16,0,88,0,2021-03-31,1617145200.0
5915,8,3,2021-04-01,0,0,88,0,2021-04-01,1617231600.0
5916,8,3,2021-04-02,0,0,88,0,2021-04-02,1617318000.0
5917,8,3,2021-04-03,0,0,88,0,2021-04-03,1617404400.0
5918,8,3,2021-04-04,0,0,88,0,2021-04-04,1617490800.0
5919,8,3,2021-04-05,0,0,88,0,2021-04-05,1617577200.0
5920,8,3,2021-04-06,0,0,88,0,2021-04-06,1617663600.0
5921,8,3,2021-04-07,0,0,88,0,2021-04-07,1617750000.0
5922,8,3,2021-04-08,0,0,88,0,2021-04-08,1617836400.0
5923,8,3,2021-04-09,0,0,88,0,2021-04-09,1617922800.0
5924,8,3,2021-04-10,0,0,88,0,2021-04-10,1618009200.0
5925,8,3,2021-04-11,0,0,88,0,2021-04-11,1618095600.0
5926,8,3,2021-04-12,0,0,88,0,2021-04-12,1618185600.0
5927,8,3,2021-04-13,2,0,90,0,2021-04-13,1618272000.0
5928,8,3,2021-04-14,7,0,97,0,2021-04-14,1618358400.0
5929,8,3,2021-04-15,3,0,100,0,2021-04-15,1618444800.0
5930,8,3,2021-04-16,2,0,102,0,2021-04-16,1618531200.0
5931,8,3,2021-04-17,0,0,102,0,2021-04-17,1618617600.0
5932,8,3,2021-04-18,0,0,102,0,2021-04-18,1618704000.0
5933,8,3,2021-04-19,4,0,106,0,2021-04-19,1618790400.0
5934,8,3,2021-04-20,2,0,108,0,2021-04-20,1618876800.0
5935,8,3,2021-04-21,0,0,108,0,2021-04-21,1618963200.0
5936,8,3,2021-04-22,1,0,109,0,2021-04-22,1619049600.0
5937,8,3,2021-04-23,0,0,109,0,2021-04-23,1619136000.0
5938,8,3,2021-04-24,0,0,109,0,2021-04-24,1619222400.0
5939,8,3,2021-04-25,0,0,109,0,2021-04-25,1619308800.0
5940,8,3,2021-04-26,0,0,109,0,2021-04-26,1619395200.0
5941,8,3,2021-04-27,0,0,109,0,2021-04-27,1619481600.0
5942,8,3,2021-04-28,2,0,111,0,2021-04-28,1619568000.0
5943,8,3,2021-04-29,0,0,111,0,2021-04-29,1619654400.0
5944,8,3,2021-04-30,0,0,111,0,2021-04-30,1619740800.0
5945,8,3,2021-05-01,0,8,111,8,2021-05-01,1619827200.0
5946,8,3,2021-05-02,0,0,111,8,2021-05-02,1619913600.0
5947,8,3,2021-05-03,0,4,111,12,2021-05-03,1620000000.0
5948,8,3,2021-05-04,0,4,111,16,2021-05-04,1620086400.0
5949,8,3,2021-05-05,0,1,111,17,2021-05-05,1620172800.0
5950,8,3,2021-05-06,0,0,111,17,2021-05-06,1620259200.0
5951,8,3,2021-05-07,0,0,111,17,2021-05-07,1620345600.0
5952,8,3,2021-05-08,0,0,111,17,2021-05-08,1620432000.0
5953,8,3,2021-05-09,0,0,111,17,2021-05-09,1620518400.0
5954,8,3,2021-05-10,0,0,111,17,2021-05-10,1620604800.0
5955,8,3,2021-05-11,0,0,111,17,2021-05-11,1620691200.0
5956,8,3,2021-05-12,0,0,111,17,2021-05-12,1620777600.0
5957,8,3,2021-05-13,0,0,111,17,2021-05-13,1620864000.0
5958,8,3,2021-05-14,0,0,111,17,2021-05-14,1620950400.0
5959,8,3,2021-05-15,0,0,111,17,2021-05-15,1621036800.0
5960,8,3,2021-05-16,0,0,111,17,2021-05-16,1621123200.0
5961,8,3,2021-05-17,0,0,111,17,2021-05-17,1621206000.0
5962,8,3,2021-05-18,0,0,111,17,2021-05-18,1621292400.0
5963,8,3,2021-05-19,0,0,111,17,2021-05-19,1621378800.0
5964,8,3,2021-05-20,0,0,111,17,2021-05-20,1621465200.0
5965,8,3,2021-05-21,3,2,114,19,2021-05-21,1621551600.0
5966,8,3,2021-05-22,0,2,114,21,2021-05-22,1621638000.0
5967,8,3,2021-05-23,0,0,114,21,2021-05-23,1621724400.0
5968,8,3,2021-05-24,0,0,114,21,2021-05-24,1621810800.0
5969,8,3,2021-05-25,0,0,114,21,2021-05-25,1621897200.0
5970,8,3,2021-05-26,0,0,114,21,2021-05-26,1621983600.0
5971,8,3,2021-05-27,0,0,114,21,2021-05-27,1622070000.0
5972,8,3,2021-05-28,0,0,114,21,2021-05-28,1622156400.0
5973,8,3,2021-05-29,0,0,114,21,2021-05-29,1622242800.0
5974,8,3,2021-05-30,0,0,114,21,2021-05-30,1622329200.0
5975,8,3,2021-05-31,0,0,114,21,2021-05-31,1622415600.0
5976,8,3,2021-06-01,0,0,114,21,2021-06-01,1622502000.0
5977,8,3,2021-06-02,0,0,114,21,2021-06-02,1622588400.0
5978,8,3,2021-06-03,0,3,114,24,2021-06-03,1622674800.0
5979,8,3,2021-06-04,1,1,115,25,2021-06-04,1622761200.0
5980,8,3,2021-06-05,0,2,115,27,2021-06-05,1622847600.0
5981,8,3,2021-06-06,0,0,115,27,2021-06-06,1622934000.0
5982,8,3,2021-06-07,0,0,115,27,2021-06-07,1623020400.0
5983,8,3,2021-06-08,1,0,116,27,2021-06-08,1623106800.0
5984,8,3,2021-06-09,0,0,116,27,2021-06-09,1623193200.0
5985,8,3,2021-06-10,0,6,116,33,2021-06-10,1623279600.0
5986,8,3,2021-06-11,5,0,121,33,2021-06-11,1623366000.0
5987,8,3,2021-06-12,0,2,121,35,2021-06-12,1623452400.0
5988,8,3,2021-06-13,0,0,121,35,2021-06-13,1623538800.0
5989,8,3,2021-06-14,0,0,121,35,2021-06-14,1623625200.0
5990,8,3,2021-06-15,0,1,121,36,2021-06-15,1623711600.0
5991,8,3,2021-06-16,0,2,121,38,2021-06-16,1623798000.0
5992,8,3,2021-06-17,0,2,121,40,2021-06-17,1623884400.0
5993,8,3,2021-06-18,0,4,121,44,2021-06-18,1623970800.0
5994,8,3,2021-06-19,2,3,123,47,2021-06-19,1624057200.0
5995,8,3,2021-06-20,0,0,123,47,2021-06-20,1624143600.0
5996,8,3,2021-06-21,0,0,123,47,2021-06-21,1624230000.0
5997,8,3,2021-06-22,0,0,123,47,2021-06-22,1624316400.0
5998,8,3,2021-06-23,0,0,123,47,2021-06-23,1624402800.0
5999,8,3,2021-06-24,0,0,123,47,2021-06-24,1624489200.0
6000,8,3,2021-06-25,0,0,123,47,2021-06-25,1624575600.0
6001,8,3,2021-06-26,0,0,123,47,2021-06-26,1624662000.0
6002,8,3,2021-06-27,0,0,123,47,2021-06-27,1624748400.0
6003,8,3,2021-06-28,0,0,123,47,2021-06-28,1624834800.0
6004,8,3,2021-06-29,0,0,123,47,2021-06-29,1624921200.0
6005,8,3,2021-06-30,0,0,123,47,2021-06-30,1625007600.0
6006,8,3,2021-07-01,0,0,123,47,2021-07-01,1625094000.0
6007,8,3,2021-07-02,0,0,123,47,2021-07-02,1625180400.0
6008,8,3,2021-07-03,0,0,123,47,2021-07-03,1625266800.0
6009,8,3,2021-07-04,0,0,123,47,2021-07-04,1625353200.0
6010,8,3,2021-07-05,0,0,123,47,2021-07-05,1625439600.0
6011,8,3,2021-07-06,0,0,123,47,2021-07-06,1625526000.0
6012,8,3,2021-07-07,0,0,123,47,2021-07-07,1625612400.0
6013,8,3,2021-07-08,0,0,123,47,2021-07-08,1625698800.0
6014,8,4,2020-12-27,0,0,0,0,2020-12-27,1609023600.0
6015,8,4,2020-12-28,0,0,0,0,2020-12-28,1609110000.0
6016,8,4,2020-12-29,0,0,0,0,2020-12-29,1609196400.0
6017,8,4,2020-12-30,0,0,0,0,2020-12-30,1609282800.0
6018,8,4,2020-12-31,0,0,0,0,2020-12-31,1609369200.0
6019,8,4,2021-01-01,0,0,0,0,2021-01-01,1609455600.0
6020,8,4,2021-01-02,0,0,0,0,2021-01-02,1609542000.0
6021,8,4,2021-01-03,0,0,0,0,2021-01-03,1609628400.0
6022,8,4,2021-01-04,0,0,0,0,2021-01-04,1609714800.0
6023,8,4,2021-01-05,0,0,0,0,2021-01-05,1609801200.0
6024,8,4,2021-01-06,0,0,0,0,2021-01-06,1609887600.0
6025,8,4,2021-01-07,0,0,0,0,2021-01-07,1609974000.0
6026,8,4,2021-01-08,0,0,0,0,2021-01-08,1610060400.0
6027,8,4,2021-01-09,0,0,0,0,2021-01-09,1610146800.0
6028,8,4,2021-01-10,0,0,0,0,2021-01-10,1610233200.0
6029,8,4,2021-01-11,0,0,0,0,2021-01-11,1610319600.0
6030,8,4,2021-01-12,0,0,0,0,2021-01-12,1610406000.0
6031,8,4,2021-01-13,0,0,0,0,2021-01-13,1610492400.0
6032,8,4,2021-01-14,0,0,0,0,2021-01-14,1610578800.0
6033,8,4,2021-01-15,0,0,0,0,2021-01-15,1610665200.0
6034,8,4,2021-01-16,0,0,0,0,2021-01-16,1610751600.0
6035,8,4,2021-01-17,0,0,0,0,2021-01-17,1610838000.0
6036,8,4,2021-01-18,0,0,0,0,2021-01-18,1610924400.0
6037,8,4,2021-01-19,0,0,0,0,2021-01-19,1611010800.0
6038,8,4,2021-01-20,0,0,0,0,2021-01-20,1611097200.0
6039,8,4,2021-01-21,0,0,0,0,2021-01-21,1611183600.0
6040,8,4,2021-01-22,0,0,0,0,2021-01-22,1611270000.0
6041,8,4,2021-01-23,0,0,0,0,2021-01-23,1611356400.0
6042,8,4,2021-01-24,0,0,0,0,2021-01-24,1611442800.0
6043,8,4,2021-01-25,0,0,0,0,2021-01-25,1611529200.0
6044,8,4,2021-01-26,0,0,0,0,2021-01-26,1611615600.0
6045,8,4,2021-01-27,0,0,0,0,2021-01-27,1611702000.0
6046,8,4,2021-01-28,0,0,0,0,2021-01-28,1611788400.0
6047,8,4,2021-01-29,0,0,0,0,2021-01-29,1611874800.0
6048,8,4,2021-01-30,0,0,0,0,2021-01-30,1611961200.0
6049,8,4,2021-01-31,0,0,0,0,2021-01-31,1612047600.0
6050,8,4,2021-02-01,0,0,0,0,2021-02-01,1612134000.0
6051,8,4,2021-02-02,0,0,0,0,2021-02-02,1612220400.0
6052,8,4,2021-02-03,0,0,0,0,2021-02-03,1612306800.0
6053,8,4,2021-02-04,0,0,0,0,2021-02-04,1612393200.0
6054,8,4,2021-02-05,0,0,0,0,2021-02-05,1612479600.0
6055,8,4,2021-02-06,0,0,0,0,2021-02-06,1612566000.0
6056,8,4,2021-02-07,0,0,0,0,2021-02-07,1612652400.0
6057,8,4,2021-02-08,0,0,0,0,2021-02-08,1612738800.0
6058,8,4,2021-02-09,0,0,0,0,2021-02-09,1612825200.0
6059,8,4,2021-02-10,0,0,0,0,2021-02-10,1612911600.0
6060,8,4,2021-02-11,0,0,0,0,2021-02-11,1612998000.0
6061,8,4,2021-02-12,0,0,0,0,2021-02-12,1613084400.0
6062,8,4,2021-02-13,0,0,0,0,2021-02-13,1613170800.0
6063,8,4,2021-02-14,0,0,0,0,2021-02-14,1613257200.0
6064,8,4,2021-02-15,0,0,0,0,2021-02-15,1613343600.0
6065,8,4,2021-02-16,0,0,0,0,2021-02-16,1613430000.0
6066,8,4,2021-02-17,0,0,0,0,2021-02-17,1613516400.0
6067,8,4,2021-02-18,0,0,0,0,2021-02-18,1613602800.0
6068,8,4,2021-02-19,0,0,0,0,2021-02-19,1613689200.0
6069,8,4,2021-02-20,0,0,0,0,2021-02-20,1613775600.0
6070,8,4,2021-02-21,0,0,0,0,2021-02-21,1613862000.0
6071,8,4,2021-02-22,0,0,0,0,2021-02-22,1613948400.0
6072,8,4,2021-02-23,0,0,0,0,2021-02-23,1614034800.0
6073,8,4,2021-02-24,0,0,0,0,2021-02-24,1614121200.0
6074,8,4,2021-02-25,0,0,0,0,2021-02-25,1614207600.0
6075,8,4,2021-02-26,0,0,0,0,2021-02-26,1614294000.0
6076,8,4,2021-02-27,0,0,0,0,2021-02-27,1614380400.0
6077,8,4,2021-02-28,0,0,0,0,2021-02-28,1614466800.0
6078,8,4,2021-03-01,0,0,0,0,2021-03-01,1614553200.0
6079,8,4,2021-03-02,0,0,0,0,2021-03-02,1614639600.0
6080,8,4,2021-03-03,0,0,0,0,2021-03-03,1614726000.0
6081,8,4,2021-03-04,0,0,0,0,2021-03-04,1614812400.0
6082,8,4,2021-03-05,0,0,0,0,2021-03-05,1614898800.0
6083,8,4,2021-03-06,0,0,0,0,2021-03-06,1614985200.0
6084,8,4,2021-03-07,0,0,0,0,2021-03-07,1615071600.0
6085,8,4,2021-03-08,0,0,0,0,2021-03-08,1615158000.0
6086,8,4,2021-03-09,0,0,0,0,2021-03-09,1615244400.0
6087,8,4,2021-03-10,0,0,0,0,2021-03-10,1615330800.0
6088,8,4,2021-03-11,0,0,0,0,2021-03-11,1615417200.0
6089,8,4,2021-03-12,0,0,0,0,2021-03-12,1615503600.0
6090,8,4,2021-03-13,0,0,0,0,2021-03-13,1615590000.0
6091,8,4,2021-03-14,0,0,0,0,2021-03-14,1615676400.0
6092,8,4,2021-03-15,0,0,0,0,2021-03-15,1615762800.0
6093,8,4,2021-03-16,0,0,0,0,2021-03-16,1615849200.0
6094,8,4,2021-03-17,0,0,0,0,2021-03-17,1615935600.0
6095,8,4,2021-03-18,0,0,0,0,2021-03-18,1616022000.0
6096,8,4,2021-03-19,0,0,0,0,2021-03-19,1616108400.0
6097,8,4,2021-03-20,0,0,0,0,2021-03-20,1616194800.0
6098,8,4,2021-03-21,0,0,0,0,2021-03-21,1616281200.0
6099,8,4,2021-03-22,0,0,0,0,2021-03-22,1616367600.0
6100,8,4,2021-03-23,0,0,0,0,2021-03-23,1616454000.0
6101,8,4,2021-03-24,0,0,0,0,2021-03-24,1616540400.0
6102,8,4,2021-03-25,0,0,0,0,2021-03-25,1616626800.0
6103,8,4,2021-03-26,0,0,0,0,2021-03-26,1616713200.0
6104,8,4,2021-03-27,0,0,0,0,2021-03-27,1616799600.0
6105,8,4,2021-03-28,0,0,0,0,2021-03-28,1616886000.0
6106,8,4,2021-03-29,0,0,0,0,2021-03-29,1616972400.0
6107,8,4,2021-03-30,0,0,0,0,2021-03-30,1617058800.0
6108,8,4,2021-03-31,0,0,0,0,2021-03-31,1617145200.0
6109,8,4,2021-04-01,0,0,0,0,2021-04-01,1617231600.0
6110,8,4,2021-04-02,0,0,0,0,2021-04-02,1617318000.0
6111,8,4,2021-04-03,0,0,0,0,2021-04-03,1617404400.0
6112,8,4,2021-04-04,0,0,0,0,2021-04-04,1617490800.0
6113,8,4,2021-04-05,0,0,0,0,2021-04-05,1617577200.0
6114,8,4,2021-04-06,0,0,0,0,2021-04-06,1617663600.0
6115,8,4,2021-04-07,0,0,0,0,2021-04-07,1617750000.0
6116,8,4,2021-04-08,0,0,0,0,2021-04-08,1617836400.0
6117,8,4,2021-04-09,0,0,0,0,2021-04-09,1617922800.0
6118,8,4,2021-04-10,0,0,0,0,2021-04-10,1618009200.0
6119,8,4,2021-04-11,0,0,0,0,2021-04-11,1618095600.0
6120,8,4,2021-04-12,0,0,0,0,2021-04-12,1618185600.0
6121,8,4,2021-04-13,0,0,0,0,2021-04-13,1618272000.0
6122,8,4,2021-04-14,0,0,0,0,2021-04-14,1618358400.0
6123,8,4,2021-04-15,0,0,0,0,2021-04-15,1618444800.0
6124,8,4,2021-04-16,0,0,0,0,2021-04-16,1618531200.0
6125,8,4,2021-04-17,0,0,0,0,2021-04-17,1618617600.0
6126,8,4,2021-04-18,0,0,0,0,2021-04-18,1618704000.0
6127,8,4,2021-04-19,0,0,0,0,2021-04-19,1618790400.0
6128,8,4,2021-04-20,0,0,0,0,2021-04-20,1618876800.0
6129,8,4,2021-04-21,0,0,0,0,2021-04-21,1618963200.0
6130,8,4,2021-04-22,0,0,0,0,2021-04-22,1619049600.0
6131,8,4,2021-04-23,0,0,0,0,2021-04-23,1619136000.0
6132,8,4,2021-04-24,0,0,0,0,2021-04-24,1619222400.0
6133,8,4,2021-04-25,0,0,0,0,2021-04-25,1619308800.0
6134,8,4,2021-04-26,0,0,0,0,2021-04-26,1619395200.0
6135,8,4,2021-04-27,0,0,0,0,2021-04-27,1619481600.0
6136,8,4,2021-04-28,0,0,0,0,2021-04-28,1619568000.0
6137,8,4,2021-04-29,0,0,0,0,2021-04-29,1619654400.0
6138,8,4,2021-04-30,0,0,0,0,2021-04-30,1619740800.0
6139,8,4,2021-05-01,0,0,0,0,2021-05-01,1619827200.0
6140,8,4,2021-05-02,0,0,0,0,2021-05-02,1619913600.0
6141,8,4,2021-05-03,0,0,0,0,2021-05-03,1620000000.0
6142,8,4,2021-05-04,0,0,0,0,2021-05-04,1620086400.0
6143,8,4,2021-05-05,0,0,0,0,2021-05-05,1620172800.0
6144,8,4,2021-05-06,0,0,0,0,2021-05-06,1620259200.0
6145,8,4,2021-05-07,0,0,0,0,2021-05-07,1620345600.0
6146,8,4,2021-05-08,0,0,0,0,2021-05-08,1620432000.0
6147,8,4,2021-05-09,0,0,0,0,2021-05-09,1620518400.0
6148,8,4,2021-05-10,0,0,0,0,2021-05-10,1620604800.0
6149,8,4,2021-05-11,0,0,0,0,2021-05-11,1620691200.0
6150,8,4,2021-05-12,0,0,0,0,2021-05-12,1620777600.0
6151,8,4,2021-05-13,0,0,0,0,2021-05-13,1620864000.0
6152,8,4,2021-05-14,0,0,0,0,2021-05-14,1620950400.0
6153,8,4,2021-05-15,0,0,0,0,2021-05-15,1621036800.0
6154,8,4,2021-05-16,0,0,0,0,2021-05-16,1621123200.0
6155,8,4,2021-05-17,0,0,0,0,2021-05-17,1621206000.0
6156,8,4,2021-05-18,0,0,0,0,2021-05-18,1621292400.0
6157,8,4,2021-05-19,0,0,0,0,2021-05-19,1621378800.0
6158,8,4,2021-05-20,0,0,0,0,2021-05-20,1621465200.0
6159,8,4,2021-05-21,0,0,0,0,2021-05-21,1621551600.0
6160,8,4,2021-05-22,0,0,0,0,2021-05-22,1621638000.0
6161,8,4,2021-05-23,0,0,0,0,2021-05-23,1621724400.0
6162,8,4,2021-05-24,0,0,0,0,2021-05-24,1621810800.0
6163,8,4,2021-05-25,0,0,0,0,2021-05-25,1621897200.0
6164,8,4,2021-05-26,0,0,0,0,2021-05-26,1621983600.0
6165,8,4,2021-05-27,0,0,0,0,2021-05-27,1622070000.0
6166,8,4,2021-05-28,0,0,0,0,2021-05-28,1622156400.0
6167,8,4,2021-05-29,0,0,0,0,2021-05-29,1622242800.0
6168,8,4,2021-05-30,0,0,0,0,2021-05-30,1622329200.0
6169,8,4,2021-05-31,0,0,0,0,2021-05-31,1622415600.0
6170,8,4,2021-06-01,0,0,0,0,2021-06-01,1622502000.0
6171,8,4,2021-06-02,0,0,0,0,2021-06-02,1622588400.0
6172,8,4,2021-06-03,0,0,0,0,2021-06-03,1622674800.0
6173,8,4,2021-06-04,0,0,0,0,2021-06-04,1622761200.0
6174,8,4,2021-06-05,0,0,0,0,2021-06-05,1622847600.0
6175,8,4,2021-06-06,0,0,0,0,2021-06-06,1622934000.0
6176,8,4,2021-06-07,0,0,0,0,2021-06-07,1623020400.0
6177,8,4,2021-06-08,0,0,0,0,2021-06-08,1623106800.0
6178,8,4,2021-06-09,0,0,0,0,2021-06-09,1623193200.0
6179,8,4,2021-06-10,0,0,0,0,2021-06-10,1623279600.0
6180,8,4,2021-06-11,0,0,0,0,2021-06-11,1623366000.0
6181,8,4,2021-06-12,0,0,0,0,2021-06-12,1623452400.0
6182,8,4,2021-06-13,0,0,0,0,2021-06-13,1623538800.0
6183,8,4,2021-06-14,0,0,0,0,2021-06-14,1623625200.0
6184,8,4,2021-06-15,0,0,0,0,2021-06-15,1623711600.0
6185,8,4,2021-06-16,0,0,0,0,2021-06-16,1623798000.0
6186,8,4,2021-06-17,0,0,0,0,2021-06-17,1623884400.0
6187,8,4,2021-06-18,0,0,0,0,2021-06-18,1623970800.0
6188,8,4,2021-06-19,0,0,0,0,2021-06-19,1624057200.0
6189,8,4,2021-06-20,0,0,0,0,2021-06-20,1624143600.0
6190,8,4,2021-06-21,0,0,0,0,2021-06-21,1624230000.0
6191,8,4,2021-06-22,0,0,0,0,2021-06-22,1624316400.0
6192,8,4,2021-06-23,0,0,0,0,2021-06-23,1624402800.0
6193,8,4,2021-06-24,0,0,0,0,2021-06-24,1624489200.0
6194,8,4,2021-06-25,0,0,0,0,2021-06-25,1624575600.0
6195,8,4,2021-06-26,0,0,0,0,2021-06-26,1624662000.0
6196,8,4,2021-06-27,0,0,0,0,2021-06-27,1624748400.0
6197,8,4,2021-06-28,0,0,0,0,2021-06-28,1624834800.0
6198,8,4,2021-06-29,0,0,0,0,2021-06-29,1624921200.0
6199,8,4,2021-06-30,0,0,0,0,2021-06-30,1625007600.0
6200,8,4,2021-07-01,0,0,0,0,2021-07-01,1625094000.0
6201,8,4,2021-07-02,0,0,0,0,2021-07-02,1625180400.0
6202,8,4,2021-07-03,0,0,0,0,2021-07-03,1625266800.0
6203,8,4,2021-07-04,0,0,0,0,2021-07-04,1625353200.0
6204,8,4,2021-07-05,0,0,0,0,2021-07-05,1625439600.0
6205,8,4,2021-07-06,0,0,0,0,2021-07-06,1625526000.0
6206,8,4,2021-07-07,0,0,0,0,2021-07-07,1625612400.0
6207,8,4,2021-07-08,0,0,0,0,2021-07-08,1625698800.0
6208,11,1,2020-12-27,13,0,13,0,2020-12-27,1609023600.0
6209,11,1,2020-12-28,12,0,25,0,2020-12-28,1609110000.0
6210,11,1,2020-12-29,56,0,81,0,2020-12-29,1609196400.0
6211,11,1,2020-12-30,91,0,172,0,2020-12-30,1609282800.0
6212,11,1,2020-12-31,39,0,211,0,2020-12-31,1609369200.0
6213,11,1,2021-01-01,32,0,243,0,2021-01-01,1609455600.0
6214,11,1,2021-01-02,64,0,307,0,2021-01-02,1609542000.0
6215,11,1,2021-01-03,78,0,385,0,2021-01-03,1609628400.0
6216,11,1,2021-01-04,554,0,939,0,2021-01-04,1609714800.0
6217,11,1,2021-01-05,2075,0,3014,0,2021-01-05,1609801200.0
6218,11,1,2021-01-06,3022,0,6036,0,2021-01-06,1609887600.0
6219,11,1,2021-01-07,5394,0,11430,0,2021-01-07,1609974000.0
6220,11,1,2021-01-08,7136,0,18566,0,2021-01-08,1610060400.0
6221,11,1,2021-01-09,1897,0,20463,0,2021-01-09,1610146800.0
6222,11,1,2021-01-10,1756,0,22219,0,2021-01-10,1610233200.0
6223,11,1,2021-01-11,8022,0,30241,0,2021-01-11,1610319600.0
6224,11,1,2021-01-12,10381,0,40622,0,2021-01-12,1610406000.0
6225,11,1,2021-01-13,10030,0,50652,0,2021-01-13,1610492400.0
6226,11,1,2021-01-14,10158,0,60810,0,2021-01-14,1610578800.0
6227,11,1,2021-01-15,8930,0,69740,0,2021-01-15,1610665200.0
6228,11,1,2021-01-16,2419,9,72159,9,2021-01-16,1610751600.0
6229,11,1,2021-01-17,1093,6,73252,15,2021-01-17,1610838000.0
6230,11,1,2021-01-18,12269,22,85521,37,2021-01-18,1610924400.0
6231,11,1,2021-01-19,15871,22,101392,59,2021-01-19,1611010800.0
6232,11,1,2021-01-20,18395,26,119787,85,2021-01-20,1611097200.0
6233,11,1,2021-01-21,22319,25,142106,110,2021-01-21,1611183600.0
6234,11,1,2021-01-22,17112,54,159218,164,2021-01-22,1611270000.0
6235,11,1,2021-01-23,4958,7,164176,171,2021-01-23,1611356400.0
6236,11,1,2021-01-24,1285,0,165461,171,2021-01-24,1611442800.0
6237,11,1,2021-01-25,8875,153,174336,324,2021-01-25,1611529200.0
6238,11,1,2021-01-26,12348,333,186684,657,2021-01-26,1611615600.0
6239,11,1,2021-01-27,16234,641,202918,1298,2021-01-27,1611702000.0
6240,11,1,2021-01-28,20312,1112,223230,2410,2021-01-28,1611788400.0
6241,11,1,2021-01-29,15357,1298,238587,3708,2021-01-29,1611874800.0
6242,11,1,2021-01-30,4468,82,243055,3790,2021-01-30,1611961200.0
6243,11,1,2021-01-31,586,19,243641,3809,2021-01-31,1612047600.0
6244,11,1,2021-02-01,7377,1937,251018,5746,2021-02-01,1612134000.0
6245,11,1,2021-02-02,8354,2793,259372,8539,2021-02-02,1612220400.0
6246,11,1,2021-02-03,8090,3778,267462,12317,2021-02-03,1612306800.0
6247,11,1,2021-02-04,8713,4567,276175,16884,2021-02-04,1612393200.0
6248,11,1,2021-02-05,8942,4406,285117,21290,2021-02-05,1612479600.0
6249,11,1,2021-02-06,3243,744,288360,22034,2021-02-06,1612566000.0
6250,11,1,2021-02-07,432,535,288792,22569,2021-02-07,1612652400.0
6251,11,1,2021-02-08,3489,5857,292281,28426,2021-02-08,1612738800.0
6252,11,1,2021-02-09,4007,9561,296288,37987,2021-02-09,1612825200.0
6253,11,1,2021-02-10,4359,11018,300647,49005,2021-02-10,1612911600.0
6254,11,1,2021-02-11,5756,16164,306403,65169,2021-02-11,1612998000.0
6255,11,1,2021-02-12,5698,10265,312101,75434,2021-02-12,1613084400.0
6256,11,1,2021-02-13,1004,2554,313105,77988,2021-02-13,1613170800.0
6257,11,1,2021-02-14,131,554,313236,78542,2021-02-14,1613257200.0
6258,11,1,2021-02-15,2262,11861,315498,90403,2021-02-15,1613343600.0
6259,11,1,2021-02-16,3030,18264,318528,108667,2021-02-16,1613430000.0
6260,11,1,2021-02-17,3566,15412,322094,124079,2021-02-17,1613516400.0
6261,11,1,2021-02-18,6114,20457,328208,144536,2021-02-18,1613602800.0
6262,11,1,2021-02-19,6752,15137,334960,159673,2021-02-19,1613689200.0
6263,11,1,2021-02-20,1402,4804,336362,164477,2021-02-20,1613775600.0
6264,11,1,2021-02-21,352,817,336714,165294,2021-02-21,1613862000.0
6265,11,1,2021-02-22,2492,9811,339206,175105,2021-02-22,1613948400.0
6266,11,1,2021-02-23,3188,10377,342394,185482,2021-02-23,1614034800.0
6267,11,1,2021-02-24,3095,9748,345489,195230,2021-02-24,1614121200.0
6268,11,1,2021-02-25,3292,13817,348781,209047,2021-02-25,1614207600.0
6269,11,1,2021-02-26,4575,9875,353356,218922,2021-02-26,1614294000.0
6270,11,1,2021-02-27,1032,3197,354388,222119,2021-02-27,1614380400.0
6271,11,1,2021-02-28,90,626,354478,222745,2021-02-28,1614466800.0
6272,11,1,2021-03-01,3708,7670,358186,230415,2021-03-01,1614553200.0
6273,11,1,2021-03-02,5942,9259,364128,239674,2021-03-02,1614639600.0
6274,11,1,2021-03-03,8348,9522,372476,249196,2021-03-03,1614726000.0
6275,11,1,2021-03-04,11580,10192,384056,259388,2021-03-04,1614812400.0
6276,11,1,2021-03-05,12234,9962,396290,269350,2021-03-05,1614898800.0
6277,11,1,2021-03-06,27265,2678,423555,272028,2021-03-06,1614985200.0
6278,11,1,2021-03-07,26836,2184,450391,274212,2021-03-07,1615071600.0
6279,11,1,2021-03-08,9145,4265,459536,278477,2021-03-08,1615158000.0
6280,11,1,2021-03-09,13999,3860,473535,282337,2021-03-09,1615244400.0
6281,11,1,2021-03-10,14173,4151,487708,286488,2021-03-10,1615330800.0
6282,11,1,2021-03-11,16824,5039,504532,291527,2021-03-11,1615417200.0
6283,11,1,2021-03-12,17459,4943,521991,296470,2021-03-12,1615503600.0
6284,11,1,2021-03-13,20008,933,541999,297403,2021-03-13,1615590000.0
6285,11,1,2021-03-14,10476,383,552475,297786,2021-03-14,1615676400.0
6286,11,1,2021-03-15,14527,2807,567002,300593,2021-03-15,1615762800.0
6287,11,1,2021-03-16,20315,3152,587317,303745,2021-03-16,1615849200.0
6288,11,1,2021-03-17,20762,2878,608079,306623,2021-03-17,1615935600.0
6289,11,1,2021-03-18,23857,3034,631936,309657,2021-03-18,1616022000.0
6290,11,1,2021-03-19,24895,2885,656831,312542,2021-03-19,1616108400.0
6291,11,1,2021-03-20,14116,874,670947,313416,2021-03-20,1616194800.0
6292,11,1,2021-03-21,3838,1056,674785,314472,2021-03-21,1616281200.0
6293,11,1,2021-03-22,19488,3002,694273,317474,2021-03-22,1616367600.0
6294,11,1,2021-03-23,23493,3828,717766,321302,2021-03-23,1616454000.0
6295,11,1,2021-03-24,23289,3446,741055,324748,2021-03-24,1616540400.0
6296,11,1,2021-03-25,30033,2999,771088,327747,2021-03-25,1616626800.0
6297,11,1,2021-03-26,30622,3656,801710,331403,2021-03-26,1616713200.0
6298,11,1,2021-03-27,22374,1009,824084,332412,2021-03-27,1616799600.0
6299,11,1,2021-03-28,8240,137,832324,332549,2021-03-28,1616886000.0
6300,11,1,2021-03-29,21003,5615,853327,338164,2021-03-29,1616972400.0
6301,11,1,2021-03-30,27305,7652,880632,345816,2021-03-30,1617058800.0
6302,11,1,2021-03-31,27133,10346,907765,356162,2021-03-31,1617145200.0
6303,11,1,2021-04-01,30643,17358,938408,373520,2021-04-01,1617231600.0
6304,11,1,2021-04-02,25859,19907,964267,393427,2021-04-02,1617318000.0
6305,11,1,2021-04-03,11290,19355,975557,412782,2021-04-03,1617404400.0
6306,11,1,2021-04-04,4824,6963,980381,419745,2021-04-04,1617490800.0
6307,11,1,2021-04-05,4510,1811,984891,421556,2021-04-05,1617577200.0
6308,11,1,2021-04-06,19743,16362,1004634,437918,2021-04-06,1617663600.0
6309,11,1,2021-04-07,24913,17446,1029547,455364,2021-04-07,1617750000.0
6310,11,1,2021-04-08,30314,17992,1059861,473356,2021-04-08,1617836400.0
6311,11,1,2021-04-09,28366,18305,1088227,491661,2021-04-09,1617922800.0
6312,11,1,2021-04-10,14640,17998,1102867,509659,2021-04-10,1618009200.0
6313,11,1,2021-04-11,4619,6778,1107486,516437,2021-04-11,1618095600.0
6314,11,1,2021-04-12,22165,14948,1129651,531385,2021-04-12,1618185600.0
6315,11,1,2021-04-13,25022,22550,1154673,553935,2021-04-13,1618272000.0
6316,11,1,2021-04-14,24216,18748,1178889,572683,2021-04-14,1618358400.0
6317,11,1,2021-04-15,25225,21901,1204114,594584,2021-04-15,1618444800.0
6318,11,1,2021-04-16,25584,22509,1229698,617093,2021-04-16,1618531200.0
6319,11,1,2021-04-17,15221,12639,1244919,629732,2021-04-17,1618617600.0
6320,11,1,2021-04-18,3262,3288,1248181,633020,2021-04-18,1618704000.0
6321,11,1,2021-04-19,18269,18340,1266450,651360,2021-04-19,1618790400.0
6322,11,1,2021-04-20,21097,21977,1287547,673337,2021-04-20,1618876800.0
6323,11,1,2021-04-21,23977,22239,1311524,695576,2021-04-21,1618963200.0
6324,11,1,2021-04-22,24760,27905,1336284,723481,2021-04-22,1619049600.0
6325,11,1,2021-04-23,26013,26049,1362297,749530,2021-04-23,1619136000.0
6326,11,1,2021-04-24,19721,19446,1382018,768976,2021-04-24,1619222400.0
6327,11,1,2021-04-25,11845,6495,1393863,775471,2021-04-25,1619308800.0
6328,11,1,2021-04-26,26180,19925,1420043,795396,2021-04-26,1619395200.0
6329,11,1,2021-04-27,35626,22782,1455669,818178,2021-04-27,1619481600.0
6330,11,1,2021-04-28,38526,22021,1494195,840199,2021-04-28,1619568000.0
6331,11,1,2021-04-29,45986,23787,1540181,863986,2021-04-29,1619654400.0
6332,11,1,2021-04-30,48140,22167,1588321,886153,2021-04-30,1619740800.0
6333,11,1,2021-05-01,19855,3334,1608176,889487,2021-05-01,1619827200.0
6334,11,1,2021-05-02,12150,3247,1620326,892734,2021-05-02,1619913600.0
6335,11,1,2021-05-03,48546,27428,1668872,920162,2021-05-03,1620000000.0
6336,11,1,2021-05-04,54289,21716,1723161,941878,2021-05-04,1620086400.0
6337,11,1,2021-05-05,54613,20027,1777774,961905,2021-05-05,1620172800.0
6338,11,1,2021-05-06,60474,21792,1838248,983697,2021-05-06,1620259200.0
6339,11,1,2021-05-07,56334,22842,1894582,1006539,2021-05-07,1620345600.0
6340,11,1,2021-05-08,46928,8536,1941510,1015075,2021-05-08,1620432000.0
6341,11,1,2021-05-09,31162,6128,1972672,1021203,2021-05-09,1620518400.0
6342,11,1,2021-05-10,61331,20655,2034003,1041858,2021-05-10,1620604800.0
6343,11,1,2021-05-11,70816,25565,2104819,1067423,2021-05-11,1620691200.0
6344,11,1,2021-05-12,72599,20091,2177418,1087514,2021-05-12,1620777600.0
6345,11,1,2021-05-13,59412,3956,2236830,1091470,2021-05-13,1620864000.0
6346,11,1,2021-05-14,71931,10559,2308761,1102029,2021-05-14,1620950400.0
6347,11,1,2021-05-15,56903,6726,2365664,1108755,2021-05-15,1621036800.0
6348,11,1,2021-05-16,31267,1757,2396931,1110512,2021-05-16,1621123200.0
6349,11,1,2021-05-17,75791,5926,2472722,1116438,2021-05-17,1621206000.0
6350,11,1,2021-05-18,90101,6336,2562823,1122774,2021-05-18,1621292400.0
6351,11,1,2021-05-19,86172,12479,2648995,1135253,2021-05-19,1621378800.0
6352,11,1,2021-05-20,93072,11399,2742067,1146652,2021-05-20,1621465200.0
6353,11,1,2021-05-21,86248,7145,2828315,1153797,2021-05-21,1621551600.0
6354,11,1,2021-05-22,66053,2830,2894368,1156627,2021-05-22,1621638000.0
6355,11,1,2021-05-23,35769,1345,2930137,1157972,2021-05-23,1621724400.0
6356,11,1,2021-05-24,57182,2115,2987319,1160087,2021-05-24,1621810800.0
6357,11,1,2021-05-25,83124,14045,3070443,1174132,2021-05-25,1621897200.0
6358,11,1,2021-05-26,81729,14582,3152172,1188714,2021-05-26,1621983600.0
6359,11,1,2021-05-27,88558,18445,3240730,1207159,2021-05-27,1622070000.0
6360,11,1,2021-05-28,79724,19609,3320454,1226768,2021-05-28,1622156400.0
6361,11,1,2021-05-29,61951,10263,3382405,1237031,2021-05-29,1622242800.0
6362,11,1,2021-05-30,34826,2841,3417231,1239872,2021-05-30,1622329200.0
6363,11,1,2021-05-31,69406,21094,3486637,1260966,2021-05-31,1622415600.0
6364,11,1,2021-06-01,75235,27035,3561872,1288001,2021-06-01,1622502000.0
6365,11,1,2021-06-02,73947,24202,3635819,1312203,2021-06-02,1622588400.0
6366,11,1,2021-06-03,78651,24786,3714470,1336989,2021-06-03,1622674800.0
6367,11,1,2021-06-04,73039,28335,3787509,1365324,2021-06-04,1622761200.0
6368,11,1,2021-06-05,56144,21276,3843653,1386600,2021-06-05,1622847600.0
6369,11,1,2021-06-06,36481,8632,3880134,1395232,2021-06-06,1622934000.0
6370,11,1,2021-06-07,61883,34052,3942017,1429284,2021-06-07,1623020400.0
6371,11,1,2021-06-08,61829,40350,4003846,1469634,2021-06-08,1623106800.0
6372,11,1,2021-06-09,62302,41937,4066148,1511571,2021-06-09,1623193200.0
6373,11,1,2021-06-10,61751,55256,4127899,1566827,2021-06-10,1623279600.0
6374,11,1,2021-06-11,55699,44515,4183598,1611342,2021-06-11,1623366000.0
6375,11,1,2021-06-12,58155,28780,4241753,1640122,2021-06-12,1623452400.0
6376,11,1,2021-06-13,28096,15071,4269849,1655193,2021-06-13,1623538800.0
6377,11,1,2021-06-14,37837,57572,4307686,1712765,2021-06-14,1623625200.0
6378,11,1,2021-06-15,43119,59354,4350805,1772119,2021-06-15,1623711600.0
6379,11,1,2021-06-16,45910,57033,4396715,1829152,2021-06-16,1623798000.0
6380,11,1,2021-06-17,46640,56982,4443355,1886134,2021-06-17,1623884400.0
6381,11,1,2021-06-18,42174,68671,4485529,1954805,2021-06-18,1623970800.0
6382,11,1,2021-06-19,38587,53087,4524116,2007892,2021-06-19,1624057200.0
6383,11,1,2021-06-20,14809,31066,4538925,2038958,2021-06-20,1624143600.0
6384,11,1,2021-06-21,30750,64574,4569675,2103532,2021-06-21,1624230000.0
6385,11,1,2021-06-22,33634,75686,4603309,2179218,2021-06-22,1624316400.0
6386,11,1,2021-06-23,35044,74208,4638353,2253426,2021-06-23,1624402800.0
6387,11,1,2021-06-24,37024,66901,4675377,2320327,2021-06-24,1624489200.0
6388,11,1,2021-06-25,33832,80927,4709209,2401254,2021-06-25,1624575600.0
6389,11,1,2021-06-26,32484,65528,4741693,2466782,2021-06-26,1624662000.0
6390,11,1,2021-06-27,12207,34886,4753900,2501668,2021-06-27,1624748400.0
6391,11,1,2021-06-28,27324,76287,4781224,2577955,2021-06-28,1624834800.0
6392,11,1,2021-06-29,30544,84677,4811768,2662632,2021-06-29,1624921200.0
6393,11,1,2021-06-30,33681,80506,4845449,2743138,2021-06-30,1625007600.0
6394,11,1,2021-07-01,35132,77435,4880581,2820573,2021-07-01,1625094000.0
6395,11,1,2021-07-02,34436,79103,4915017,2899676,2021-07-02,1625180400.0
6396,11,1,2021-07-03,29531,69432,4944548,2969108,2021-07-03,1625266800.0
6397,11,1,2021-07-04,13357,34102,4957905,3003210,2021-07-04,1625353200.0
6398,11,1,2021-07-05,30457,69779,4988362,3072989,2021-07-05,1625439600.0
6399,11,1,2021-07-06,32901,79948,5021263,3152937,2021-07-06,1625526000.0
6400,11,1,2021-07-07,34557,77352,5055820,3230289,2021-07-07,1625612400.0
6401,11,1,2021-07-08,37257,75238,5093077,3305527,2021-07-08,1625698800.0
6402,11,2,2020-12-27,0,0,0,0,2020-12-27,1609023600.0
6403,11,2,2020-12-28,0,0,0,0,2020-12-28,1609110000.0
6404,11,2,2020-12-29,0,0,0,0,2020-12-29,1609196400.0
6405,11,2,2020-12-30,0,0,0,0,2020-12-30,1609282800.0
6406,11,2,2020-12-31,0,0,0,0,2020-12-31,1609369200.0
6407,11,2,2021-01-01,0,0,0,0,2021-01-01,1609455600.0
6408,11,2,2021-01-02,0,0,0,0,2021-01-02,1609542000.0
6409,11,2,2021-01-03,0,0,0,0,2021-01-03,1609628400.0
6410,11,2,2021-01-04,0,0,0,0,2021-01-04,1609714800.0
6411,11,2,2021-01-05,0,0,0,0,2021-01-05,1609801200.0
6412,11,2,2021-01-06,0,0,0,0,2021-01-06,1609887600.0
6413,11,2,2021-01-07,0,0,0,0,2021-01-07,1609974000.0
6414,11,2,2021-01-08,0,0,0,0,2021-01-08,1610060400.0
6415,11,2,2021-01-09,0,0,0,0,2021-01-09,1610146800.0
6416,11,2,2021-01-10,0,0,0,0,2021-01-10,1610233200.0
6417,11,2,2021-01-11,0,0,0,0,2021-01-11,1610319600.0
6418,11,2,2021-01-12,0,0,0,0,2021-01-12,1610406000.0
6419,11,2,2021-01-13,0,0,0,0,2021-01-13,1610492400.0
6420,11,2,2021-01-14,3,0,3,0,2021-01-14,1610578800.0
6421,11,2,2021-01-15,1,0,4,0,2021-01-15,1610665200.0
6422,11,2,2021-01-16,0,0,4,0,2021-01-16,1610751600.0
6423,11,2,2021-01-17,0,0,4,0,2021-01-17,1610838000.0
6424,11,2,2021-01-18,0,0,4,0,2021-01-18,1610924400.0
6425,11,2,2021-01-19,0,0,4,0,2021-01-19,1611010800.0
6426,11,2,2021-01-20,1,0,5,0,2021-01-20,1611097200.0
6427,11,2,2021-01-21,8,0,13,0,2021-01-21,1611183600.0
6428,11,2,2021-01-22,4,0,17,0,2021-01-22,1611270000.0
6429,11,2,2021-01-23,5,0,22,0,2021-01-23,1611356400.0
6430,11,2,2021-01-24,0,0,22,0,2021-01-24,1611442800.0
6431,11,2,2021-01-25,0,0,22,0,2021-01-25,1611529200.0
6432,11,2,2021-01-26,1,0,23,0,2021-01-26,1611615600.0
6433,11,2,2021-01-27,1,0,24,0,2021-01-27,1611702000.0
6434,11,2,2021-01-28,2,0,26,0,2021-01-28,1611788400.0
6435,11,2,2021-01-29,47,0,73,0,2021-01-29,1611874800.0
6436,11,2,2021-01-30,0,0,73,0,2021-01-30,1611961200.0
6437,11,2,2021-01-31,0,0,73,0,2021-01-31,1612047600.0
6438,11,2,2021-02-01,16,0,89,0,2021-02-01,1612134000.0
6439,11,2,2021-02-02,5,0,94,0,2021-02-02,1612220400.0
6440,11,2,2021-02-03,40,0,134,0,2021-02-03,1612306800.0
6441,11,2,2021-02-04,74,0,208,0,2021-02-04,1612393200.0
6442,11,2,2021-02-05,11,0,219,0,2021-02-05,1612479600.0
6443,11,2,2021-02-06,3,0,222,0,2021-02-06,1612566000.0
6444,11,2,2021-02-07,0,0,222,0,2021-02-07,1612652400.0
6445,11,2,2021-02-08,2390,0,2612,0,2021-02-08,1612738800.0
6446,11,2,2021-02-09,3069,2,5681,2,2021-02-09,1612825200.0
6447,11,2,2021-02-10,3569,2,9250,4,2021-02-10,1612911600.0
6448,11,2,2021-02-11,3832,5,13082,9,2021-02-11,1612998000.0
6449,11,2,2021-02-12,3675,3,16757,12,2021-02-12,1613084400.0
6450,11,2,2021-02-13,1240,1,17997,13,2021-02-13,1613170800.0
6451,11,2,2021-02-14,81,0,18078,13,2021-02-14,1613257200.0
6452,11,2,2021-02-15,195,2,18273,15,2021-02-15,1613343600.0
6453,11,2,2021-02-16,102,2,18375,17,2021-02-16,1613430000.0
6454,11,2,2021-02-17,151,0,18526,17,2021-02-17,1613516400.0
6455,11,2,2021-02-18,184,7,18710,24,2021-02-18,1613602800.0
6456,11,2,2021-02-19,232,2,18942,26,2021-02-19,1613689200.0
6457,11,2,2021-02-20,0,2,18942,28,2021-02-20,1613775600.0
6458,11,2,2021-02-21,0,0,18942,28,2021-02-21,1613862000.0
6459,11,2,2021-02-22,190,2,19132,30,2021-02-22,1613948400.0
6460,11,2,2021-02-23,142,0,19274,30,2021-02-23,1614034800.0
6461,11,2,2021-02-24,204,2,19478,32,2021-02-24,1614121200.0
6462,11,2,2021-02-25,304,0,19782,32,2021-02-25,1614207600.0
6463,11,2,2021-02-26,200,2,19982,34,2021-02-26,1614294000.0
6464,11,2,2021-02-27,39,0,20021,34,2021-02-27,1614380400.0
6465,11,2,2021-02-28,0,0,20021,34,2021-02-28,1614466800.0
6466,11,2,2021-03-01,1579,4,21600,38,2021-03-01,1614553200.0
6467,11,2,2021-03-02,2201,2,23801,40,2021-03-02,1614639600.0
6468,11,2,2021-03-03,2016,1,25817,41,2021-03-03,1614726000.0
6469,11,2,2021-03-04,2089,12,27906,53,2021-03-04,1614812400.0
6470,11,2,2021-03-05,2156,15,30062,68,2021-03-05,1614898800.0
6471,11,2,2021-03-06,1080,42,31142,110,2021-03-06,1614985200.0
6472,11,2,2021-03-07,228,3,31370,113,2021-03-07,1615071600.0
6473,11,2,2021-03-08,456,2596,31826,2709,2021-03-08,1615158000.0
6474,11,2,2021-03-09,424,3120,32250,5829,2021-03-09,1615244400.0
6475,11,2,2021-03-10,507,3381,32757,9210,2021-03-10,1615330800.0
6476,11,2,2021-03-11,550,3595,33307,12805,2021-03-11,1615417200.0
6477,11,2,2021-03-12,485,3146,33792,15951,2021-03-12,1615503600.0
6478,11,2,2021-03-13,207,909,33999,16860,2021-03-13,1615590000.0
6479,11,2,2021-03-14,27,90,34026,16950,2021-03-14,1615676400.0
6480,11,2,2021-03-15,2649,431,36675,17381,2021-03-15,1615762800.0
6481,11,2,2021-03-16,3281,107,39956,17488,2021-03-16,1615849200.0
6482,11,2,2021-03-17,3581,143,43537,17631,2021-03-17,1615935600.0
6483,11,2,2021-03-18,4887,201,48424,17832,2021-03-18,1616022000.0
6484,11,2,2021-03-19,3458,160,51882,17992,2021-03-19,1616108400.0
6485,11,2,2021-03-20,1340,1,53222,17993,2021-03-20,1616194800.0
6486,11,2,2021-03-21,146,9,53368,18002,2021-03-21,1616281200.0
6487,11,2,2021-03-22,3646,124,57014,18126,2021-03-22,1616367600.0
6488,11,2,2021-03-23,4291,176,61305,18302,2021-03-23,1616454000.0
6489,11,2,2021-03-24,4512,213,65817,18515,2021-03-24,1616540400.0
6490,11,2,2021-03-25,5173,280,70990,18795,2021-03-25,1616626800.0
6491,11,2,2021-03-26,4111,176,75101,18971,2021-03-26,1616713200.0
6492,11,2,2021-03-27,1088,13,76189,18984,2021-03-27,1616799600.0
6493,11,2,2021-03-28,199,18,76388,19002,2021-03-28,1616886000.0
6494,11,2,2021-03-29,3112,1349,79500,20351,2021-03-29,1616972400.0
6495,11,2,2021-03-30,3416,2086,82916,22437,2021-03-30,1617058800.0
6496,11,2,2021-03-31,3284,1861,86200,24298,2021-03-31,1617145200.0
6497,11,2,2021-04-01,2416,2181,88616,26479,2021-04-01,1617231600.0
6498,11,2,2021-04-02,1793,2112,90409,28591,2021-04-02,1617318000.0
6499,11,2,2021-04-03,1576,970,91985,29561,2021-04-03,1617404400.0
6500,11,2,2021-04-04,359,70,92344,29631,2021-04-04,1617490800.0
6501,11,2,2021-04-05,816,3,93160,29634,2021-04-05,1617577200.0
6502,11,2,2021-04-06,5584,617,98744,30251,2021-04-06,1617663600.0
6503,11,2,2021-04-07,7944,603,106688,30854,2021-04-07,1617750000.0
6504,11,2,2021-04-08,7461,435,114149,31289,2021-04-08,1617836400.0
6505,11,2,2021-04-09,7250,415,121399,31704,2021-04-09,1617922800.0
6506,11,2,2021-04-10,4601,250,126000,31954,2021-04-10,1618009200.0
6507,11,2,2021-04-11,842,27,126842,31981,2021-04-11,1618095600.0
6508,11,2,2021-04-12,750,2748,127592,34729,2021-04-12,1618185600.0
6509,11,2,2021-04-13,926,3050,128518,37779,2021-04-13,1618272000.0
6510,11,2,2021-04-14,1375,3604,129893,41383,2021-04-14,1618358400.0
6511,11,2,2021-04-15,1365,4266,131258,45649,2021-04-15,1618444800.0
6512,11,2,2021-04-16,1180,3160,132438,48809,2021-04-16,1618531200.0
6513,11,2,2021-04-17,544,1171,132982,49980,2021-04-17,1618617600.0
6514,11,2,2021-04-18,156,116,133138,50096,2021-04-18,1618704000.0
6515,11,2,2021-04-19,3132,3511,136270,53607,2021-04-19,1618790400.0
6516,11,2,2021-04-20,3441,4153,139711,57760,2021-04-20,1618876800.0
6517,11,2,2021-04-21,2846,4088,142557,61848,2021-04-21,1618963200.0
6518,11,2,2021-04-22,3600,4534,146157,66382,2021-04-22,1619049600.0
6519,11,2,2021-04-23,4093,3639,150250,70021,2021-04-23,1619136000.0
6520,11,2,2021-04-24,13200,1084,163450,71105,2021-04-24,1619222400.0
6521,11,2,2021-04-25,6849,192,170299,71297,2021-04-25,1619308800.0
6522,11,2,2021-04-26,4182,2572,174481,73869,2021-04-26,1619395200.0
6523,11,2,2021-04-27,4383,3034,178864,76903,2021-04-27,1619481600.0
6524,11,2,2021-04-28,4667,3120,183531,80023,2021-04-28,1619568000.0
6525,11,2,2021-04-29,4924,2211,188455,82234,2021-04-29,1619654400.0
6526,11,2,2021-04-30,4885,1968,193340,84202,2021-04-30,1619740800.0
6527,11,2,2021-05-01,2629,595,195969,84797,2021-05-01,1619827200.0
6528,11,2,2021-05-02,1691,497,197660,85294,2021-05-02,1619913600.0
6529,11,2,2021-05-03,3517,2986,201177,88280,2021-05-03,1620000000.0
6530,11,2,2021-05-04,1805,5330,202982,93610,2021-05-04,1620086400.0
6531,11,2,2021-05-05,2521,7221,205503,100831,2021-05-05,1620172800.0
6532,11,2,2021-05-06,2083,7103,207586,107934,2021-05-06,1620259200.0
6533,11,2,2021-05-07,2651,6400,210237,114334,2021-05-07,1620345600.0
6534,11,2,2021-05-08,3160,2034,213397,116368,2021-05-08,1620432000.0
6535,11,2,2021-05-09,1375,769,214772,117137,2021-05-09,1620518400.0
6536,11,2,2021-05-10,6678,1618,221450,118755,2021-05-10,1620604800.0
6537,11,2,2021-05-11,6438,1172,227888,119927,2021-05-11,1620691200.0
6538,11,2,2021-05-12,7993,1153,235881,121080,2021-05-12,1620777600.0
6539,11,2,2021-05-13,8135,207,244016,121287,2021-05-13,1620864000.0
6540,11,2,2021-05-14,10400,780,254416,122067,2021-05-14,1620950400.0
6541,11,2,2021-05-15,8573,289,262989,122356,2021-05-15,1621036800.0
6542,11,2,2021-05-16,5271,52,268260,122408,2021-05-16,1621123200.0
6543,11,2,2021-05-17,5687,507,273947,122915,2021-05-17,1621206000.0
6544,11,2,2021-05-18,7321,428,281268,123343,2021-05-18,1621292400.0
6545,11,2,2021-05-19,10435,585,291703,123928,2021-05-19,1621378800.0
6546,11,2,2021-05-20,11827,495,303530,124423,2021-05-20,1621465200.0
6547,11,2,2021-05-21,12951,721,316481,125144,2021-05-21,1621551600.0
6548,11,2,2021-05-22,12865,197,329346,125341,2021-05-22,1621638000.0
6549,11,2,2021-05-23,6155,44,335501,125385,2021-05-23,1621724400.0
6550,11,2,2021-05-24,2602,109,338103,125494,2021-05-24,1621810800.0
6551,11,2,2021-05-25,1592,890,339695,126384,2021-05-25,1621897200.0
6552,11,2,2021-05-26,1761,1117,341456,127501,2021-05-26,1621983600.0
6553,11,2,2021-05-27,1889,808,343345,128309,2021-05-27,1622070000.0
6554,11,2,2021-05-28,3907,1336,347252,129645,2021-05-28,1622156400.0
6555,11,2,2021-05-29,4499,920,351751,130565,2021-05-29,1622242800.0
6556,11,2,2021-05-30,946,264,352697,130829,2021-05-30,1622329200.0
6557,11,2,2021-05-31,6821,4389,359518,135218,2021-05-31,1622415600.0
6558,11,2,2021-06-01,9408,4006,368926,139224,2021-06-01,1622502000.0
6559,11,2,2021-06-02,7270,2967,376196,142191,2021-06-02,1622588400.0
6560,11,2,2021-06-03,7753,5631,383949,147822,2021-06-03,1622674800.0
6561,11,2,2021-06-04,8981,5332,392930,153154,2021-06-04,1622761200.0
6562,11,2,2021-06-05,6052,13008,398982,166162,2021-06-05,1622847600.0
6563,11,2,2021-06-06,1249,3329,400231,169491,2021-06-06,1622934000.0
6564,11,2,2021-06-07,5735,5411,405966,174902,2021-06-07,1623020400.0
6565,11,2,2021-06-08,8813,4784,414779,179686,2021-06-08,1623106800.0
6566,11,2,2021-06-09,6602,4658,421381,184344,2021-06-09,1623193200.0
6567,11,2,2021-06-10,7472,4622,428853,188966,2021-06-10,1623279600.0
6568,11,2,2021-06-11,7808,5148,436661,194114,2021-06-11,1623366000.0
6569,11,2,2021-06-12,4403,3998,441064,198112,2021-06-12,1623452400.0
6570,11,2,2021-06-13,1230,2538,442294,200650,2021-06-13,1623538800.0
6571,11,2,2021-06-14,4326,4268,446620,204918,2021-06-14,1623625200.0
6572,11,2,2021-06-15,6450,3127,453070,208045,2021-06-15,1623711600.0
6573,11,2,2021-06-16,5064,3388,458134,211433,2021-06-16,1623798000.0
6574,11,2,2021-06-17,5819,2687,463953,214120,2021-06-17,1623884400.0
6575,11,2,2021-06-18,6111,3859,470064,217979,2021-06-18,1623970800.0
6576,11,2,2021-06-19,3995,3151,474059,221130,2021-06-19,1624057200.0
6577,11,2,2021-06-20,1300,1109,475359,222239,2021-06-20,1624143600.0
6578,11,2,2021-06-21,2800,7633,478159,229872,2021-06-21,1624230000.0
6579,11,2,2021-06-22,4266,8330,482425,238202,2021-06-22,1624316400.0
6580,11,2,2021-06-23,3299,8829,485724,247031,2021-06-23,1624402800.0
6581,11,2,2021-06-24,3989,10693,489713,257724,2021-06-24,1624489200.0
6582,11,2,2021-06-25,3687,9627,493400,267351,2021-06-25,1624575600.0
6583,11,2,2021-06-26,2255,7849,495655,275200,2021-06-26,1624662000.0
6584,11,2,2021-06-27,982,1683,496637,276883,2021-06-27,1624748400.0
6585,11,2,2021-06-28,2149,8156,498786,285039,2021-06-28,1624834800.0
6586,11,2,2021-06-29,2593,8801,501379,293840,2021-06-29,1624921200.0
6587,11,2,2021-06-30,2198,10825,503577,304665,2021-06-30,1625007600.0
6588,11,2,2021-07-01,2961,11578,506538,316243,2021-07-01,1625094000.0
6589,11,2,2021-07-02,2921,11642,509459,327885,2021-07-02,1625180400.0
6590,11,2,2021-07-03,1875,11868,511334,339753,2021-07-03,1625266800.0
6591,11,2,2021-07-04,773,4635,512107,344388,2021-07-04,1625353200.0
6592,11,2,2021-07-05,1522,4884,513629,349272,2021-07-05,1625439600.0
6593,11,2,2021-07-06,2318,5618,515947,354890,2021-07-06,1625526000.0
6594,11,2,2021-07-07,2091,5436,518038,360326,2021-07-07,1625612400.0
6595,11,2,2021-07-08,3101,6656,521139,366982,2021-07-08,1625698800.0
6596,11,3,2020-12-27,0,0,0,0,2020-12-27,1609023600.0
6597,11,3,2020-12-28,0,0,0,0,2020-12-28,1609110000.0
6598,11,3,2020-12-29,0,0,0,0,2020-12-29,1609196400.0
6599,11,3,2020-12-30,0,0,0,0,2020-12-30,1609282800.0
6600,11,3,2020-12-31,0,0,0,0,2020-12-31,1609369200.0
6601,11,3,2021-01-01,0,0,0,0,2021-01-01,1609455600.0
6602,11,3,2021-01-02,0,0,0,0,2021-01-02,1609542000.0
6603,11,3,2021-01-03,0,0,0,0,2021-01-03,1609628400.0
6604,11,3,2021-01-04,0,0,0,0,2021-01-04,1609714800.0
6605,11,3,2021-01-05,0,0,0,0,2021-01-05,1609801200.0
6606,11,3,2021-01-06,0,0,0,0,2021-01-06,1609887600.0
6607,11,3,2021-01-07,0,0,0,0,2021-01-07,1609974000.0
6608,11,3,2021-01-08,0,0,0,0,2021-01-08,1610060400.0
6609,11,3,2021-01-09,0,0,0,0,2021-01-09,1610146800.0
6610,11,3,2021-01-10,0,0,0,0,2021-01-10,1610233200.0
6611,11,3,2021-01-11,0,0,0,0,2021-01-11,1610319600.0
6612,11,3,2021-01-12,0,0,0,0,2021-01-12,1610406000.0
6613,11,3,2021-01-13,0,0,0,0,2021-01-13,1610492400.0
6614,11,3,2021-01-14,0,0,0,0,2021-01-14,1610578800.0
6615,11,3,2021-01-15,0,0,0,0,2021-01-15,1610665200.0
6616,11,3,2021-01-16,0,0,0,0,2021-01-16,1610751600.0
6617,11,3,2021-01-17,0,0,0,0,2021-01-17,1610838000.0
6618,11,3,2021-01-18,0,0,0,0,2021-01-18,1610924400.0
6619,11,3,2021-01-19,0,0,0,0,2021-01-19,1611010800.0
6620,11,3,2021-01-20,0,0,0,0,2021-01-20,1611097200.0
6621,11,3,2021-01-21,0,0,0,0,2021-01-21,1611183600.0
6622,11,3,2021-01-22,0,0,0,0,2021-01-22,1611270000.0
6623,11,3,2021-01-23,0,0,0,0,2021-01-23,1611356400.0
6624,11,3,2021-01-24,0,0,0,0,2021-01-24,1611442800.0
6625,11,3,2021-01-25,0,0,0,0,2021-01-25,1611529200.0
6626,11,3,2021-01-26,0,0,0,0,2021-01-26,1611615600.0
6627,11,3,2021-01-27,0,0,0,0,2021-01-27,1611702000.0
6628,11,3,2021-01-28,0,0,0,0,2021-01-28,1611788400.0
6629,11,3,2021-01-29,0,0,0,0,2021-01-29,1611874800.0
6630,11,3,2021-01-30,0,0,0,0,2021-01-30,1611961200.0
6631,11,3,2021-01-31,0,0,0,0,2021-01-31,1612047600.0
6632,11,3,2021-02-01,0,0,0,0,2021-02-01,1612134000.0
6633,11,3,2021-02-02,0,0,0,0,2021-02-02,1612220400.0
6634,11,3,2021-02-03,0,0,0,0,2021-02-03,1612306800.0
6635,11,3,2021-02-04,0,0,0,0,2021-02-04,1612393200.0
6636,11,3,2021-02-05,0,0,0,0,2021-02-05,1612479600.0
6637,11,3,2021-02-06,27,0,27,0,2021-02-06,1612566000.0
6638,11,3,2021-02-07,156,0,183,0,2021-02-07,1612652400.0
6639,11,3,2021-02-08,348,0,531,0,2021-02-08,1612738800.0
6640,11,3,2021-02-09,1367,0,1898,0,2021-02-09,1612825200.0
6641,11,3,2021-02-10,2044,0,3942,0,2021-02-10,1612911600.0
6642,11,3,2021-02-11,2800,0,6742,0,2021-02-11,1612998000.0
6643,11,3,2021-02-12,2504,0,9246,0,2021-02-12,1613084400.0
6644,11,3,2021-02-13,352,0,9598,0,2021-02-13,1613170800.0
6645,11,3,2021-02-14,103,0,9701,0,2021-02-14,1613257200.0
6646,11,3,2021-02-15,2003,0,11704,0,2021-02-15,1613343600.0
6647,11,3,2021-02-16,2551,0,14255,0,2021-02-16,1613430000.0
6648,11,3,2021-02-17,1975,0,16230,0,2021-02-17,1613516400.0
6649,11,3,2021-02-18,2353,0,18583,0,2021-02-18,1613602800.0
6650,11,3,2021-02-19,2063,0,20646,0,2021-02-19,1613689200.0
6651,11,3,2021-02-20,289,0,20935,0,2021-02-20,1613775600.0
6652,11,3,2021-02-21,46,0,20981,0,2021-02-21,1613862000.0
6653,11,3,2021-02-22,1549,0,22530,0,2021-02-22,1613948400.0
6654,11,3,2021-02-23,1624,0,24154,0,2021-02-23,1614034800.0
6655,11,3,2021-02-24,2123,0,26277,0,2021-02-24,1614121200.0
6656,11,3,2021-02-25,5033,0,31310,0,2021-02-25,1614207600.0
6657,11,3,2021-02-26,6425,0,37735,0,2021-02-26,1614294000.0
6658,11,3,2021-02-27,3998,0,41733,0,2021-02-27,1614380400.0
6659,11,3,2021-02-28,658,0,42391,0,2021-02-28,1614466800.0
6660,11,3,2021-03-01,3573,3,45964,3,2021-03-01,1614553200.0
6661,11,3,2021-03-02,6257,3,52221,6,2021-03-02,1614639600.0
6662,11,3,2021-03-03,8338,5,60559,11,2021-03-03,1614726000.0
6663,11,3,2021-03-04,14626,4,75185,15,2021-03-04,1614812400.0
6664,11,3,2021-03-05,22141,25,97326,40,2021-03-05,1614898800.0
6665,11,3,2021-03-06,18113,11,115439,51,2021-03-06,1614985200.0
6666,11,3,2021-03-07,7250,1,122689,52,2021-03-07,1615071600.0
6667,11,3,2021-03-08,8188,7,130877,59,2021-03-08,1615158000.0
6668,11,3,2021-03-09,12473,7,143350,66,2021-03-09,1615244400.0
6669,11,3,2021-03-10,13001,2,156351,68,2021-03-10,1615330800.0
6670,11,3,2021-03-11,19723,10,176074,78,2021-03-11,1615417200.0
6671,11,3,2021-03-12,26905,14,202979,92,2021-03-12,1615503600.0
6672,11,3,2021-03-13,19686,3,222665,95,2021-03-13,1615590000.0
6673,11,3,2021-03-14,3774,1,226439,96,2021-03-14,1615676400.0
6674,11,3,2021-03-15,12081,11,238520,107,2021-03-15,1615762800.0
6675,11,3,2021-03-16,182,1,238702,108,2021-03-16,1615849200.0
6676,11,3,2021-03-17,126,1,238828,109,2021-03-17,1615935600.0
6677,11,3,2021-03-18,300,0,239128,109,2021-03-18,1616022000.0
6678,11,3,2021-03-19,11356,7,250484,116,2021-03-19,1616108400.0
6679,11,3,2021-03-20,10425,6,260909,122,2021-03-20,1616194800.0
6680,11,3,2021-03-21,1654,3,262563,125,2021-03-21,1616281200.0
6681,11,3,2021-03-22,9049,9,271612,134,2021-03-22,1616367600.0
6682,11,3,2021-03-23,15582,16,287194,150,2021-03-23,1616454000.0
6683,11,3,2021-03-24,14922,15,302116,165,2021-03-24,1616540400.0
6684,11,3,2021-03-25,22821,16,324937,181,2021-03-25,1616626800.0
6685,11,3,2021-03-26,23120,21,348057,202,2021-03-26,1616713200.0
6686,11,3,2021-03-27,11058,7,359115,209,2021-03-27,1616799600.0
6687,11,3,2021-03-28,1735,3,360850,212,2021-03-28,1616886000.0
6688,11,3,2021-03-29,9008,13,369858,225,2021-03-29,1616972400.0
6689,11,3,2021-03-30,14207,21,384065,246,2021-03-30,1617058800.0
6690,11,3,2021-03-31,9542,11,393607,257,2021-03-31,1617145200.0
6691,11,3,2021-04-01,12444,11,406051,268,2021-04-01,1617231600.0
6692,11,3,2021-04-02,11866,32,417917,300,2021-04-02,1617318000.0
6693,11,3,2021-04-03,5542,29,423459,329,2021-04-03,1617404400.0
6694,11,3,2021-04-04,943,3,424402,332,2021-04-04,1617490800.0
6695,11,3,2021-04-05,649,0,425051,332,2021-04-05,1617577200.0
6696,11,3,2021-04-06,4700,17,429751,349,2021-04-06,1617663600.0
6697,11,3,2021-04-07,4775,8,434526,357,2021-04-07,1617750000.0
6698,11,3,2021-04-08,9008,38,443534,395,2021-04-08,1617836400.0
6699,11,3,2021-04-09,18291,62,461825,457,2021-04-09,1617922800.0
6700,11,3,2021-04-10,9764,59,471589,516,2021-04-10,1618009200.0
6701,11,3,2021-04-11,1097,6,472686,522,2021-04-11,1618095600.0
6702,11,3,2021-04-12,7438,65,480124,587,2021-04-12,1618185600.0
6703,11,3,2021-04-13,11433,88,491557,675,2021-04-13,1618272000.0
6704,11,3,2021-04-14,9517,91,501074,766,2021-04-14,1618358400.0
6705,11,3,2021-04-15,12663,83,513737,849,2021-04-15,1618444800.0
6706,11,3,2021-04-16,14378,91,528115,940,2021-04-16,1618531200.0
6707,11,3,2021-04-17,7054,53,535169,993,2021-04-17,1618617600.0
6708,11,3,2021-04-18,1910,15,537079,1008,2021-04-18,1618704000.0
6709,11,3,2021-04-19,3753,41,540832,1049,2021-04-19,1618790400.0
6710,11,3,2021-04-20,6103,83,546935,1132,2021-04-20,1618876800.0
6711,11,3,2021-04-21,5465,109,552400,1241,2021-04-21,1618963200.0
6712,11,3,2021-04-22,6183,134,558583,1375,2021-04-22,1619049600.0
6713,11,3,2021-04-23,7628,136,566211,1511,2021-04-23,1619136000.0
6714,11,3,2021-04-24,4613,120,570824,1631,2021-04-24,1619222400.0
6715,11,3,2021-04-25,1771,70,572595,1701,2021-04-25,1619308800.0
6716,11,3,2021-04-26,2878,108,575473,1809,2021-04-26,1619395200.0
6717,11,3,2021-04-27,4392,172,579865,1981,2021-04-27,1619481600.0
6718,11,3,2021-04-28,3830,240,583695,2221,2021-04-28,1619568000.0
6719,11,3,2021-04-29,5093,641,588788,2862,2021-04-29,1619654400.0
6720,11,3,2021-04-30,6496,844,595284,3706,2021-04-30,1619740800.0
6721,11,3,2021-05-01,1515,288,596799,3994,2021-05-01,1619827200.0
6722,11,3,2021-05-02,778,182,597577,4176,2021-05-02,1619913600.0
6723,11,3,2021-05-03,1823,824,599400,5000,2021-05-03,1620000000.0
6724,11,3,2021-05-04,2886,2062,602286,7062,2021-05-04,1620086400.0
6725,11,3,2021-05-05,2505,1728,604791,8790,2021-05-05,1620172800.0
6726,11,3,2021-05-06,3652,3044,608443,11834,2021-05-06,1620259200.0
6727,11,3,2021-05-07,4872,4088,613315,15922,2021-05-07,1620345600.0
6728,11,3,2021-05-08,836,2454,614151,18376,2021-05-08,1620432000.0
6729,11,3,2021-05-09,377,567,614528,18943,2021-05-09,1620518400.0
6730,11,3,2021-05-10,1942,2342,616470,21285,2021-05-10,1620604800.0
6731,11,3,2021-05-11,2967,3669,619437,24954,2021-05-11,1620691200.0
6732,11,3,2021-05-12,1922,3826,621359,28780,2021-05-12,1620777600.0
6733,11,3,2021-05-13,291,462,621650,29242,2021-05-13,1620864000.0
6734,11,3,2021-05-14,1589,3520,623239,32762,2021-05-14,1620950400.0
6735,11,3,2021-05-15,865,2881,624104,35643,2021-05-15,1621036800.0
6736,11,3,2021-05-16,151,558,624255,36201,2021-05-16,1621123200.0
6737,11,3,2021-05-17,961,3177,625216,39378,2021-05-17,1621206000.0
6738,11,3,2021-05-18,1351,4128,626567,43506,2021-05-18,1621292400.0
6739,11,3,2021-05-19,1106,6036,627673,49542,2021-05-19,1621378800.0
6740,11,3,2021-05-20,1414,6763,629087,56305,2021-05-20,1621465200.0
6741,11,3,2021-05-21,1320,8178,630407,64483,2021-05-21,1621551600.0
6742,11,3,2021-05-22,602,4486,631009,68969,2021-05-22,1621638000.0
6743,11,3,2021-05-23,67,757,631076,69726,2021-05-23,1621724400.0
6744,11,3,2021-05-24,180,832,631256,70558,2021-05-24,1621810800.0
6745,11,3,2021-05-25,781,8643,632037,79201,2021-05-25,1621897200.0
6746,11,3,2021-05-26,727,7808,632764,87009,2021-05-26,1621983600.0
6747,11,3,2021-05-27,865,11177,633629,98186,2021-05-27,1622070000.0
6748,11,3,2021-05-28,905,13468,634534,111654,2021-05-28,1622156400.0
6749,11,3,2021-05-29,455,8463,634989,120117,2021-05-29,1622242800.0
6750,11,3,2021-05-30,75,1807,635064,121924,2021-05-30,1622329200.0
6751,11,3,2021-05-31,370,5934,635434,127858,2021-05-31,1622415600.0
6752,11,3,2021-06-01,414,9452,635848,137310,2021-06-01,1622502000.0
6753,11,3,2021-06-02,413,8154,636261,145464,2021-06-02,1622588400.0
6754,11,3,2021-06-03,538,12171,636799,157635,2021-06-03,1622674800.0
6755,11,3,2021-06-04,559,13989,637358,171624,2021-06-04,1622761200.0
6756,11,3,2021-06-05,255,7635,637613,179259,2021-06-05,1622847600.0
6757,11,3,2021-06-06,61,1371,637674,180630,2021-06-06,1622934000.0
6758,11,3,2021-06-07,263,5494,637937,186124,2021-06-07,1623020400.0
6759,11,3,2021-06-08,285,7006,638222,193130,2021-06-08,1623106800.0
6760,11,3,2021-06-09,281,6597,638503,199727,2021-06-09,1623193200.0
6761,11,3,2021-06-10,292,10645,638795,210372,2021-06-10,1623279600.0
6762,11,3,2021-06-11,351,12508,639146,222880,2021-06-11,1623366000.0
6763,11,3,2021-06-12,174,6143,639320,229023,2021-06-12,1623452400.0
6764,11,3,2021-06-13,20,931,639340,229954,2021-06-13,1623538800.0
6765,11,3,2021-06-14,175,6559,639515,236513,2021-06-14,1623625200.0
6766,11,3,2021-06-15,217,12266,639732,248779,2021-06-15,1623711600.0
6767,11,3,2021-06-16,205,9407,639937,258186,2021-06-16,1623798000.0
6768,11,3,2021-06-17,259,13034,640196,271220,2021-06-17,1623884400.0
6769,11,3,2021-06-18,273,14572,640469,285792,2021-06-18,1623970800.0
6770,11,3,2021-06-19,135,5862,640604,291654,2021-06-19,1624057200.0
6771,11,3,2021-06-20,28,896,640632,292550,2021-06-20,1624143600.0
6772,11,3,2021-06-21,135,5789,640767,298339,2021-06-21,1624230000.0
6773,11,3,2021-06-22,188,9486,640955,307825,2021-06-22,1624316400.0
6774,11,3,2021-06-23,167,6897,641122,314722,2021-06-23,1624402800.0
6775,11,3,2021-06-24,212,9578,641334,324300,2021-06-24,1624489200.0
6776,11,3,2021-06-25,221,11153,641555,335453,2021-06-25,1624575600.0
6777,11,3,2021-06-26,99,5061,641654,340514,2021-06-26,1624662000.0
6778,11,3,2021-06-27,22,855,641676,341369,2021-06-27,1624748400.0
6779,11,3,2021-06-28,137,4801,641813,346170,2021-06-28,1624834800.0
6780,11,3,2021-06-29,128,7261,641941,353431,2021-06-29,1624921200.0
6781,11,3,2021-06-30,139,5998,642080,359429,2021-06-30,1625007600.0
6782,11,3,2021-07-01,208,7329,642288,366758,2021-07-01,1625094000.0
6783,11,3,2021-07-02,201,9507,642489,376265,2021-07-02,1625180400.0
6784,11,3,2021-07-03,104,3856,642593,380121,2021-07-03,1625266800.0
6785,11,3,2021-07-04,7,669,642600,380790,2021-07-04,1625353200.0
6786,11,3,2021-07-05,123,4039,642723,384829,2021-07-05,1625439600.0
6787,11,3,2021-07-06,136,6380,642859,391209,2021-07-06,1625526000.0
6788,11,3,2021-07-07,146,4865,643005,396074,2021-07-07,1625612400.0
6789,11,3,2021-07-08,167,6465,643172,402539,2021-07-08,1625698800.0
6790,11,4,2020-12-27,0,0,0,0,2020-12-27,1609023600.0
6791,11,4,2020-12-28,0,0,0,0,2020-12-28,1609110000.0
6792,11,4,2020-12-29,0,0,0,0,2020-12-29,1609196400.0
6793,11,4,2020-12-30,0,0,0,0,2020-12-30,1609282800.0
6794,11,4,2020-12-31,0,0,0,0,2020-12-31,1609369200.0
6795,11,4,2021-01-01,0,0,0,0,2021-01-01,1609455600.0
6796,11,4,2021-01-02,0,0,0,0,2021-01-02,1609542000.0
6797,11,4,2021-01-03,0,0,0,0,2021-01-03,1609628400.0
6798,11,4,2021-01-04,0,0,0,0,2021-01-04,1609714800.0
6799,11,4,2021-01-05,0,0,0,0,2021-01-05,1609801200.0
6800,11,4,2021-01-06,0,0,0,0,2021-01-06,1609887600.0
6801,11,4,2021-01-07,0,0,0,0,2021-01-07,1609974000.0
6802,11,4,2021-01-08,0,0,0,0,2021-01-08,1610060400.0
6803,11,4,2021-01-09,0,0,0,0,2021-01-09,1610146800.0
6804,11,4,2021-01-10,0,0,0,0,2021-01-10,1610233200.0
6805,11,4,2021-01-11,0,0,0,0,2021-01-11,1610319600.0
6806,11,4,2021-01-12,0,0,0,0,2021-01-12,1610406000.0
6807,11,4,2021-01-13,0,0,0,0,2021-01-13,1610492400.0
6808,11,4,2021-01-14,0,0,0,0,2021-01-14,1610578800.0
6809,11,4,2021-01-15,0,0,0,0,2021-01-15,1610665200.0
6810,11,4,2021-01-16,0,0,0,0,2021-01-16,1610751600.0
6811,11,4,2021-01-17,0,0,0,0,2021-01-17,1610838000.0
6812,11,4,2021-01-18,0,0,0,0,2021-01-18,1610924400.0
6813,11,4,2021-01-19,0,0,0,0,2021-01-19,1611010800.0
6814,11,4,2021-01-20,0,0,0,0,2021-01-20,1611097200.0
6815,11,4,2021-01-21,0,0,0,0,2021-01-21,1611183600.0
6816,11,4,2021-01-22,0,0,0,0,2021-01-22,1611270000.0
6817,11,4,2021-01-23,0,0,0,0,2021-01-23,1611356400.0
6818,11,4,2021-01-24,0,0,0,0,2021-01-24,1611442800.0
6819,11,4,2021-01-25,0,0,0,0,2021-01-25,1611529200.0
6820,11,4,2021-01-26,0,0,0,0,2021-01-26,1611615600.0
6821,11,4,2021-01-27,0,0,0,0,2021-01-27,1611702000.0
6822,11,4,2021-01-28,0,0,0,0,2021-01-28,1611788400.0
6823,11,4,2021-01-29,0,0,0,0,2021-01-29,1611874800.0
6824,11,4,2021-01-30,0,0,0,0,2021-01-30,1611961200.0
6825,11,4,2021-01-31,0,0,0,0,2021-01-31,1612047600.0
6826,11,4,2021-02-01,0,0,0,0,2021-02-01,1612134000.0
6827,11,4,2021-02-02,0,0,0,0,2021-02-02,1612220400.0
6828,11,4,2021-02-03,0,0,0,0,2021-02-03,1612306800.0
6829,11,4,2021-02-04,0,0,0,0,2021-02-04,1612393200.0
6830,11,4,2021-02-05,0,0,0,0,2021-02-05,1612479600.0
6831,11,4,2021-02-06,0,0,0,0,2021-02-06,1612566000.0
6832,11,4,2021-02-07,0,0,0,0,2021-02-07,1612652400.0
6833,11,4,2021-02-08,0,0,0,0,2021-02-08,1612738800.0
6834,11,4,2021-02-09,0,0,0,0,2021-02-09,1612825200.0
6835,11,4,2021-02-10,0,0,0,0,2021-02-10,1612911600.0
6836,11,4,2021-02-11,0,0,0,0,2021-02-11,1612998000.0
6837,11,4,2021-02-12,0,0,0,0,2021-02-12,1613084400.0
6838,11,4,2021-02-13,0,0,0,0,2021-02-13,1613170800.0
6839,11,4,2021-02-14,0,0,0,0,2021-02-14,1613257200.0
6840,11,4,2021-02-15,0,0,0,0,2021-02-15,1613343600.0
6841,11,4,2021-02-16,0,0,0,0,2021-02-16,1613430000.0
6842,11,4,2021-02-17,0,0,0,0,2021-02-17,1613516400.0
6843,11,4,2021-02-18,0,0,0,0,2021-02-18,1613602800.0
6844,11,4,2021-02-19,0,0,0,0,2021-02-19,1613689200.0
6845,11,4,2021-02-20,0,0,0,0,2021-02-20,1613775600.0
6846,11,4,2021-02-21,0,0,0,0,2021-02-21,1613862000.0
6847,11,4,2021-02-22,0,0,0,0,2021-02-22,1613948400.0
6848,11,4,2021-02-23,0,0,0,0,2021-02-23,1614034800.0
6849,11,4,2021-02-24,0,0,0,0,2021-02-24,1614121200.0
6850,11,4,2021-02-25,0,0,0,0,2021-02-25,1614207600.0
6851,11,4,2021-02-26,0,0,0,0,2021-02-26,1614294000.0
6852,11,4,2021-02-27,0,0,0,0,2021-02-27,1614380400.0
6853,11,4,2021-02-28,0,0,0,0,2021-02-28,1614466800.0
6854,11,4,2021-03-01,0,0,0,0,2021-03-01,1614553200.0
6855,11,4,2021-03-02,0,0,0,0,2021-03-02,1614639600.0
6856,11,4,2021-03-03,0,0,0,0,2021-03-03,1614726000.0
6857,11,4,2021-03-04,0,0,0,0,2021-03-04,1614812400.0
6858,11,4,2021-03-05,0,0,0,0,2021-03-05,1614898800.0
6859,11,4,2021-03-06,0,0,0,0,2021-03-06,1614985200.0
6860,11,4,2021-03-07,0,0,0,0,2021-03-07,1615071600.0
6861,11,4,2021-03-08,0,0,0,0,2021-03-08,1615158000.0
6862,11,4,2021-03-09,0,0,0,0,2021-03-09,1615244400.0
6863,11,4,2021-03-10,0,0,0,0,2021-03-10,1615330800.0
6864,11,4,2021-03-11,0,0,0,0,2021-03-11,1615417200.0
6865,11,4,2021-03-12,0,0,0,0,2021-03-12,1615503600.0
6866,11,4,2021-03-13,0,0,0,0,2021-03-13,1615590000.0
6867,11,4,2021-03-14,0,0,0,0,2021-03-14,1615676400.0
6868,11,4,2021-03-15,0,0,0,0,2021-03-15,1615762800.0
6869,11,4,2021-03-16,0,0,0,0,2021-03-16,1615849200.0
6870,11,4,2021-03-17,0,0,0,0,2021-03-17,1615935600.0
6871,11,4,2021-03-18,0,0,0,0,2021-03-18,1616022000.0
6872,11,4,2021-03-19,0,0,0,0,2021-03-19,1616108400.0
6873,11,4,2021-03-20,0,0,0,0,2021-03-20,1616194800.0
6874,11,4,2021-03-21,0,0,0,0,2021-03-21,1616281200.0
6875,11,4,2021-03-22,0,0,0,0,2021-03-22,1616367600.0
6876,11,4,2021-03-23,0,0,0,0,2021-03-23,1616454000.0
6877,11,4,2021-03-24,0,0,0,0,2021-03-24,1616540400.0
6878,11,4,2021-03-25,0,0,0,0,2021-03-25,1616626800.0
6879,11,4,2021-03-26,0,0,0,0,2021-03-26,1616713200.0
6880,11,4,2021-03-27,0,0,0,0,2021-03-27,1616799600.0
6881,11,4,2021-03-28,0,0,0,0,2021-03-28,1616886000.0
6882,11,4,2021-03-29,0,0,0,0,2021-03-29,1616972400.0
6883,11,4,2021-03-30,0,0,0,0,2021-03-30,1617058800.0
6884,11,4,2021-03-31,0,0,0,0,2021-03-31,1617145200.0
6885,11,4,2021-04-01,0,0,0,0,2021-04-01,1617231600.0
6886,11,4,2021-04-02,0,0,0,0,2021-04-02,1617318000.0
6887,11,4,2021-04-03,0,0,0,0,2021-04-03,1617404400.0
6888,11,4,2021-04-04,0,0,0,0,2021-04-04,1617490800.0
6889,11,4,2021-04-05,0,0,0,0,2021-04-05,1617577200.0
6890,11,4,2021-04-06,0,0,0,0,2021-04-06,1617663600.0
6891,11,4,2021-04-07,0,0,0,0,2021-04-07,1617750000.0
6892,11,4,2021-04-08,0,0,0,0,2021-04-08,1617836400.0
6893,11,4,2021-04-09,0,0,0,0,2021-04-09,1617922800.0
6894,11,4,2021-04-10,0,0,0,0,2021-04-10,1618009200.0
6895,11,4,2021-04-11,0,0,0,0,2021-04-11,1618095600.0
6896,11,4,2021-04-12,0,0,0,0,2021-04-12,1618185600.0
6897,11,4,2021-04-13,0,0,0,0,2021-04-13,1618272000.0
6898,11,4,2021-04-14,0,0,0,0,2021-04-14,1618358400.0
6899,11,4,2021-04-15,0,0,0,0,2021-04-15,1618444800.0
6900,11,4,2021-04-16,0,0,0,0,2021-04-16,1618531200.0
6901,11,4,2021-04-17,0,0,0,0,2021-04-17,1618617600.0
6902,11,4,2021-04-18,0,0,0,0,2021-04-18,1618704000.0
6903,11,4,2021-04-19,0,0,0,0,2021-04-19,1618790400.0
6904,11,4,2021-04-20,0,0,0,0,2021-04-20,1618876800.0
6905,11,4,2021-04-21,0,0,0,0,2021-04-21,1618963200.0
6906,11,4,2021-04-22,0,0,0,0,2021-04-22,1619049600.0
6907,11,4,2021-04-23,273,0,273,0,2021-04-23,1619136000.0
6908,11,4,2021-04-24,462,0,735,0,2021-04-24,1619222400.0
6909,11,4,2021-04-25,68,0,803,0,2021-04-25,1619308800.0
6910,11,4,2021-04-26,690,0,1493,0,2021-04-26,1619395200.0
6911,11,4,2021-04-27,1400,0,2893,0,2021-04-27,1619481600.0
6912,11,4,2021-04-28,1451,0,4344,0,2021-04-28,1619568000.0
6913,11,4,2021-04-29,1844,2,6188,2,2021-04-29,1619654400.0
6914,11,4,2021-04-30,1882,0,8070,2,2021-04-30,1619740800.0
6915,11,4,2021-05-01,137,3,8207,5,2021-05-01,1619827200.0
6916,11,4,2021-05-02,48,0,8255,5,2021-05-02,1619913600.0
6917,11,4,2021-05-03,594,0,8849,5,2021-05-03,1620000000.0
6918,11,4,2021-05-04,795,0,9644,5,2021-05-04,1620086400.0
6919,11,4,2021-05-05,801,2,10445,7,2021-05-05,1620172800.0
6920,11,4,2021-05-06,1190,0,11635,7,2021-05-06,1620259200.0
6921,11,4,2021-05-07,1843,1,13478,8,2021-05-07,1620345600.0
6922,11,4,2021-05-08,313,0,13791,8,2021-05-08,1620432000.0
6923,11,4,2021-05-09,294,0,14085,8,2021-05-09,1620518400.0
6924,11,4,2021-05-10,892,1,14977,9,2021-05-10,1620604800.0
6925,11,4,2021-05-11,1646,2,16623,11,2021-05-11,1620691200.0
6926,11,4,2021-05-12,1228,2,17851,13,2021-05-12,1620777600.0
6927,11,4,2021-05-13,423,1,18274,14,2021-05-13,1620864000.0
6928,11,4,2021-05-14,749,4,19023,18,2021-05-14,1620950400.0
6929,11,4,2021-05-15,484,5,19507,23,2021-05-15,1621036800.0
6930,11,4,2021-05-16,50,0,19557,23,2021-05-16,1621123200.0
6931,11,4,2021-05-17,535,0,20092,23,2021-05-17,1621206000.0
6932,11,4,2021-05-18,1054,2,21146,25,2021-05-18,1621292400.0
6933,11,4,2021-05-19,758,3,21904,28,2021-05-19,1621378800.0
6934,11,4,2021-05-20,1104,1,23008,29,2021-05-20,1621465200.0
6935,11,4,2021-05-21,1241,3,24249,32,2021-05-21,1621551600.0
6936,11,4,2021-05-22,632,0,24881,32,2021-05-22,1621638000.0
6937,11,4,2021-05-23,92,0,24973,32,2021-05-23,1621724400.0
6938,11,4,2021-05-24,201,3,25174,35,2021-05-24,1621810800.0
6939,11,4,2021-05-25,808,0,25982,35,2021-05-25,1621897200.0
6940,11,4,2021-05-26,981,1,26963,36,2021-05-26,1621983600.0
6941,11,4,2021-05-27,1618,1,28581,37,2021-05-27,1622070000.0
6942,11,4,2021-05-28,2810,28,31391,65,2021-05-28,1622156400.0
6943,11,4,2021-05-29,1558,2,32949,67,2021-05-29,1622242800.0
6944,11,4,2021-05-30,268,1,33217,68,2021-05-30,1622329200.0
6945,11,4,2021-05-31,1567,3,34784,71,2021-05-31,1622415600.0
6946,11,4,2021-06-01,2298,14,37082,85,2021-06-01,1622502000.0
6947,11,4,2021-06-02,1889,14,38971,99,2021-06-02,1622588400.0
6948,11,4,2021-06-03,2178,4,41149,103,2021-06-03,1622674800.0
6949,11,4,2021-06-04,2269,6,43418,109,2021-06-04,1622761200.0
6950,11,4,2021-06-05,1246,3,44664,112,2021-06-05,1622847600.0
6951,11,4,2021-06-06,225,0,44889,112,2021-06-06,1622934000.0
6952,11,4,2021-06-07,1204,0,46093,112,2021-06-07,1623020400.0
6953,11,4,2021-06-08,1645,4,47738,116,2021-06-08,1623106800.0
6954,11,4,2021-06-09,1534,8,49272,124,2021-06-09,1623193200.0
6955,11,4,2021-06-10,1818,4,51090,128,2021-06-10,1623279600.0
6956,11,4,2021-06-11,1802,6,52892,134,2021-06-11,1623366000.0
6957,11,4,2021-06-12,1065,6,53957,140,2021-06-12,1623452400.0
6958,11,4,2021-06-13,234,0,54191,140,2021-06-13,1623538800.0
6959,11,4,2021-06-14,899,5,55090,145,2021-06-14,1623625200.0
6960,11,4,2021-06-15,1363,5,56453,150,2021-06-15,1623711600.0
6961,11,4,2021-06-16,1221,2,57674,152,2021-06-16,1623798000.0
6962,11,4,2021-06-17,1370,2,59044,154,2021-06-17,1623884400.0
6963,11,4,2021-06-18,1431,5,60475,159,2021-06-18,1623970800.0
6964,11,4,2021-06-19,748,6,61223,165,2021-06-19,1624057200.0
6965,11,4,2021-06-20,163,2,61386,167,2021-06-20,1624143600.0
6966,11,4,2021-06-21,672,3,62058,170,2021-06-21,1624230000.0
6967,11,4,2021-06-22,877,4,62935,174,2021-06-22,1624316400.0
6968,11,4,2021-06-23,938,4,63873,178,2021-06-23,1624402800.0
6969,11,4,2021-06-24,1068,4,64941,182,2021-06-24,1624489200.0
6970,11,4,2021-06-25,1135,7,66076,189,2021-06-25,1624575600.0
6971,11,4,2021-06-26,571,0,66647,189,2021-06-26,1624662000.0
6972,11,4,2021-06-27,147,0,66794,189,2021-06-27,1624748400.0
6973,11,4,2021-06-28,722,3,67516,192,2021-06-28,1624834800.0
6974,11,4,2021-06-29,876,2,68392,194,2021-06-29,1624921200.0
6975,11,4,2021-06-30,734,12,69126,206,2021-06-30,1625007600.0
6976,11,4,2021-07-01,890,3,70016,209,2021-07-01,1625094000.0
6977,11,4,2021-07-02,940,8,70956,217,2021-07-02,1625180400.0
6978,11,4,2021-07-03,655,5,71611,222,2021-07-03,1625266800.0
6979,11,4,2021-07-04,113,0,71724,222,2021-07-04,1625353200.0
6980,11,4,2021-07-05,556,2,72280,224,2021-07-05,1625439600.0
6981,11,4,2021-07-06,803,4,73083,228,2021-07-06,1625526000.0
6982,11,4,2021-07-07,921,7,74004,235,2021-07-07,1625612400.0
6983,11,4,2021-07-08,904,1,74908,236,2021-07-08,1625698800.0
6984,24,1,2020-12-27,0,0,0,0,2020-12-27,1609023600.0
6985,24,1,2020-12-28,17,0,17,0,2020-12-28,1609110000.0
6986,24,1,2020-12-29,10,0,27,0,2020-12-29,1609196400.0
6987,24,1,2020-12-30,1,0,28,0,2020-12-30,1609282800.0
6988,24,1,2020-12-31,0,0,28,0,2020-12-31,1609369200.0
6989,24,1,2021-01-01,1,0,29,0,2021-01-01,1609455600.0
6990,24,1,2021-01-02,0,0,29,0,2021-01-02,1609542000.0
6991,24,1,2021-01-03,0,0,29,0,2021-01-03,1609628400.0
6992,24,1,2021-01-04,24,0,53,0,2021-01-04,1609714800.0
6993,24,1,2021-01-05,163,0,216,0,2021-01-05,1609801200.0
6994,24,1,2021-01-06,328,0,544,0,2021-01-06,1609887600.0
6995,24,1,2021-01-07,492,0,1036,0,2021-01-07,1609974000.0
6996,24,1,2021-01-08,952,0,1988,0,2021-01-08,1610060400.0
6997,24,1,2021-01-09,504,0,2492,0,2021-01-09,1610146800.0
6998,24,1,2021-01-10,395,0,2887,0,2021-01-10,1610233200.0
6999,24,1,2021-01-11,1279,0,4166,0,2021-01-11,1610319600.0
7000,24,1,2021-01-12,2575,0,6741,0,2021-01-12,1610406000.0
7001,24,1,2021-01-13,2191,0,8932,0,2021-01-13,1610492400.0
7002,24,1,2021-01-14,2504,0,11436,0,2021-01-14,1610578800.0
7003,24,1,2021-01-15,2115,0,13551,0,2021-01-15,1610665200.0
7004,24,1,2021-01-16,857,2,14408,2,2021-01-16,1610751600.0
7005,24,1,2021-01-17,322,3,14730,5,2021-01-17,1610838000.0
7006,24,1,2021-01-18,3215,13,17945,18,2021-01-18,1610924400.0
7007,24,1,2021-01-19,6326,10,24271,28,2021-01-19,1611010800.0
7008,24,1,2021-01-20,7165,5,31436,33,2021-01-20,1611097200.0
7009,24,1,2021-01-21,7417,1,38853,34,2021-01-21,1611183600.0
7010,24,1,2021-01-22,5118,1,43971,35,2021-01-22,1611270000.0
7011,24,1,2021-01-23,1276,1,45247,36,2021-01-23,1611356400.0
7012,24,1,2021-01-24,225,1,45472,37,2021-01-24,1611442800.0
7013,24,1,2021-01-25,3115,20,48587,57,2021-01-25,1611529200.0
7014,24,1,2021-01-26,4847,81,53434,138,2021-01-26,1611615600.0
7015,24,1,2021-01-27,5044,176,58478,314,2021-01-27,1611702000.0
7016,24,1,2021-01-28,5632,495,64110,809,2021-01-28,1611788400.0
7017,24,1,2021-01-29,3420,725,67530,1534,2021-01-29,1611874800.0
7018,24,1,2021-01-30,1207,397,68737,1931,2021-01-30,1611961200.0
7019,24,1,2021-01-31,251,368,68988,2299,2021-01-31,1612047600.0
7020,24,1,2021-02-01,2169,925,71157,3224,2021-02-01,1612134000.0
7021,24,1,2021-02-02,3032,1887,74189,5111,2021-02-02,1612220400.0
7022,24,1,2021-02-03,3111,1766,77300,6877,2021-02-03,1612306800.0
7023,24,1,2021-02-04,3234,1611,80534,8488,2021-02-04,1612393200.0
7024,24,1,2021-02-05,2394,1364,82928,9852,2021-02-05,1612479600.0
7025,24,1,2021-02-06,698,262,83626,10114,2021-02-06,1612566000.0
7026,24,1,2021-02-07,114,31,83740,10145,2021-02-07,1612652400.0
7027,24,1,2021-02-08,1773,1560,85513,11705,2021-02-08,1612738800.0
7028,24,1,2021-02-09,3054,3287,88567,14992,2021-02-09,1612825200.0
7029,24,1,2021-02-10,3640,3735,92207,18727,2021-02-10,1612911600.0
7030,24,1,2021-02-11,4063,4744,96270,23471,2021-02-11,1612998000.0
7031,24,1,2021-02-12,2920,3255,99190,26726,2021-02-12,1613084400.0
7032,24,1,2021-02-13,613,766,99803,27492,2021-02-13,1613170800.0
7033,24,1,2021-02-14,168,250,99971,27742,2021-02-14,1613257200.0
7034,24,1,2021-02-15,1277,2838,101248,30580,2021-02-15,1613343600.0
7035,24,1,2021-02-16,2092,4473,103340,35053,2021-02-16,1613430000.0
7036,24,1,2021-02-17,2152,5068,105492,40121,2021-02-17,1613516400.0
7037,24,1,2021-02-18,2799,5131,108291,45252,2021-02-18,1613602800.0
7038,24,1,2021-02-19,2415,3538,110706,48790,2021-02-19,1613689200.0
7039,24,1,2021-02-20,938,981,111644,49771,2021-02-20,1613775600.0
7040,24,1,2021-02-21,249,238,111893,50009,2021-02-21,1613862000.0
7041,24,1,2021-02-22,1130,3053,113023,53062,2021-02-22,1613948400.0
7042,24,1,2021-02-23,1801,3130,114824,56192,2021-02-23,1614034800.0
7043,24,1,2021-02-24,1441,3456,116265,59648,2021-02-24,1614121200.0
7044,24,1,2021-02-25,1784,3138,118049,62786,2021-02-25,1614207600.0
7045,24,1,2021-02-26,1659,2594,119708,65380,2021-02-26,1614294000.0
7046,24,1,2021-02-27,502,979,120210,66359,2021-02-27,1614380400.0
7047,24,1,2021-02-28,47,219,120257,66578,2021-02-28,1614466800.0
7048,24,1,2021-03-01,1386,2003,121643,68581,2021-03-01,1614553200.0
7049,24,1,2021-03-02,2132,2863,123775,71444,2021-03-02,1614639600.0
7050,24,1,2021-03-03,2096,3386,125871,74830,2021-03-03,1614726000.0
7051,24,1,2021-03-04,2584,3635,128455,78465,2021-03-04,1614812400.0
7052,24,1,2021-03-05,2837,3085,131292,81550,2021-03-05,1614898800.0
7053,24,1,2021-03-06,1997,689,133289,82239,2021-03-06,1614985200.0
7054,24,1,2021-03-07,909,268,134198,82507,2021-03-07,1615071600.0
7055,24,1,2021-03-08,1175,2463,135373,84970,2021-03-08,1615158000.0
7056,24,1,2021-03-09,2823,2695,138196,87665,2021-03-09,1615244400.0
7057,24,1,2021-03-10,3644,3304,141840,90969,2021-03-10,1615330800.0
7058,24,1,2021-03-11,3689,3237,145529,94206,2021-03-11,1615417200.0
7059,24,1,2021-03-12,4047,2389,149576,96595,2021-03-12,1615503600.0
7060,24,1,2021-03-13,1173,514,150749,97109,2021-03-13,1615590000.0
7061,24,1,2021-03-14,581,162,151330,97271,2021-03-14,1615676400.0
7062,24,1,2021-03-15,2281,1777,153611,99048,2021-03-15,1615762800.0
7063,24,1,2021-03-16,3776,2088,157387,101136,2021-03-16,1615849200.0
7064,24,1,2021-03-17,3984,1848,161371,102984,2021-03-17,1615935600.0
7065,24,1,2021-03-18,4004,1887,165375,104871,2021-03-18,1616022000.0
7066,24,1,2021-03-19,4201,1406,169576,106277,2021-03-19,1616108400.0
7067,24,1,2021-03-20,1069,725,170645,107002,2021-03-20,1616194800.0
7068,24,1,2021-03-21,102,243,170747,107245,2021-03-21,1616281200.0
7069,24,1,2021-03-22,3160,1384,173907,108629,2021-03-22,1616367600.0
7070,24,1,2021-03-23,4444,1970,178351,110599,2021-03-23,1616454000.0
7071,24,1,2021-03-24,4805,1636,183156,112235,2021-03-24,1616540400.0
7072,24,1,2021-03-25,5250,1510,188406,113745,2021-03-25,1616626800.0
7073,24,1,2021-03-26,5458,1327,193864,115072,2021-03-26,1616713200.0
7074,24,1,2021-03-27,2453,472,196317,115544,2021-03-27,1616799600.0
7075,24,1,2021-03-28,156,97,196473,115641,2021-03-28,1616886000.0
7076,24,1,2021-03-29,4288,1615,200761,117256,2021-03-29,1616972400.0
7077,24,1,2021-03-30,5301,2453,206062,119709,2021-03-30,1617058800.0
7078,24,1,2021-03-31,6943,2004,213005,121713,2021-03-31,1617145200.0
7079,24,1,2021-04-01,7199,2866,220204,124579,2021-04-01,1617231600.0
7080,24,1,2021-04-02,6199,2816,226403,127395,2021-04-02,1617318000.0
7081,24,1,2021-04-03,1437,1606,227840,129001,2021-04-03,1617404400.0
7082,24,1,2021-04-04,159,328,227999,129329,2021-04-04,1617490800.0
7083,24,1,2021-04-05,150,45,228149,129374,2021-04-05,1617577200.0
7084,24,1,2021-04-06,6025,3069,234174,132443,2021-04-06,1617663600.0
7085,24,1,2021-04-07,8675,4075,242849,136518,2021-04-07,1617750000.0
7086,24,1,2021-04-08,9028,4129,251877,140647,2021-04-08,1617836400.0
7087,24,1,2021-04-09,8584,3139,260461,143786,2021-04-09,1617922800.0
7088,24,1,2021-04-10,3861,1137,264322,144923,2021-04-10,1618009200.0
7089,24,1,2021-04-11,823,591,265145,145514,2021-04-11,1618095600.0
7090,24,1,2021-04-12,7870,2675,273015,148189,2021-04-12,1618185600.0
7091,24,1,2021-04-13,9137,3802,282152,151991,2021-04-13,1618272000.0
7092,24,1,2021-04-14,9577,4196,291729,156187,2021-04-14,1618358400.0
7093,24,1,2021-04-15,9480,3850,301209,160037,2021-04-15,1618444800.0
7094,24,1,2021-04-16,8816,3372,310025,163409,2021-04-16,1618531200.0
7095,24,1,2021-04-17,4879,928,314904,164337,2021-04-17,1618617600.0
7096,24,1,2021-04-18,568,39,315472,164376,2021-04-18,1618704000.0
7097,24,1,2021-04-19,7868,3329,323340,167705,2021-04-19,1618790400.0
7098,24,1,2021-04-20,9501,4814,332841,172519,2021-04-20,1618876800.0
7099,24,1,2021-04-21,9774,5000,342615,177519,2021-04-21,1618963200.0
7100,24,1,2021-04-22,10523,5953,353138,183472,2021-04-22,1619049600.0
7101,24,1,2021-04-23,9120,5351,362258,188823,2021-04-23,1619136000.0
7102,24,1,2021-04-24,7047,2271,369305,191094,2021-04-24,1619222400.0
7103,24,1,2021-04-25,2744,206,372049,191300,2021-04-25,1619308800.0
7104,24,1,2021-04-26,8828,4477,380877,195777,2021-04-26,1619395200.0
7105,24,1,2021-04-27,10346,5332,391223,201109,2021-04-27,1619481600.0
7106,24,1,2021-04-28,10537,6868,401760,207977,2021-04-28,1619568000.0
7107,24,1,2021-04-29,12757,5880,414517,213857,2021-04-29,1619654400.0
7108,24,1,2021-04-30,12741,4358,427258,218215,2021-04-30,1619740800.0
7109,24,1,2021-05-01,1969,294,429227,218509,2021-05-01,1619827200.0
7110,24,1,2021-05-02,1788,199,431015,218708,2021-05-02,1619913600.0
7111,24,1,2021-05-03,9876,4816,440891,223524,2021-05-03,1620000000.0
7112,24,1,2021-05-04,10066,8352,450957,231876,2021-05-04,1620086400.0
7113,24,1,2021-05-05,11828,7507,462785,239383,2021-05-05,1620172800.0
7114,24,1,2021-05-06,14010,6420,476795,245803,2021-05-06,1620259200.0
7115,24,1,2021-05-07,10127,8115,486922,253918,2021-05-07,1620345600.0
7116,24,1,2021-05-08,2827,1089,489749,255007,2021-05-08,1620432000.0
7117,24,1,2021-05-09,2155,1367,491904,256374,2021-05-09,1620518400.0
7118,24,1,2021-05-10,8793,9867,500697,266241,2021-05-10,1620604800.0
7119,24,1,2021-05-11,11971,10553,512668,276794,2021-05-11,1620691200.0
7120,24,1,2021-05-12,14980,9840,527648,286634,2021-05-12,1620777600.0
7121,24,1,2021-05-13,6131,2734,533779,289368,2021-05-13,1620864000.0
7122,24,1,2021-05-14,10906,6795,544685,296163,2021-05-14,1620950400.0
7123,24,1,2021-05-15,7189,3531,551874,299694,2021-05-15,1621036800.0
7124,24,1,2021-05-16,3120,638,554994,300332,2021-05-16,1621123200.0
7125,24,1,2021-05-17,11119,5740,566113,306072,2021-05-17,1621206000.0
7126,24,1,2021-05-18,14891,5488,581004,311560,2021-05-18,1621292400.0
7127,24,1,2021-05-19,16247,4826,597251,316386,2021-05-19,1621378800.0
7128,24,1,2021-05-20,17678,4484,614929,320870,2021-05-20,1621465200.0
7129,24,1,2021-05-21,14220,4713,629149,325583,2021-05-21,1621551600.0
7130,24,1,2021-05-22,6143,2298,635292,327881,2021-05-22,1621638000.0
7131,24,1,2021-05-23,2460,668,637752,328549,2021-05-23,1621724400.0
7132,24,1,2021-05-24,8229,1061,645981,329610,2021-05-24,1621810800.0
7133,24,1,2021-05-25,15806,5318,661787,334928,2021-05-25,1621897200.0
7134,24,1,2021-05-26,17991,5147,679778,340075,2021-05-26,1621983600.0
7135,24,1,2021-05-27,18618,5337,698396,345412,2021-05-27,1622070000.0
7136,24,1,2021-05-28,16934,5382,715330,350794,2021-05-28,1622156400.0
7137,24,1,2021-05-29,7580,1486,722910,352280,2021-05-29,1622242800.0
7138,24,1,2021-05-30,708,841,723618,353121,2021-05-30,1622329200.0
7139,24,1,2021-05-31,12795,6326,736413,359447,2021-05-31,1622415600.0
7140,24,1,2021-06-01,16193,6925,752606,366372,2021-06-01,1622502000.0
7141,24,1,2021-06-02,15511,7082,768117,373454,2021-06-02,1622588400.0
7142,24,1,2021-06-03,17676,6564,785793,380018,2021-06-03,1622674800.0
7143,24,1,2021-06-04,16118,7000,801911,387018,2021-06-04,1622761200.0
7144,24,1,2021-06-05,7896,4830,809807,391848,2021-06-05,1622847600.0
7145,24,1,2021-06-06,1876,2417,811683,394265,2021-06-06,1622934000.0
7146,24,1,2021-06-07,13324,8938,825007,403203,2021-06-07,1623020400.0
7147,24,1,2021-06-08,13535,10263,838542,413466,2021-06-08,1623106800.0
7148,24,1,2021-06-09,14720,9157,853262,422623,2021-06-09,1623193200.0
7149,24,1,2021-06-10,15608,7912,868870,430535,2021-06-10,1623279600.0
7150,24,1,2021-06-11,14183,9052,883053,439587,2021-06-11,1623366000.0
7151,24,1,2021-06-12,8123,3244,891176,442831,2021-06-12,1623452400.0
7152,24,1,2021-06-13,815,805,891991,443636,2021-06-13,1623538800.0
7153,24,1,2021-06-14,9029,12185,901020,455821,2021-06-14,1623625200.0
7154,24,1,2021-06-15,10571,11625,911591,467446,2021-06-15,1623711600.0
7155,24,1,2021-06-16,11797,11627,923388,479073,2021-06-16,1623798000.0
7156,24,1,2021-06-17,10973,10599,934361,489672,2021-06-17,1623884400.0
7157,24,1,2021-06-18,12053,12417,946414,502089,2021-06-18,1623970800.0
7158,24,1,2021-06-19,6387,3779,952801,505868,2021-06-19,1624057200.0
7159,24,1,2021-06-20,489,498,953290,506366,2021-06-20,1624143600.0
7160,24,1,2021-06-21,7899,12483,961189,518849,2021-06-21,1624230000.0
7161,24,1,2021-06-22,8499,13159,969688,532008,2021-06-22,1624316400.0
7162,24,1,2021-06-23,8497,12895,978185,544903,2021-06-23,1624402800.0
7163,24,1,2021-06-24,7439,7664,985624,552567,2021-06-24,1624489200.0
7164,24,1,2021-06-25,8442,12070,994066,564637,2021-06-25,1624575600.0
7165,24,1,2021-06-26,3888,5860,997954,570497,2021-06-26,1624662000.0
7166,24,1,2021-06-27,709,1848,998663,572345,2021-06-27,1624748400.0
7167,24,1,2021-06-28,5877,14803,1004540,587148,2021-06-28,1624834800.0
7168,24,1,2021-06-29,6685,17003,1011225,604151,2021-06-29,1624921200.0
7169,24,1,2021-06-30,7176,16516,1018401,620667,2021-06-30,1625007600.0
7170,24,1,2021-07-01,6812,13013,1025213,633680,2021-07-01,1625094000.0
7171,24,1,2021-07-02,6809,14593,1032022,648273,2021-07-02,1625180400.0
7172,24,1,2021-07-03,3432,7351,1035454,655624,2021-07-03,1625266800.0
7173,24,1,2021-07-04,426,1782,1035880,657406,2021-07-04,1625353200.0
7174,24,1,2021-07-05,6217,15024,1042097,672430,2021-07-05,1625439600.0
7175,24,1,2021-07-06,6991,17321,1049088,689751,2021-07-06,1625526000.0
7176,24,1,2021-07-07,6887,17695,1055975,707446,2021-07-07,1625612400.0
7177,24,1,2021-07-08,7987,15515,1063962,722961,2021-07-08,1625698800.0
7178,24,2,2020-12-27,0,0,0,0,2020-12-27,1609023600.0
7179,24,2,2020-12-28,0,0,0,0,2020-12-28,1609110000.0
7180,24,2,2020-12-29,0,0,0,0,2020-12-29,1609196400.0
7181,24,2,2020-12-30,0,0,0,0,2020-12-30,1609282800.0
7182,24,2,2020-12-31,0,0,0,0,2020-12-31,1609369200.0
7183,24,2,2021-01-01,0,0,0,0,2021-01-01,1609455600.0
7184,24,2,2021-01-02,0,0,0,0,2021-01-02,1609542000.0
7185,24,2,2021-01-03,0,0,0,0,2021-01-03,1609628400.0
7186,24,2,2021-01-04,0,0,0,0,2021-01-04,1609714800.0
7187,24,2,2021-01-05,0,0,0,0,2021-01-05,1609801200.0
7188,24,2,2021-01-06,0,0,0,0,2021-01-06,1609887600.0
7189,24,2,2021-01-07,0,0,0,0,2021-01-07,1609974000.0
7190,24,2,2021-01-08,0,0,0,0,2021-01-08,1610060400.0
7191,24,2,2021-01-09,0,0,0,0,2021-01-09,1610146800.0
7192,24,2,2021-01-10,0,0,0,0,2021-01-10,1610233200.0
7193,24,2,2021-01-11,0,0,0,0,2021-01-11,1610319600.0
7194,24,2,2021-01-12,0,0,0,0,2021-01-12,1610406000.0
7195,24,2,2021-01-13,0,0,0,0,2021-01-13,1610492400.0
7196,24,2,2021-01-14,0,0,0,0,2021-01-14,1610578800.0
7197,24,2,2021-01-15,0,0,0,0,2021-01-15,1610665200.0
7198,24,2,2021-01-16,0,0,0,0,2021-01-16,1610751600.0
7199,24,2,2021-01-17,0,0,0,0,2021-01-17,1610838000.0
7200,24,2,2021-01-18,0,0,0,0,2021-01-18,1610924400.0
7201,24,2,2021-01-19,0,0,0,0,2021-01-19,1611010800.0
7202,24,2,2021-01-20,0,0,0,0,2021-01-20,1611097200.0
7203,24,2,2021-01-21,0,0,0,0,2021-01-21,1611183600.0
7204,24,2,2021-01-22,2,0,2,0,2021-01-22,1611270000.0
7205,24,2,2021-01-23,0,0,2,0,2021-01-23,1611356400.0
7206,24,2,2021-01-24,0,0,2,0,2021-01-24,1611442800.0
7207,24,2,2021-01-25,0,0,2,0,2021-01-25,1611529200.0
7208,24,2,2021-01-26,1,0,3,0,2021-01-26,1611615600.0
7209,24,2,2021-01-27,3,0,6,0,2021-01-27,1611702000.0
7210,24,2,2021-01-28,2,0,8,0,2021-01-28,1611788400.0
7211,24,2,2021-01-29,3,0,11,0,2021-01-29,1611874800.0
7212,24,2,2021-01-30,1,0,12,0,2021-01-30,1611961200.0
7213,24,2,2021-01-31,0,0,12,0,2021-01-31,1612047600.0
7214,24,2,2021-02-01,1,0,13,0,2021-02-01,1612134000.0
7215,24,2,2021-02-02,0,0,13,0,2021-02-02,1612220400.0
7216,24,2,2021-02-03,0,0,13,0,2021-02-03,1612306800.0
7217,24,2,2021-02-04,0,0,13,0,2021-02-04,1612393200.0
7218,24,2,2021-02-05,0,0,13,0,2021-02-05,1612479600.0
7219,24,2,2021-02-06,0,0,13,0,2021-02-06,1612566000.0
7220,24,2,2021-02-07,0,0,13,0,2021-02-07,1612652400.0
7221,24,2,2021-02-08,120,0,133,0,2021-02-08,1612738800.0
7222,24,2,2021-02-09,30,0,163,0,2021-02-09,1612825200.0
7223,24,2,2021-02-10,168,0,331,0,2021-02-10,1612911600.0
7224,24,2,2021-02-11,197,1,528,1,2021-02-11,1612998000.0
7225,24,2,2021-02-12,215,1,743,2,2021-02-12,1613084400.0
7226,24,2,2021-02-13,127,0,870,2,2021-02-13,1613170800.0
7227,24,2,2021-02-14,101,0,971,2,2021-02-14,1613257200.0
7228,24,2,2021-02-15,167,0,1138,2,2021-02-15,1613343600.0
7229,24,2,2021-02-16,260,0,1398,2,2021-02-16,1613430000.0
7230,24,2,2021-02-17,137,3,1535,5,2021-02-17,1613516400.0
7231,24,2,2021-02-18,276,1,1811,6,2021-02-18,1613602800.0
7232,24,2,2021-02-19,304,5,2115,11,2021-02-19,1613689200.0
7233,24,2,2021-02-20,187,0,2302,11,2021-02-20,1613775600.0
7234,24,2,2021-02-21,105,0,2407,11,2021-02-21,1613862000.0
7235,24,2,2021-02-22,266,1,2673,12,2021-02-22,1613948400.0
7236,24,2,2021-02-23,268,3,2941,15,2021-02-23,1614034800.0
7237,24,2,2021-02-24,244,1,3185,16,2021-02-24,1614121200.0
7238,24,2,2021-02-25,308,1,3493,17,2021-02-25,1614207600.0
7239,24,2,2021-02-26,544,2,4037,19,2021-02-26,1614294000.0
7240,24,2,2021-02-27,153,0,4190,19,2021-02-27,1614380400.0
7241,24,2,2021-02-28,0,0,4190,19,2021-02-28,1614466800.0
7242,24,2,2021-03-01,171,0,4361,19,2021-03-01,1614553200.0
7243,24,2,2021-03-02,176,0,4537,19,2021-03-02,1614639600.0
7244,24,2,2021-03-03,177,0,4714,19,2021-03-03,1614726000.0
7245,24,2,2021-03-04,233,0,4947,19,2021-03-04,1614812400.0
7246,24,2,2021-03-05,310,1,5257,20,2021-03-05,1614898800.0
7247,24,2,2021-03-06,72,0,5329,20,2021-03-06,1614985200.0
7248,24,2,2021-03-07,0,0,5329,20,2021-03-07,1615071600.0
7249,24,2,2021-03-08,153,128,5482,148,2021-03-08,1615158000.0
7250,24,2,2021-03-09,163,64,5645,212,2021-03-09,1615244400.0
7251,24,2,2021-03-10,294,164,5939,376,2021-03-10,1615330800.0
7252,24,2,2021-03-11,316,184,6255,560,2021-03-11,1615417200.0
7253,24,2,2021-03-12,278,193,6533,753,2021-03-12,1615503600.0
7254,24,2,2021-03-13,797,165,7330,918,2021-03-13,1615590000.0
7255,24,2,2021-03-14,635,101,7965,1019,2021-03-14,1615676400.0
7256,24,2,2021-03-15,593,168,8558,1187,2021-03-15,1615762800.0
7257,24,2,2021-03-16,781,234,9339,1421,2021-03-16,1615849200.0
7258,24,2,2021-03-17,457,113,9796,1534,2021-03-17,1615935600.0
7259,24,2,2021-03-18,1032,155,10828,1689,2021-03-18,1616022000.0
7260,24,2,2021-03-19,642,192,11470,1881,2021-03-19,1616108400.0
7261,24,2,2021-03-20,288,114,11758,1995,2021-03-20,1616194800.0
7262,24,2,2021-03-21,253,101,12011,2096,2021-03-21,1616281200.0
7263,24,2,2021-03-22,617,249,12628,2345,2021-03-22,1616367600.0
7264,24,2,2021-03-23,952,242,13580,2587,2021-03-23,1616454000.0
7265,24,2,2021-03-24,738,268,14318,2855,2021-03-24,1616540400.0
7266,24,2,2021-03-25,1252,328,15570,3183,2021-03-25,1616626800.0
7267,24,2,2021-03-26,1257,502,16827,3685,2021-03-26,1616713200.0
7268,24,2,2021-03-27,748,159,17575,3844,2021-03-27,1616799600.0
7269,24,2,2021-03-28,170,0,17745,3844,2021-03-28,1616886000.0
7270,24,2,2021-03-29,723,175,18468,4019,2021-03-29,1616972400.0
7271,24,2,2021-03-30,1666,189,20134,4208,2021-03-30,1617058800.0
7272,24,2,2021-03-31,846,191,20980,4399,2021-03-31,1617145200.0
7273,24,2,2021-04-01,1532,252,22512,4651,2021-04-01,1617231600.0
7274,24,2,2021-04-02,1278,306,23790,4957,2021-04-02,1617318000.0
7275,24,2,2021-04-03,218,69,24008,5026,2021-04-03,1617404400.0
7276,24,2,2021-04-04,71,10,24079,5036,2021-04-04,1617490800.0
7277,24,2,2021-04-05,187,0,24266,5036,2021-04-05,1617577200.0
7278,24,2,2021-04-06,1075,215,25341,5251,2021-04-06,1617663600.0
7279,24,2,2021-04-07,1075,282,26416,5533,2021-04-07,1617750000.0
7280,24,2,2021-04-08,1750,354,28166,5887,2021-04-08,1617836400.0
7281,24,2,2021-04-09,1479,267,29645,6154,2021-04-09,1617922800.0
7282,24,2,2021-04-10,1373,797,31018,6951,2021-04-10,1618009200.0
7283,24,2,2021-04-11,1921,597,32939,7548,2021-04-11,1618095600.0
7284,24,2,2021-04-12,854,598,33793,8146,2021-04-12,1618185600.0
7285,24,2,2021-04-13,1428,765,35221,8911,2021-04-13,1618272000.0
7286,24,2,2021-04-14,745,478,35966,9389,2021-04-14,1618358400.0
7287,24,2,2021-04-15,1356,1014,37322,10403,2021-04-15,1618444800.0
7288,24,2,2021-04-16,1400,663,38722,11066,2021-04-16,1618531200.0
7289,24,2,2021-04-17,625,262,39347,11328,2021-04-17,1618617600.0
7290,24,2,2021-04-18,329,226,39676,11554,2021-04-18,1618704000.0
7291,24,2,2021-04-19,441,566,40117,12120,2021-04-19,1618790400.0
7292,24,2,2021-04-20,888,872,41005,12992,2021-04-20,1618876800.0
7293,24,2,2021-04-21,465,659,41470,13651,2021-04-21,1618963200.0
7294,24,2,2021-04-22,866,1200,42336,14851,2021-04-22,1619049600.0
7295,24,2,2021-04-23,810,1291,43146,16142,2021-04-23,1619136000.0
7296,24,2,2021-04-24,442,710,43588,16852,2021-04-24,1619222400.0
7297,24,2,2021-04-25,216,167,43804,17019,2021-04-25,1619308800.0
7298,24,2,2021-04-26,358,632,44162,17651,2021-04-26,1619395200.0
7299,24,2,2021-04-27,884,1615,45046,19266,2021-04-27,1619481600.0
7300,24,2,2021-04-28,520,810,45566,20076,2021-04-28,1619568000.0
7301,24,2,2021-04-29,767,1453,46333,21529,2021-04-29,1619654400.0
7302,24,2,2021-04-30,590,1269,46923,22798,2021-04-30,1619740800.0
7303,24,2,2021-05-01,317,154,47240,22952,2021-05-01,1619827200.0
7304,24,2,2021-05-02,224,7,47464,22959,2021-05-02,1619913600.0
7305,24,2,2021-05-03,478,617,47942,23576,2021-05-03,1620000000.0
7306,24,2,2021-05-04,1078,1119,49020,24695,2021-05-04,1620086400.0
7307,24,2,2021-05-05,570,1020,49590,25715,2021-05-05,1620172800.0
7308,24,2,2021-05-06,660,1665,50250,27380,2021-05-06,1620259200.0
7309,24,2,2021-05-07,609,1466,50859,28846,2021-05-07,1620345600.0
7310,24,2,2021-05-08,25,754,50884,29600,2021-05-08,1620432000.0
7311,24,2,2021-05-09,71,2204,50955,31804,2021-05-09,1620518400.0
7312,24,2,2021-05-10,1450,1111,52405,32915,2021-05-10,1620604800.0
7313,24,2,2021-05-11,1759,1314,54164,34229,2021-05-11,1620691200.0
7314,24,2,2021-05-12,1767,1347,55931,35576,2021-05-12,1620777600.0
7315,24,2,2021-05-13,540,0,56471,35576,2021-05-13,1620864000.0
7316,24,2,2021-05-14,2398,594,58869,36170,2021-05-14,1620950400.0
7317,24,2,2021-05-15,2637,339,61506,36509,2021-05-15,1621036800.0
7318,24,2,2021-05-16,18,309,61524,36818,2021-05-16,1621123200.0
7319,24,2,2021-05-17,1664,520,63188,37338,2021-05-17,1621206000.0
7320,24,2,2021-05-18,2094,647,65282,37985,2021-05-18,1621292400.0
7321,24,2,2021-05-19,1959,384,67241,38369,2021-05-19,1621378800.0
7322,24,2,2021-05-20,2339,540,69580,38909,2021-05-20,1621465200.0
7323,24,2,2021-05-21,2821,641,72401,39550,2021-05-21,1621551600.0
7324,24,2,2021-05-22,1006,8,73407,39558,2021-05-22,1621638000.0
7325,24,2,2021-05-23,366,7,73773,39565,2021-05-23,1621724400.0
7326,24,2,2021-05-24,1,0,73774,39565,2021-05-24,1621810800.0
7327,24,2,2021-05-25,1297,852,75071,40417,2021-05-25,1621897200.0
7328,24,2,2021-05-26,832,522,75903,40939,2021-05-26,1621983600.0
7329,24,2,2021-05-27,1286,778,77189,41717,2021-05-27,1622070000.0
7330,24,2,2021-05-28,1838,613,79027,42330,2021-05-28,1622156400.0
7331,24,2,2021-05-29,4055,438,83082,42768,2021-05-29,1622242800.0
7332,24,2,2021-05-30,1263,48,84345,42816,2021-05-30,1622329200.0
7333,24,2,2021-05-31,1159,267,85504,43083,2021-05-31,1622415600.0
7334,24,2,2021-06-01,2247,621,87751,43704,2021-06-01,1622502000.0
7335,24,2,2021-06-02,1603,249,89354,43953,2021-06-02,1622588400.0
7336,24,2,2021-06-03,2170,517,91524,44470,2021-06-03,1622674800.0
7337,24,2,2021-06-04,2625,610,94149,45080,2021-06-04,1622761200.0
7338,24,2,2021-06-05,1339,370,95488,45450,2021-06-05,1622847600.0
7339,24,2,2021-06-06,81,208,95569,45658,2021-06-06,1622934000.0
7340,24,2,2021-06-07,685,589,96254,46247,2021-06-07,1623020400.0
7341,24,2,2021-06-08,1648,1167,97902,47414,2021-06-08,1623106800.0
7342,24,2,2021-06-09,1052,460,98954,47874,2021-06-09,1623193200.0
7343,24,2,2021-06-10,1522,462,100476,48336,2021-06-10,1623279600.0
7344,24,2,2021-06-11,2017,488,102493,48824,2021-06-11,1623366000.0
7345,24,2,2021-06-12,1516,988,104009,49812,2021-06-12,1623452400.0
7346,24,2,2021-06-13,54,217,104063,50029,2021-06-13,1623538800.0
7347,24,2,2021-06-14,1093,723,105156,50752,2021-06-14,1623625200.0
7348,24,2,2021-06-15,1952,978,107108,51730,2021-06-15,1623711600.0
7349,24,2,2021-06-16,1273,535,108381,52265,2021-06-16,1623798000.0
7350,24,2,2021-06-17,1653,762,110034,53027,2021-06-17,1623884400.0
7351,24,2,2021-06-18,1916,946,111950,53973,2021-06-18,1623970800.0
7352,24,2,2021-06-19,1250,192,113200,54165,2021-06-19,1624057200.0
7353,24,2,2021-06-20,43,103,113243,54268,2021-06-20,1624143600.0
7354,24,2,2021-06-21,628,1508,113871,55776,2021-06-21,1624230000.0
7355,24,2,2021-06-22,1206,1920,115077,57696,2021-06-22,1624316400.0
7356,24,2,2021-06-23,796,1526,115873,59222,2021-06-23,1624402800.0
7357,24,2,2021-06-24,1121,688,116994,59910,2021-06-24,1624489200.0
7358,24,2,2021-06-25,1682,2570,118676,62480,2021-06-25,1624575600.0
7359,24,2,2021-06-26,1154,2270,119830,64750,2021-06-26,1624662000.0
7360,24,2,2021-06-27,43,12,119873,64762,2021-06-27,1624748400.0
7361,24,2,2021-06-28,394,1799,120267,66561,2021-06-28,1624834800.0
7362,24,2,2021-06-29,864,2941,121131,69502,2021-06-29,1624921200.0
7363,24,2,2021-06-30,660,2184,121791,71686,2021-06-30,1625007600.0
7364,24,2,2021-07-01,540,2267,122331,73953,2021-07-01,1625094000.0
7365,24,2,2021-07-02,943,2838,123274,76791,2021-07-02,1625180400.0
7366,24,2,2021-07-03,521,1461,123795,78252,2021-07-03,1625266800.0
7367,24,2,2021-07-04,39,684,123834,78936,2021-07-04,1625353200.0
7368,24,2,2021-07-05,247,798,124081,79734,2021-07-05,1625439600.0
7369,24,2,2021-07-06,617,2067,124698,81801,2021-07-06,1625526000.0
7370,24,2,2021-07-07,592,1224,125290,83025,2021-07-07,1625612400.0
7371,24,2,2021-07-08,715,1935,126005,84960,2021-07-08,1625698800.0
7372,24,3,2020-12-27,0,0,0,0,2020-12-27,1609023600.0
7373,24,3,2020-12-28,0,0,0,0,2020-12-28,1609110000.0
7374,24,3,2020-12-29,0,0,0,0,2020-12-29,1609196400.0
7375,24,3,2020-12-30,0,0,0,0,2020-12-30,1609282800.0
7376,24,3,2020-12-31,0,0,0,0,2020-12-31,1609369200.0
7377,24,3,2021-01-01,0,0,0,0,2021-01-01,1609455600.0
7378,24,3,2021-01-02,0,0,0,0,2021-01-02,1609542000.0
7379,24,3,2021-01-03,0,0,0,0,2021-01-03,1609628400.0
7380,24,3,2021-01-04,0,0,0,0,2021-01-04,1609714800.0
7381,24,3,2021-01-05,0,0,0,0,2021-01-05,1609801200.0
7382,24,3,2021-01-06,0,0,0,0,2021-01-06,1609887600.0
7383,24,3,2021-01-07,0,0,0,0,2021-01-07,1609974000.0
7384,24,3,2021-01-08,0,0,0,0,2021-01-08,1610060400.0
7385,24,3,2021-01-09,0,0,0,0,2021-01-09,1610146800.0
7386,24,3,2021-01-10,0,0,0,0,2021-01-10,1610233200.0
7387,24,3,2021-01-11,0,0,0,0,2021-01-11,1610319600.0
7388,24,3,2021-01-12,0,0,0,0,2021-01-12,1610406000.0
7389,24,3,2021-01-13,0,0,0,0,2021-01-13,1610492400.0
7390,24,3,2021-01-14,0,0,0,0,2021-01-14,1610578800.0
7391,24,3,2021-01-15,0,0,0,0,2021-01-15,1610665200.0
7392,24,3,2021-01-16,0,0,0,0,2021-01-16,1610751600.0
7393,24,3,2021-01-17,0,0,0,0,2021-01-17,1610838000.0
7394,24,3,2021-01-18,0,0,0,0,2021-01-18,1610924400.0
7395,24,3,2021-01-19,0,0,0,0,2021-01-19,1611010800.0
7396,24,3,2021-01-20,0,0,0,0,2021-01-20,1611097200.0
7397,24,3,2021-01-21,0,0,0,0,2021-01-21,1611183600.0
7398,24,3,2021-01-22,0,0,0,0,2021-01-22,1611270000.0
7399,24,3,2021-01-23,0,0,0,0,2021-01-23,1611356400.0
7400,24,3,2021-01-24,0,0,0,0,2021-01-24,1611442800.0
7401,24,3,2021-01-25,0,0,0,0,2021-01-25,1611529200.0
7402,24,3,2021-01-26,0,0,0,0,2021-01-26,1611615600.0
7403,24,3,2021-01-27,0,0,0,0,2021-01-27,1611702000.0
7404,24,3,2021-01-28,0,0,0,0,2021-01-28,1611788400.0
7405,24,3,2021-01-29,0,0,0,0,2021-01-29,1611874800.0
7406,24,3,2021-01-30,0,0,0,0,2021-01-30,1611961200.0
7407,24,3,2021-01-31,0,0,0,0,2021-01-31,1612047600.0
7408,24,3,2021-02-01,0,0,0,0,2021-02-01,1612134000.0
7409,24,3,2021-02-02,0,0,0,0,2021-02-02,1612220400.0
7410,24,3,2021-02-03,0,0,0,0,2021-02-03,1612306800.0
7411,24,3,2021-02-04,0,0,0,0,2021-02-04,1612393200.0
7412,24,3,2021-02-05,0,0,0,0,2021-02-05,1612479600.0
7413,24,3,2021-02-06,9,0,9,0,2021-02-06,1612566000.0
7414,24,3,2021-02-07,20,0,29,0,2021-02-07,1612652400.0
7415,24,3,2021-02-08,75,0,104,0,2021-02-08,1612738800.0
7416,24,3,2021-02-09,329,0,433,0,2021-02-09,1612825200.0
7417,24,3,2021-02-10,277,0,710,0,2021-02-10,1612911600.0
7418,24,3,2021-02-11,396,0,1106,0,2021-02-11,1612998000.0
7419,24,3,2021-02-12,348,0,1454,0,2021-02-12,1613084400.0
7420,24,3,2021-02-13,100,0,1554,0,2021-02-13,1613170800.0
7421,24,3,2021-02-14,157,0,1711,0,2021-02-14,1613257200.0
7422,24,3,2021-02-15,520,0,2231,0,2021-02-15,1613343600.0
7423,24,3,2021-02-16,497,0,2728,0,2021-02-16,1613430000.0
7424,24,3,2021-02-17,402,0,3130,0,2021-02-17,1613516400.0
7425,24,3,2021-02-18,446,0,3576,0,2021-02-18,1613602800.0
7426,24,3,2021-02-19,539,0,4115,0,2021-02-19,1613689200.0
7427,24,3,2021-02-20,163,0,4278,0,2021-02-20,1613775600.0
7428,24,3,2021-02-21,79,0,4357,0,2021-02-21,1613862000.0
7429,24,3,2021-02-22,256,0,4613,0,2021-02-22,1613948400.0
7430,24,3,2021-02-23,271,0,4884,0,2021-02-23,1614034800.0
7431,24,3,2021-02-24,408,0,5292,0,2021-02-24,1614121200.0
7432,24,3,2021-02-25,1531,0,6823,0,2021-02-25,1614207600.0
7433,24,3,2021-02-26,2264,0,9087,0,2021-02-26,1614294000.0
7434,24,3,2021-02-27,1222,0,10309,0,2021-02-27,1614380400.0
7435,24,3,2021-02-28,50,0,10359,0,2021-02-28,1614466800.0
7436,24,3,2021-03-01,620,0,10979,0,2021-03-01,1614553200.0
7437,24,3,2021-03-02,1123,2,12102,2,2021-03-02,1614639600.0
7438,24,3,2021-03-03,1278,3,13380,5,2021-03-03,1614726000.0
7439,24,3,2021-03-04,2522,0,15902,5,2021-03-04,1614812400.0
7440,24,3,2021-03-05,3892,3,19794,8,2021-03-05,1614898800.0
7441,24,3,2021-03-06,5308,2,25102,10,2021-03-06,1614985200.0
7442,24,3,2021-03-07,1520,0,26622,10,2021-03-07,1615071600.0
7443,24,3,2021-03-08,1361,1,27983,11,2021-03-08,1615158000.0
7444,24,3,2021-03-09,2791,4,30774,15,2021-03-09,1615244400.0
7445,24,3,2021-03-10,2475,1,33249,16,2021-03-10,1615330800.0
7446,24,3,2021-03-11,3801,3,37050,19,2021-03-11,1615417200.0
7447,24,3,2021-03-12,6464,0,43514,19,2021-03-12,1615503600.0
7448,24,3,2021-03-13,5152,2,48666,21,2021-03-13,1615590000.0
7449,24,3,2021-03-14,333,0,48999,21,2021-03-14,1615676400.0
7450,24,3,2021-03-15,1685,0,50684,21,2021-03-15,1615762800.0
7451,24,3,2021-03-16,40,0,50724,21,2021-03-16,1615849200.0
7452,24,3,2021-03-17,21,0,50745,21,2021-03-17,1615935600.0
7453,24,3,2021-03-18,28,0,50773,21,2021-03-18,1616022000.0
7454,24,3,2021-03-19,2940,2,53713,23,2021-03-19,1616108400.0
7455,24,3,2021-03-20,3079,3,56792,26,2021-03-20,1616194800.0
7456,24,3,2021-03-21,202,0,56994,26,2021-03-21,1616281200.0
7457,24,3,2021-03-22,1084,0,58078,26,2021-03-22,1616367600.0
7458,24,3,2021-03-23,2645,4,60723,30,2021-03-23,1616454000.0
7459,24,3,2021-03-24,3273,1,63996,31,2021-03-24,1616540400.0
7460,24,3,2021-03-25,5632,3,69628,34,2021-03-25,1616626800.0
7461,24,3,2021-03-26,6557,5,76185,39,2021-03-26,1616713200.0
7462,24,3,2021-03-27,2581,2,78766,41,2021-03-27,1616799600.0
7463,24,3,2021-03-28,194,0,78960,41,2021-03-28,1616886000.0
7464,24,3,2021-03-29,1752,1,80712,42,2021-03-29,1616972400.0
7465,24,3,2021-03-30,3208,4,83920,46,2021-03-30,1617058800.0
7466,24,3,2021-03-31,2106,1,86026,47,2021-03-31,1617145200.0
7467,24,3,2021-04-01,3316,4,89342,51,2021-04-01,1617231600.0
7468,24,3,2021-04-02,3165,1,92507,52,2021-04-02,1617318000.0
7469,24,3,2021-04-03,1760,1,94267,53,2021-04-03,1617404400.0
7470,24,3,2021-04-04,164,0,94431,53,2021-04-04,1617490800.0
7471,24,3,2021-04-05,64,3,94495,56,2021-04-05,1617577200.0
7472,24,3,2021-04-06,1228,0,95723,56,2021-04-06,1617663600.0
7473,24,3,2021-04-07,1321,0,97044,56,2021-04-07,1617750000.0
7474,24,3,2021-04-08,3412,4,100456,60,2021-04-08,1617836400.0
7475,24,3,2021-04-09,7706,11,108162,71,2021-04-09,1617922800.0
7476,24,3,2021-04-10,4159,12,112321,83,2021-04-10,1618009200.0
7477,24,3,2021-04-11,166,0,112487,83,2021-04-11,1618095600.0
7478,24,3,2021-04-12,2125,4,114612,87,2021-04-12,1618185600.0
7479,24,3,2021-04-13,4429,6,119041,93,2021-04-13,1618272000.0
7480,24,3,2021-04-14,3156,7,122197,100,2021-04-14,1618358400.0
7481,24,3,2021-04-15,4527,6,126724,106,2021-04-15,1618444800.0
7482,24,3,2021-04-16,5480,6,132204,112,2021-04-16,1618531200.0
7483,24,3,2021-04-17,2692,12,134896,124,2021-04-17,1618617600.0
7484,24,3,2021-04-18,205,0,135101,124,2021-04-18,1618704000.0
7485,24,3,2021-04-19,1130,5,136231,129,2021-04-19,1618790400.0
7486,24,3,2021-04-20,2338,4,138569,133,2021-04-20,1618876800.0
7487,24,3,2021-04-21,2091,19,140660,152,2021-04-21,1618963200.0
7488,24,3,2021-04-22,2476,24,143136,176,2021-04-22,1619049600.0
7489,24,3,2021-04-23,3750,30,146886,206,2021-04-23,1619136000.0
7490,24,3,2021-04-24,2673,21,149559,227,2021-04-24,1619222400.0
7491,24,3,2021-04-25,88,2,149647,229,2021-04-25,1619308800.0
7492,24,3,2021-04-26,926,1,150573,230,2021-04-26,1619395200.0
7493,24,3,2021-04-27,2201,54,152774,284,2021-04-27,1619481600.0
7494,24,3,2021-04-28,1587,70,154361,354,2021-04-28,1619568000.0
7495,24,3,2021-04-29,2373,142,156734,496,2021-04-29,1619654400.0
7496,24,3,2021-04-30,3336,333,160070,829,2021-04-30,1619740800.0
7497,24,3,2021-05-01,553,56,160623,885,2021-05-01,1619827200.0
7498,24,3,2021-05-02,110,12,160733,897,2021-05-02,1619913600.0
7499,24,3,2021-05-03,776,142,161509,1039,2021-05-03,1620000000.0
7500,24,3,2021-05-04,1465,188,162974,1227,2021-05-04,1620086400.0
7501,24,3,2021-05-05,1229,305,164203,1532,2021-05-05,1620172800.0
7502,24,3,2021-05-06,2346,531,166549,2063,2021-05-06,1620259200.0
7503,24,3,2021-05-07,2929,1009,169478,3072,2021-05-07,1620345600.0
7504,24,3,2021-05-08,651,254,170129,3326,2021-05-08,1620432000.0
7505,24,3,2021-05-09,98,57,170227,3383,2021-05-09,1620518400.0
7506,24,3,2021-05-10,925,383,171152,3766,2021-05-10,1620604800.0
7507,24,3,2021-05-11,1957,1124,173109,4890,2021-05-11,1620691200.0
7508,24,3,2021-05-12,1078,857,174187,5747,2021-05-12,1620777600.0
7509,24,3,2021-05-13,147,69,174334,5816,2021-05-13,1620864000.0
7510,24,3,2021-05-14,806,854,175140,6670,2021-05-14,1620950400.0
7511,24,3,2021-05-15,497,653,175637,7323,2021-05-15,1621036800.0
7512,24,3,2021-05-16,29,73,175666,7396,2021-05-16,1621123200.0
7513,24,3,2021-05-17,339,546,176005,7942,2021-05-17,1621206000.0
7514,24,3,2021-05-18,1091,882,177096,8824,2021-05-18,1621292400.0
7515,24,3,2021-05-19,625,1281,177721,10105,2021-05-19,1621378800.0
7516,24,3,2021-05-20,847,1995,178568,12100,2021-05-20,1621465200.0
7517,24,3,2021-05-21,856,2365,179424,14465,2021-05-21,1621551600.0
7518,24,3,2021-05-22,303,1393,179727,15858,2021-05-22,1621638000.0
7519,24,3,2021-05-23,138,108,179865,15966,2021-05-23,1621724400.0
7520,24,3,2021-05-24,71,122,179936,16088,2021-05-24,1621810800.0
7521,24,3,2021-05-25,298,1393,180234,17481,2021-05-25,1621897200.0
7522,24,3,2021-05-26,274,1424,180508,18905,2021-05-26,1621983600.0
7523,24,3,2021-05-27,360,2302,180868,21207,2021-05-27,1622070000.0
7524,24,3,2021-05-28,388,3941,181256,25148,2021-05-28,1622156400.0
7525,24,3,2021-05-29,178,2831,181434,27979,2021-05-29,1622242800.0
7526,24,3,2021-05-30,45,497,181479,28476,2021-05-30,1622329200.0
7527,24,3,2021-05-31,107,1116,181586,29592,2021-05-31,1622415600.0
7528,24,3,2021-06-01,203,2437,181789,32029,2021-06-01,1622502000.0
7529,24,3,2021-06-02,129,1988,181918,34017,2021-06-02,1622588400.0
7530,24,3,2021-06-03,182,2801,182100,36818,2021-06-03,1622674800.0
7531,24,3,2021-06-04,157,4134,182257,40952,2021-06-04,1622761200.0
7532,24,3,2021-06-05,106,2671,182363,43623,2021-06-05,1622847600.0
7533,24,3,2021-06-06,17,245,182380,43868,2021-06-06,1622934000.0
7534,24,3,2021-06-07,53,1275,182433,45143,2021-06-07,1623020400.0
7535,24,3,2021-06-08,76,1834,182509,46977,2021-06-08,1623106800.0
7536,24,3,2021-06-09,111,1602,182620,48579,2021-06-09,1623193200.0
7537,24,3,2021-06-10,119,2166,182739,50745,2021-06-10,1623279600.0
7538,24,3,2021-06-11,105,3861,182844,54606,2021-06-11,1623366000.0
7539,24,3,2021-06-12,47,2131,182891,56737,2021-06-12,1623452400.0
7540,24,3,2021-06-13,2,202,182893,56939,2021-06-13,1623538800.0
7541,24,3,2021-06-14,31,1430,182924,58369,2021-06-14,1623625200.0
7542,24,3,2021-06-15,39,3278,182963,61647,2021-06-15,1623711600.0
7543,24,3,2021-06-16,49,2934,183012,64581,2021-06-16,1623798000.0
7544,24,3,2021-06-17,78,4568,183090,69149,2021-06-17,1623884400.0
7545,24,3,2021-06-18,73,4918,183163,74067,2021-06-18,1623970800.0
7546,24,3,2021-06-19,44,1895,183207,75962,2021-06-19,1624057200.0
7547,24,3,2021-06-20,8,211,183215,76173,2021-06-20,1624143600.0
7548,24,3,2021-06-21,74,1538,183289,77711,2021-06-21,1624230000.0
7549,24,3,2021-06-22,90,3038,183379,80749,2021-06-22,1624316400.0
7550,24,3,2021-06-23,37,2226,183416,82975,2021-06-23,1624402800.0
7551,24,3,2021-06-24,70,3352,183486,86327,2021-06-24,1624489200.0
7552,24,3,2021-06-25,48,3841,183534,90168,2021-06-25,1624575600.0
7553,24,3,2021-06-26,23,2106,183557,92274,2021-06-26,1624662000.0
7554,24,3,2021-06-27,11,209,183568,92483,2021-06-27,1624748400.0
7555,24,3,2021-06-28,9,1108,183577,93591,2021-06-28,1624834800.0
7556,24,3,2021-06-29,55,3026,183632,96617,2021-06-29,1624921200.0
7557,24,3,2021-06-30,37,2417,183669,99034,2021-06-30,1625007600.0
7558,24,3,2021-07-01,44,3113,183713,102147,2021-07-01,1625094000.0
7559,24,3,2021-07-02,52,4644,183765,106791,2021-07-02,1625180400.0
7560,24,3,2021-07-03,30,1709,183795,108500,2021-07-03,1625266800.0
7561,24,3,2021-07-04,9,232,183804,108732,2021-07-04,1625353200.0
7562,24,3,2021-07-05,12,1773,183816,110505,2021-07-05,1625439600.0
7563,24,3,2021-07-06,18,2883,183834,113388,2021-07-06,1625526000.0
7564,24,3,2021-07-07,32,2553,183866,115941,2021-07-07,1625612400.0
7565,24,3,2021-07-08,32,3321,183898,119262,2021-07-08,1625698800.0
7566,24,4,2020-12-27,0,0,0,0,2020-12-27,1609023600.0
7567,24,4,2020-12-28,0,0,0,0,2020-12-28,1609110000.0
7568,24,4,2020-12-29,0,0,0,0,2020-12-29,1609196400.0
7569,24,4,2020-12-30,0,0,0,0,2020-12-30,1609282800.0
7570,24,4,2020-12-31,0,0,0,0,2020-12-31,1609369200.0
7571,24,4,2021-01-01,0,0,0,0,2021-01-01,1609455600.0
7572,24,4,2021-01-02,0,0,0,0,2021-01-02,1609542000.0
7573,24,4,2021-01-03,0,0,0,0,2021-01-03,1609628400.0
7574,24,4,2021-01-04,0,0,0,0,2021-01-04,1609714800.0
7575,24,4,2021-01-05,0,0,0,0,2021-01-05,1609801200.0
7576,24,4,2021-01-06,0,0,0,0,2021-01-06,1609887600.0
7577,24,4,2021-01-07,0,0,0,0,2021-01-07,1609974000.0
7578,24,4,2021-01-08,0,0,0,0,2021-01-08,1610060400.0
7579,24,4,2021-01-09,0,0,0,0,2021-01-09,1610146800.0
7580,24,4,2021-01-10,0,0,0,0,2021-01-10,1610233200.0
7581,24,4,2021-01-11,0,0,0,0,2021-01-11,1610319600.0
7582,24,4,2021-01-12,0,0,0,0,2021-01-12,1610406000.0
7583,24,4,2021-01-13,0,0,0,0,2021-01-13,1610492400.0
7584,24,4,2021-01-14,0,0,0,0,2021-01-14,1610578800.0
7585,24,4,2021-01-15,0,0,0,0,2021-01-15,1610665200.0
7586,24,4,2021-01-16,0,0,0,0,2021-01-16,1610751600.0
7587,24,4,2021-01-17,0,0,0,0,2021-01-17,1610838000.0
7588,24,4,2021-01-18,0,0,0,0,2021-01-18,1610924400.0
7589,24,4,2021-01-19,0,0,0,0,2021-01-19,1611010800.0
7590,24,4,2021-01-20,0,0,0,0,2021-01-20,1611097200.0
7591,24,4,2021-01-21,0,0,0,0,2021-01-21,1611183600.0
7592,24,4,2021-01-22,0,0,0,0,2021-01-22,1611270000.0
7593,24,4,2021-01-23,0,0,0,0,2021-01-23,1611356400.0
7594,24,4,2021-01-24,0,0,0,0,2021-01-24,1611442800.0
7595,24,4,2021-01-25,0,0,0,0,2021-01-25,1611529200.0
7596,24,4,2021-01-26,0,0,0,0,2021-01-26,1611615600.0
7597,24,4,2021-01-27,0,0,0,0,2021-01-27,1611702000.0
7598,24,4,2021-01-28,0,0,0,0,2021-01-28,1611788400.0
7599,24,4,2021-01-29,0,0,0,0,2021-01-29,1611874800.0
7600,24,4,2021-01-30,0,0,0,0,2021-01-30,1611961200.0
7601,24,4,2021-01-31,0,0,0,0,2021-01-31,1612047600.0
7602,24,4,2021-02-01,0,0,0,0,2021-02-01,1612134000.0
7603,24,4,2021-02-02,0,0,0,0,2021-02-02,1612220400.0
7604,24,4,2021-02-03,0,0,0,0,2021-02-03,1612306800.0
7605,24,4,2021-02-04,0,0,0,0,2021-02-04,1612393200.0
7606,24,4,2021-02-05,0,0,0,0,2021-02-05,1612479600.0
7607,24,4,2021-02-06,0,0,0,0,2021-02-06,1612566000.0
7608,24,4,2021-02-07,0,0,0,0,2021-02-07,1612652400.0
7609,24,4,2021-02-08,0,0,0,0,2021-02-08,1612738800.0
7610,24,4,2021-02-09,0,0,0,0,2021-02-09,1612825200.0
7611,24,4,2021-02-10,0,0,0,0,2021-02-10,1612911600.0
7612,24,4,2021-02-11,0,0,0,0,2021-02-11,1612998000.0
7613,24,4,2021-02-12,0,0,0,0,2021-02-12,1613084400.0
7614,24,4,2021-02-13,0,0,0,0,2021-02-13,1613170800.0
7615,24,4,2021-02-14,0,0,0,0,2021-02-14,1613257200.0
7616,24,4,2021-02-15,0,0,0,0,2021-02-15,1613343600.0
7617,24,4,2021-02-16,0,0,0,0,2021-02-16,1613430000.0
7618,24,4,2021-02-17,0,0,0,0,2021-02-17,1613516400.0
7619,24,4,2021-02-18,0,0,0,0,2021-02-18,1613602800.0
7620,24,4,2021-02-19,0,0,0,0,2021-02-19,1613689200.0
7621,24,4,2021-02-20,0,0,0,0,2021-02-20,1613775600.0
7622,24,4,2021-02-21,0,0,0,0,2021-02-21,1613862000.0
7623,24,4,2021-02-22,0,0,0,0,2021-02-22,1613948400.0
7624,24,4,2021-02-23,0,0,0,0,2021-02-23,1614034800.0
7625,24,4,2021-02-24,0,0,0,0,2021-02-24,1614121200.0
7626,24,4,2021-02-25,0,0,0,0,2021-02-25,1614207600.0
7627,24,4,2021-02-26,0,0,0,0,2021-02-26,1614294000.0
7628,24,4,2021-02-27,0,0,0,0,2021-02-27,1614380400.0
7629,24,4,2021-02-28,0,0,0,0,2021-02-28,1614466800.0
7630,24,4,2021-03-01,0,0,0,0,2021-03-01,1614553200.0
7631,24,4,2021-03-02,0,0,0,0,2021-03-02,1614639600.0
7632,24,4,2021-03-03,0,0,0,0,2021-03-03,1614726000.0
7633,24,4,2021-03-04,0,0,0,0,2021-03-04,1614812400.0
7634,24,4,2021-03-05,0,0,0,0,2021-03-05,1614898800.0
7635,24,4,2021-03-06,0,0,0,0,2021-03-06,1614985200.0
7636,24,4,2021-03-07,0,0,0,0,2021-03-07,1615071600.0
7637,24,4,2021-03-08,0,0,0,0,2021-03-08,1615158000.0
7638,24,4,2021-03-09,0,0,0,0,2021-03-09,1615244400.0
7639,24,4,2021-03-10,0,0,0,0,2021-03-10,1615330800.0
7640,24,4,2021-03-11,0,0,0,0,2021-03-11,1615417200.0
7641,24,4,2021-03-12,0,0,0,0,2021-03-12,1615503600.0
7642,24,4,2021-03-13,0,0,0,0,2021-03-13,1615590000.0
7643,24,4,2021-03-14,0,0,0,0,2021-03-14,1615676400.0
7644,24,4,2021-03-15,0,0,0,0,2021-03-15,1615762800.0
7645,24,4,2021-03-16,0,0,0,0,2021-03-16,1615849200.0
7646,24,4,2021-03-17,0,0,0,0,2021-03-17,1615935600.0
7647,24,4,2021-03-18,0,0,0,0,2021-03-18,1616022000.0
7648,24,4,2021-03-19,0,0,0,0,2021-03-19,1616108400.0
7649,24,4,2021-03-20,0,0,0,0,2021-03-20,1616194800.0
7650,24,4,2021-03-21,0,0,0,0,2021-03-21,1616281200.0
7651,24,4,2021-03-22,0,0,0,0,2021-03-22,1616367600.0
7652,24,4,2021-03-23,0,0,0,0,2021-03-23,1616454000.0
7653,24,4,2021-03-24,0,0,0,0,2021-03-24,1616540400.0
7654,24,4,2021-03-25,0,0,0,0,2021-03-25,1616626800.0
7655,24,4,2021-03-26,0,0,0,0,2021-03-26,1616713200.0
7656,24,4,2021-03-27,0,0,0,0,2021-03-27,1616799600.0
7657,24,4,2021-03-28,0,0,0,0,2021-03-28,1616886000.0
7658,24,4,2021-03-29,0,0,0,0,2021-03-29,1616972400.0
7659,24,4,2021-03-30,0,0,0,0,2021-03-30,1617058800.0
7660,24,4,2021-03-31,0,0,0,0,2021-03-31,1617145200.0
7661,24,4,2021-04-01,0,0,0,0,2021-04-01,1617231600.0
7662,24,4,2021-04-02,0,0,0,0,2021-04-02,1617318000.0
7663,24,4,2021-04-03,0,0,0,0,2021-04-03,1617404400.0
7664,24,4,2021-04-04,0,0,0,0,2021-04-04,1617490800.0
7665,24,4,2021-04-05,0,0,0,0,2021-04-05,1617577200.0
7666,24,4,2021-04-06,0,0,0,0,2021-04-06,1617663600.0
7667,24,4,2021-04-07,0,0,0,0,2021-04-07,1617750000.0
7668,24,4,2021-04-08,0,0,0,0,2021-04-08,1617836400.0
7669,24,4,2021-04-09,0,0,0,0,2021-04-09,1617922800.0
7670,24,4,2021-04-10,0,0,0,0,2021-04-10,1618009200.0
7671,24,4,2021-04-11,0,0,0,0,2021-04-11,1618095600.0
7672,24,4,2021-04-12,0,0,0,0,2021-04-12,1618185600.0
7673,24,4,2021-04-13,0,0,0,0,2021-04-13,1618272000.0
7674,24,4,2021-04-14,0,0,0,0,2021-04-14,1618358400.0
7675,24,4,2021-04-15,0,0,0,0,2021-04-15,1618444800.0
7676,24,4,2021-04-16,0,0,0,0,2021-04-16,1618531200.0
7677,24,4,2021-04-17,0,0,0,0,2021-04-17,1618617600.0
7678,24,4,2021-04-18,0,0,0,0,2021-04-18,1618704000.0
7679,24,4,2021-04-19,0,0,0,0,2021-04-19,1618790400.0
7680,24,4,2021-04-20,0,0,0,0,2021-04-20,1618876800.0
7681,24,4,2021-04-21,0,0,0,0,2021-04-21,1618963200.0
7682,24,4,2021-04-22,0,0,0,0,2021-04-22,1619049600.0
7683,24,4,2021-04-23,21,0,21,0,2021-04-23,1619136000.0
7684,24,4,2021-04-24,76,0,97,0,2021-04-24,1619222400.0
7685,24,4,2021-04-25,1,0,98,0,2021-04-25,1619308800.0
7686,24,4,2021-04-26,95,0,193,0,2021-04-26,1619395200.0
7687,24,4,2021-04-27,444,0,637,0,2021-04-27,1619481600.0
7688,24,4,2021-04-28,387,0,1024,0,2021-04-28,1619568000.0
7689,24,4,2021-04-29,687,0,1711,0,2021-04-29,1619654400.0
7690,24,4,2021-04-30,811,0,2522,0,2021-04-30,1619740800.0
7691,24,4,2021-05-01,72,0,2594,0,2021-05-01,1619827200.0
7692,24,4,2021-05-02,20,0,2614,0,2021-05-02,1619913600.0
7693,24,4,2021-05-03,165,0,2779,0,2021-05-03,1620000000.0
7694,24,4,2021-05-04,211,0,2990,0,2021-05-04,1620086400.0
7695,24,4,2021-05-05,266,0,3256,0,2021-05-05,1620172800.0
7696,24,4,2021-05-06,481,0,3737,0,2021-05-06,1620259200.0
7697,24,4,2021-05-07,900,0,4637,0,2021-05-07,1620345600.0
7698,24,4,2021-05-08,204,0,4841,0,2021-05-08,1620432000.0
7699,24,4,2021-05-09,25,1,4866,1,2021-05-09,1620518400.0
7700,24,4,2021-05-10,370,0,5236,1,2021-05-10,1620604800.0
7701,24,4,2021-05-11,683,1,5919,2,2021-05-11,1620691200.0
7702,24,4,2021-05-12,416,0,6335,2,2021-05-12,1620777600.0
7703,24,4,2021-05-13,114,0,6449,2,2021-05-13,1620864000.0
7704,24,4,2021-05-14,401,0,6850,2,2021-05-14,1620950400.0
7705,24,4,2021-05-15,142,0,6992,2,2021-05-15,1621036800.0
7706,24,4,2021-05-16,0,0,6992,2,2021-05-16,1621123200.0
7707,24,4,2021-05-17,198,0,7190,2,2021-05-17,1621206000.0
7708,24,4,2021-05-18,413,0,7603,2,2021-05-18,1621292400.0
7709,24,4,2021-05-19,218,0,7821,2,2021-05-19,1621378800.0
7710,24,4,2021-05-20,479,0,8300,2,2021-05-20,1621465200.0
7711,24,4,2021-05-21,539,0,8839,2,2021-05-21,1621551600.0
7712,24,4,2021-05-22,177,0,9016,2,2021-05-22,1621638000.0
7713,24,4,2021-05-23,27,0,9043,2,2021-05-23,1621724400.0
7714,24,4,2021-05-24,49,0,9092,2,2021-05-24,1621810800.0
7715,24,4,2021-05-25,404,1,9496,3,2021-05-25,1621897200.0
7716,24,4,2021-05-26,313,0,9809,3,2021-05-26,1621983600.0
7717,24,4,2021-05-27,647,0,10456,3,2021-05-27,1622070000.0
7718,24,4,2021-05-28,1326,5,11782,8,2021-05-28,1622156400.0
7719,24,4,2021-05-29,609,0,12391,8,2021-05-29,1622242800.0
7720,24,4,2021-05-30,16,0,12407,8,2021-05-30,1622329200.0
7721,24,4,2021-05-31,521,0,12928,8,2021-05-31,1622415600.0
7722,24,4,2021-06-01,1063,1,13991,9,2021-06-01,1622502000.0
7723,24,4,2021-06-02,547,0,14538,9,2021-06-02,1622588400.0
7724,24,4,2021-06-03,879,0,15417,9,2021-06-03,1622674800.0
7725,24,4,2021-06-04,1042,0,16459,9,2021-06-04,1622761200.0
7726,24,4,2021-06-05,537,0,16996,9,2021-06-05,1622847600.0
7727,24,4,2021-06-06,20,0,17016,9,2021-06-06,1622934000.0
7728,24,4,2021-06-07,357,1,17373,10,2021-06-07,1623020400.0
7729,24,4,2021-06-08,824,1,18197,11,2021-06-08,1623106800.0
7730,24,4,2021-06-09,579,1,18776,12,2021-06-09,1623193200.0
7731,24,4,2021-06-10,650,2,19426,14,2021-06-10,1623279600.0
7732,24,4,2021-06-11,863,0,20289,14,2021-06-11,1623366000.0
7733,24,4,2021-06-12,390,1,20679,15,2021-06-12,1623452400.0
7734,24,4,2021-06-13,22,6,20701,21,2021-06-13,1623538800.0
7735,24,4,2021-06-14,304,1,21005,22,2021-06-14,1623625200.0
7736,24,4,2021-06-15,420,4,21425,26,2021-06-15,1623711600.0
7737,24,4,2021-06-16,330,0,21755,26,2021-06-16,1623798000.0
7738,24,4,2021-06-17,431,9,22186,35,2021-06-17,1623884400.0
7739,24,4,2021-06-18,501,0,22687,35,2021-06-18,1623970800.0
7740,24,4,2021-06-19,244,0,22931,35,2021-06-19,1624057200.0
7741,24,4,2021-06-20,14,0,22945,35,2021-06-20,1624143600.0
7742,24,4,2021-06-21,254,0,23199,35,2021-06-21,1624230000.0
7743,24,4,2021-06-22,415,1,23614,36,2021-06-22,1624316400.0
7744,24,4,2021-06-23,369,0,23983,36,2021-06-23,1624402800.0
7745,24,4,2021-06-24,380,0,24363,36,2021-06-24,1624489200.0
7746,24,4,2021-06-25,478,0,24841,36,2021-06-25,1624575600.0
7747,24,4,2021-06-26,229,1,25070,37,2021-06-26,1624662000.0
7748,24,4,2021-06-27,31,1,25101,38,2021-06-27,1624748400.0
7749,24,4,2021-06-28,197,1,25298,39,2021-06-28,1624834800.0
7750,24,4,2021-06-29,308,0,25606,39,2021-06-29,1624921200.0
7751,24,4,2021-06-30,263,1,25869,40,2021-06-30,1625007600.0
7752,24,4,2021-07-01,294,2,26163,42,2021-07-01,1625094000.0
7753,24,4,2021-07-02,424,1,26587,43,2021-07-02,1625180400.0
7754,24,4,2021-07-03,188,0,26775,43,2021-07-03,1625266800.0
7755,24,4,2021-07-04,25,0,26800,43,2021-07-04,1625353200.0
7756,24,4,2021-07-05,193,1,26993,44,2021-07-05,1625439600.0
7757,24,4,2021-07-06,337,0,27330,44,2021-07-06,1625526000.0
7758,24,4,2021-07-07,286,1,27616,45,2021-07-07,1625612400.0
7759,24,4,2021-07-08,324,1,27940,46,2021-07-08,1625698800.0
7760,27,1,2020-12-27,4,0,4,0,2020-12-27,1609023600.0
7761,27,1,2020-12-28,0,0,4,0,2020-12-28,1609110000.0
7762,27,1,2020-12-29,19,0,23,0,2020-12-29,1609196400.0
7763,27,1,2020-12-30,20,0,43,0,2020-12-30,1609282800.0
7764,27,1,2020-12-31,2,0,45,0,2020-12-31,1609369200.0
7765,27,1,2021-01-01,0,0,45,0,2021-01-01,1609455600.0
7766,27,1,2021-01-02,1,0,46,0,2021-01-02,1609542000.0
7767,27,1,2021-01-03,1,0,47,0,2021-01-03,1609628400.0
7768,27,1,2021-01-04,28,0,75,0,2021-01-04,1609714800.0
7769,27,1,2021-01-05,263,0,338,0,2021-01-05,1609801200.0
7770,27,1,2021-01-06,718,0,1056,0,2021-01-06,1609887600.0
7771,27,1,2021-01-07,1582,0,2638,0,2021-01-07,1609974000.0
7772,27,1,2021-01-08,1896,0,4534,0,2021-01-08,1610060400.0
7773,27,1,2021-01-09,688,0,5222,0,2021-01-09,1610146800.0
7774,27,1,2021-01-10,3,0,5225,0,2021-01-10,1610233200.0
7775,27,1,2021-01-11,2420,0,7645,0,2021-01-11,1610319600.0
7776,27,1,2021-01-12,3824,0,11469,0,2021-01-12,1610406000.0
7777,27,1,2021-01-13,3849,0,15318,0,2021-01-13,1610492400.0
7778,27,1,2021-01-14,4736,0,20054,0,2021-01-14,1610578800.0
7779,27,1,2021-01-15,3594,0,23648,0,2021-01-15,1610665200.0
7780,27,1,2021-01-16,781,5,24429,5,2021-01-16,1610751600.0
7781,27,1,2021-01-17,116,1,24545,6,2021-01-17,1610838000.0
7782,27,1,2021-01-18,5394,10,29939,16,2021-01-18,1610924400.0
7783,27,1,2021-01-19,7260,8,37199,24,2021-01-19,1611010800.0
7784,27,1,2021-01-20,6599,48,43798,72,2021-01-20,1611097200.0
7785,27,1,2021-01-21,8044,8,51842,80,2021-01-21,1611183600.0
7786,27,1,2021-01-22,6402,6,58244,86,2021-01-22,1611270000.0
7787,27,1,2021-01-23,2418,6,60662,92,2021-01-23,1611356400.0
7788,27,1,2021-01-24,347,0,61009,92,2021-01-24,1611442800.0
7789,27,1,2021-01-25,4037,24,65046,116,2021-01-25,1611529200.0
7790,27,1,2021-01-26,5952,223,70998,339,2021-01-26,1611615600.0
7791,27,1,2021-01-27,5737,339,76735,678,2021-01-27,1611702000.0
7792,27,1,2021-01-28,5047,886,81782,1564,2021-01-28,1611788400.0
7793,27,1,2021-01-29,4831,1255,86613,2819,2021-01-29,1611874800.0
7794,27,1,2021-01-30,2019,347,88632,3166,2021-01-30,1611961200.0
7795,27,1,2021-01-31,252,22,88884,3188,2021-01-31,1612047600.0
7796,27,1,2021-02-01,2072,1389,90956,4577,2021-02-01,1612134000.0
7797,27,1,2021-02-02,2261,2216,93217,6793,2021-02-02,1612220400.0
7798,27,1,2021-02-03,1623,2378,94840,9171,2021-02-03,1612306800.0
7799,27,1,2021-02-04,1574,3149,96414,12320,2021-02-04,1612393200.0
7800,27,1,2021-02-05,1237,2585,97651,14905,2021-02-05,1612479600.0
7801,27,1,2021-02-06,662,667,98313,15572,2021-02-06,1612566000.0
7802,27,1,2021-02-07,3,87,98316,15659,2021-02-07,1612652400.0
7803,27,1,2021-02-08,741,2678,99057,18337,2021-02-08,1612738800.0
7804,27,1,2021-02-09,851,3610,99908,21947,2021-02-09,1612825200.0
7805,27,1,2021-02-10,767,3373,100675,25320,2021-02-10,1612911600.0
7806,27,1,2021-02-11,1488,4616,102163,29936,2021-02-11,1612998000.0
7807,27,1,2021-02-12,1125,4422,103288,34358,2021-02-12,1613084400.0
7808,27,1,2021-02-13,274,1383,103562,35741,2021-02-13,1613170800.0
7809,27,1,2021-02-14,28,289,103590,36030,2021-02-14,1613257200.0
7810,27,1,2021-02-15,745,4891,104335,40921,2021-02-15,1613343600.0
7811,27,1,2021-02-16,1017,6363,105352,47284,2021-02-16,1613430000.0
7812,27,1,2021-02-17,1418,5684,106770,52968,2021-02-17,1613516400.0
7813,27,1,2021-02-18,1507,4942,108277,57910,2021-02-18,1613602800.0
7814,27,1,2021-02-19,1341,4430,109618,62340,2021-02-19,1613689200.0
7815,27,1,2021-02-20,542,1597,110160,63937,2021-02-20,1613775600.0
7816,27,1,2021-02-21,1,280,110161,64217,2021-02-21,1613862000.0
7817,27,1,2021-02-22,549,3611,110710,67828,2021-02-22,1613948400.0
7818,27,1,2021-02-23,614,4061,111324,71889,2021-02-23,1614034800.0
7819,27,1,2021-02-24,676,3502,112000,75391,2021-02-24,1614121200.0
7820,27,1,2021-02-25,745,3735,112745,79126,2021-02-25,1614207600.0
7821,27,1,2021-02-26,826,2909,113571,82035,2021-02-26,1614294000.0
7822,27,1,2021-02-27,306,1480,113877,83515,2021-02-27,1614380400.0
7823,27,1,2021-02-28,4,278,113881,83793,2021-02-28,1614466800.0
7824,27,1,2021-03-01,2490,1882,116371,85675,2021-03-01,1614553200.0
7825,27,1,2021-03-02,3260,2135,119631,87810,2021-03-02,1614639600.0
7826,27,1,2021-03-03,3568,1578,123199,89388,2021-03-03,1614726000.0
7827,27,1,2021-03-04,4345,1642,127544,91030,2021-03-04,1614812400.0
7828,27,1,2021-03-05,4216,1378,131760,92408,2021-03-05,1614898800.0
7829,27,1,2021-03-06,1019,358,132779,92766,2021-03-06,1614985200.0
7830,27,1,2021-03-07,14,173,132793,92939,2021-03-07,1615071600.0
7831,27,1,2021-03-08,2874,872,135667,93811,2021-03-08,1615158000.0
7832,27,1,2021-03-09,4580,1376,140247,95187,2021-03-09,1615244400.0
7833,27,1,2021-03-10,5271,1053,145518,96240,2021-03-10,1615330800.0
7834,27,1,2021-03-11,5617,1615,151135,97855,2021-03-11,1615417200.0
7835,27,1,2021-03-12,5161,1234,156296,99089,2021-03-12,1615503600.0
7836,27,1,2021-03-13,1446,300,157742,99389,2021-03-13,1615590000.0
7837,27,1,2021-03-14,4,12,157746,99401,2021-03-14,1615676400.0
7838,27,1,2021-03-15,5015,890,162761,100291,2021-03-15,1615762800.0
7839,27,1,2021-03-16,6977,737,169738,101028,2021-03-16,1615849200.0
7840,27,1,2021-03-17,6572,917,176310,101945,2021-03-17,1615935600.0
7841,27,1,2021-03-18,6965,1084,183275,103029,2021-03-18,1616022000.0
7842,27,1,2021-03-19,5111,701,188386,103730,2021-03-19,1616108400.0
7843,27,1,2021-03-20,1212,242,189598,103972,2021-03-20,1616194800.0
7844,27,1,2021-03-21,2,4,189600,103976,2021-03-21,1616281200.0
7845,27,1,2021-03-22,7168,717,196768,104693,2021-03-22,1616367600.0
7846,27,1,2021-03-23,9547,834,206315,105527,2021-03-23,1616454000.0
7847,27,1,2021-03-24,8884,838,215199,106365,2021-03-24,1616540400.0
7848,27,1,2021-03-25,9272,987,224471,107352,2021-03-25,1616626800.0
7849,27,1,2021-03-26,9326,742,233797,108094,2021-03-26,1616713200.0
7850,27,1,2021-03-27,3732,215,237529,108309,2021-03-27,1616799600.0
7851,27,1,2021-03-28,102,116,237631,108425,2021-03-28,1616886000.0
7852,27,1,2021-03-29,6812,3077,244443,111502,2021-03-29,1616972400.0
7853,27,1,2021-03-30,7155,3570,251598,115072,2021-03-30,1617058800.0
7854,27,1,2021-03-31,7343,3684,258941,118756,2021-03-31,1617145200.0
7855,27,1,2021-04-01,7282,3549,266223,122305,2021-04-01,1617231600.0
7856,27,1,2021-04-02,6457,3553,272680,125858,2021-04-02,1617318000.0
7857,27,1,2021-04-03,2124,956,274804,126814,2021-04-03,1617404400.0
7858,27,1,2021-04-04,40,30,274844,126844,2021-04-04,1617490800.0
7859,27,1,2021-04-05,207,1,275051,126845,2021-04-05,1617577200.0
7860,27,1,2021-04-06,6244,5495,281295,132340,2021-04-06,1617663600.0
7861,27,1,2021-04-07,6859,5984,288154,138324,2021-04-07,1617750000.0
7862,27,1,2021-04-08,8560,5300,296714,143624,2021-04-08,1617836400.0
7863,27,1,2021-04-09,8026,5025,304740,148649,2021-04-09,1617922800.0
7864,27,1,2021-04-10,1942,1595,306682,150244,2021-04-10,1618009200.0
7865,27,1,2021-04-11,79,73,306761,150317,2021-04-11,1618095600.0
7866,27,1,2021-04-12,6868,5726,313629,156043,2021-04-12,1618185600.0
7867,27,1,2021-04-13,7328,6857,320957,162900,2021-04-13,1618272000.0
7868,27,1,2021-04-14,7256,5507,328213,168407,2021-04-14,1618358400.0
7869,27,1,2021-04-15,8505,5636,336718,174043,2021-04-15,1618444800.0
7870,27,1,2021-04-16,7521,4676,344239,178719,2021-04-16,1618531200.0
7871,27,1,2021-04-17,3643,1780,347882,180499,2021-04-17,1618617600.0
7872,27,1,2021-04-18,85,22,347967,180521,2021-04-18,1618704000.0
7873,27,1,2021-04-19,5202,7388,353169,187909,2021-04-19,1618790400.0
7874,27,1,2021-04-20,5281,9117,358450,197026,2021-04-20,1618876800.0
7875,27,1,2021-04-21,5283,7664,363733,204690,2021-04-21,1618963200.0
7876,27,1,2021-04-22,5455,8411,369188,213101,2021-04-22,1619049600.0
7877,27,1,2021-04-23,5931,8108,375119,221209,2021-04-23,1619136000.0
7878,27,1,2021-04-24,2176,3039,377295,224248,2021-04-24,1619222400.0
7879,27,1,2021-04-25,294,106,377589,224354,2021-04-25,1619308800.0
7880,27,1,2021-04-26,8562,7371,386151,231725,2021-04-26,1619395200.0
7881,27,1,2021-04-27,10667,7745,396818,239470,2021-04-27,1619481600.0
7882,27,1,2021-04-28,11180,6786,407998,246256,2021-04-28,1619568000.0
7883,27,1,2021-04-29,13677,6298,421675,252554,2021-04-29,1619654400.0
7884,27,1,2021-04-30,14350,4997,436025,257551,2021-04-30,1619740800.0
7885,27,1,2021-05-01,5112,860,441137,258411,2021-05-01,1619827200.0
7886,27,1,2021-05-02,568,8,441705,258419,2021-05-02,1619913600.0
7887,27,1,2021-05-03,13880,4666,455585,263085,2021-05-03,1620000000.0
7888,27,1,2021-05-04,12076,7142,467661,270227,2021-05-04,1620086400.0
7889,27,1,2021-05-05,14402,6308,482063,276535,2021-05-05,1620172800.0
7890,27,1,2021-05-06,15639,7037,497702,283572,2021-05-06,1620259200.0
7891,27,1,2021-05-07,13726,6303,511428,289875,2021-05-07,1620345600.0
7892,27,1,2021-05-08,5476,559,516904,290434,2021-05-08,1620432000.0
7893,27,1,2021-05-09,382,140,517286,290574,2021-05-09,1620518400.0
7894,27,1,2021-05-10,13608,7759,530894,298333,2021-05-10,1620604800.0
7895,27,1,2021-05-11,17507,9216,548401,307549,2021-05-11,1620691200.0
7896,27,1,2021-05-12,16722,8609,565123,316158,2021-05-12,1620777600.0
7897,27,1,2021-05-13,9432,907,574555,317065,2021-05-13,1620864000.0
7898,27,1,2021-05-14,18340,5391,592895,322456,2021-05-14,1620950400.0
7899,27,1,2021-05-15,8228,1367,601123,323823,2021-05-15,1621036800.0
7900,27,1,2021-05-16,1543,67,602666,323890,2021-05-16,1621123200.0
7901,27,1,2021-05-17,15984,4554,618650,328444,2021-05-17,1621206000.0
7902,27,1,2021-05-18,17289,5425,635939,333869,2021-05-18,1621292400.0
7903,27,1,2021-05-19,20249,4033,656188,337902,2021-05-19,1621378800.0
7904,27,1,2021-05-20,20340,3912,676528,341814,2021-05-20,1621465200.0
7905,27,1,2021-05-21,17314,4951,693842,346765,2021-05-21,1621551600.0
7906,27,1,2021-05-22,6716,976,700558,347741,2021-05-22,1621638000.0
7907,27,1,2021-05-23,880,111,701438,347852,2021-05-23,1621724400.0
7908,27,1,2021-05-24,1929,562,703367,348414,2021-05-24,1621810800.0
7909,27,1,2021-05-25,12280,7917,715647,356331,2021-05-25,1621897200.0
7910,27,1,2021-05-26,12255,6757,727902,363088,2021-05-26,1621983600.0
7911,27,1,2021-05-27,14939,6100,742841,369188,2021-05-27,1622070000.0
7912,27,1,2021-05-28,11429,7282,754270,376470,2021-05-28,1622156400.0
7913,27,1,2021-05-29,3802,1787,758072,378257,2021-05-29,1622242800.0
7914,27,1,2021-05-30,113,81,758185,378338,2021-05-30,1622329200.0
7915,27,1,2021-05-31,9392,7247,767577,385585,2021-05-31,1622415600.0
7916,27,1,2021-06-01,12198,6834,779775,392419,2021-06-01,1622502000.0
7917,27,1,2021-06-02,12885,5092,792660,397511,2021-06-02,1622588400.0
7918,27,1,2021-06-03,13591,4889,806251,402400,2021-06-03,1622674800.0
7919,27,1,2021-06-04,10639,6951,816890,409351,2021-06-04,1622761200.0
7920,27,1,2021-06-05,5164,2087,822054,411438,2021-06-05,1622847600.0
7921,27,1,2021-06-06,978,207,823032,411645,2021-06-06,1622934000.0
7922,27,1,2021-06-07,15756,9351,838788,420996,2021-06-07,1623020400.0
7923,27,1,2021-06-08,17225,9544,856013,430540,2021-06-08,1623106800.0
7924,27,1,2021-06-09,17193,7971,873206,438511,2021-06-09,1623193200.0
7925,27,1,2021-06-10,16625,8247,889831,446758,2021-06-10,1623279600.0
7926,27,1,2021-06-11,14843,9981,904674,456739,2021-06-11,1623366000.0
7927,27,1,2021-06-12,7520,4606,912194,461345,2021-06-12,1623452400.0
7928,27,1,2021-06-13,728,558,912922,461903,2021-06-13,1623538800.0
7929,27,1,2021-06-14,9722,13430,922644,475333,2021-06-14,1623625200.0
7930,27,1,2021-06-15,12105,11703,934749,487036,2021-06-15,1623711600.0
7931,27,1,2021-06-16,13123,10537,947872,497573,2021-06-16,1623798000.0
7932,27,1,2021-06-17,13384,10161,961256,507734,2021-06-17,1623884400.0
7933,27,1,2021-06-18,12217,12096,973473,519830,2021-06-18,1623970800.0
7934,27,1,2021-06-19,6287,5904,979760,525734,2021-06-19,1624057200.0
7935,27,1,2021-06-20,74,339,979834,526073,2021-06-20,1624143600.0
7936,27,1,2021-06-21,6973,14349,986807,540422,2021-06-21,1624230000.0
7937,27,1,2021-06-22,8214,17374,995021,557796,2021-06-22,1624316400.0
7938,27,1,2021-06-23,10147,13062,1005168,570858,2021-06-23,1624402800.0
7939,27,1,2021-06-24,8919,10759,1014087,581617,2021-06-24,1624489200.0
7940,27,1,2021-06-25,7388,17472,1021475,599089,2021-06-25,1624575600.0
7941,27,1,2021-06-26,4162,8340,1025637,607429,2021-06-26,1624662000.0
7942,27,1,2021-06-27,578,1302,1026215,608731,2021-06-27,1624748400.0
7943,27,1,2021-06-28,5632,17019,1031847,625750,2021-06-28,1624834800.0
7944,27,1,2021-06-29,6146,17140,1037993,642890,2021-06-29,1624921200.0
7945,27,1,2021-06-30,8134,17697,1046127,660587,2021-06-30,1625007600.0
7946,27,1,2021-07-01,7973,15218,1054100,675805,2021-07-01,1625094000.0
7947,27,1,2021-07-02,9164,12415,1063264,688220,2021-07-02,1625180400.0
7948,27,1,2021-07-03,3769,6321,1067033,694541,2021-07-03,1625266800.0
7949,27,1,2021-07-04,431,691,1067464,695232,2021-07-04,1625353200.0
7950,27,1,2021-07-05,8166,11898,1075630,707130,2021-07-05,1625439600.0
7951,27,1,2021-07-06,8255,14534,1083885,721664,2021-07-06,1625526000.0
7952,27,1,2021-07-07,7515,11286,1091400,732950,2021-07-07,1625612400.0
7953,27,1,2021-07-08,7888,10384,1099288,743334,2021-07-08,1625698800.0
7954,27,2,2020-12-27,0,0,0,0,2020-12-27,1609023600.0
7955,27,2,2020-12-28,0,0,0,0,2020-12-28,1609110000.0
7956,27,2,2020-12-29,0,0,0,0,2020-12-29,1609196400.0
7957,27,2,2020-12-30,0,0,0,0,2020-12-30,1609282800.0
7958,27,2,2020-12-31,0,0,0,0,2020-12-31,1609369200.0
7959,27,2,2021-01-01,0,0,0,0,2021-01-01,1609455600.0
7960,27,2,2021-01-02,0,0,0,0,2021-01-02,1609542000.0
7961,27,2,2021-01-03,0,0,0,0,2021-01-03,1609628400.0
7962,27,2,2021-01-04,0,0,0,0,2021-01-04,1609714800.0
7963,27,2,2021-01-05,0,0,0,0,2021-01-05,1609801200.0
7964,27,2,2021-01-06,0,0,0,0,2021-01-06,1609887600.0
7965,27,2,2021-01-07,0,0,0,0,2021-01-07,1609974000.0
7966,27,2,2021-01-08,0,0,0,0,2021-01-08,1610060400.0
7967,27,2,2021-01-09,0,0,0,0,2021-01-09,1610146800.0
7968,27,2,2021-01-10,0,0,0,0,2021-01-10,1610233200.0
7969,27,2,2021-01-11,0,0,0,0,2021-01-11,1610319600.0
7970,27,2,2021-01-12,0,0,0,0,2021-01-12,1610406000.0
7971,27,2,2021-01-13,0,0,0,0,2021-01-13,1610492400.0
7972,27,2,2021-01-14,16,0,16,0,2021-01-14,1610578800.0
7973,27,2,2021-01-15,9,0,25,0,2021-01-15,1610665200.0
7974,27,2,2021-01-16,14,0,39,0,2021-01-16,1610751600.0
7975,27,2,2021-01-17,0,0,39,0,2021-01-17,1610838000.0
7976,27,2,2021-01-18,862,0,901,0,2021-01-18,1610924400.0
7977,27,2,2021-01-19,1142,0,2043,0,2021-01-19,1611010800.0
7978,27,2,2021-01-20,1311,0,3354,0,2021-01-20,1611097200.0
7979,27,2,2021-01-21,1417,0,4771,0,2021-01-21,1611183600.0
7980,27,2,2021-01-22,1309,0,6080,0,2021-01-22,1611270000.0
7981,27,2,2021-01-23,568,0,6648,0,2021-01-23,1611356400.0
7982,27,2,2021-01-24,0,0,6648,0,2021-01-24,1611442800.0
7983,27,2,2021-01-25,1185,0,7833,0,2021-01-25,1611529200.0
7984,27,2,2021-01-26,1438,0,9271,0,2021-01-26,1611615600.0
7985,27,2,2021-01-27,1361,0,10632,0,2021-01-27,1611702000.0
7986,27,2,2021-01-28,1290,0,11922,0,2021-01-28,1611788400.0
7987,27,2,2021-01-29,1101,0,13023,0,2021-01-29,1611874800.0
7988,27,2,2021-01-30,477,0,13500,0,2021-01-30,1611961200.0
7989,27,2,2021-01-31,0,0,13500,0,2021-01-31,1612047600.0
7990,27,2,2021-02-01,1287,0,14787,0,2021-02-01,1612134000.0
7991,27,2,2021-02-02,1779,0,16566,0,2021-02-02,1612220400.0
7992,27,2,2021-02-03,1995,0,18561,0,2021-02-03,1612306800.0
7993,27,2,2021-02-04,2128,1,20689,1,2021-02-04,1612393200.0
7994,27,2,2021-02-05,2002,2,22691,3,2021-02-05,1612479600.0
7995,27,2,2021-02-06,942,2,23633,5,2021-02-06,1612566000.0
7996,27,2,2021-02-07,2,0,23635,5,2021-02-07,1612652400.0
7997,27,2,2021-02-08,2112,0,25747,5,2021-02-08,1612738800.0
7998,27,2,2021-02-09,1907,1,27654,6,2021-02-09,1612825200.0
7999,27,2,2021-02-10,1709,1,29363,7,2021-02-10,1612911600.0
8000,27,2,2021-02-11,1459,12,30822,19,2021-02-11,1612998000.0
8001,27,2,2021-02-12,1138,12,31960,31,2021-02-12,1613084400.0
8002,27,2,2021-02-13,444,68,32404,99,2021-02-13,1613170800.0
8003,27,2,2021-02-14,9,0,32413,99,2021-02-14,1613257200.0
8004,27,2,2021-02-15,172,844,32585,943,2021-02-15,1613343600.0
8005,27,2,2021-02-16,162,1050,32747,1993,2021-02-16,1613430000.0
8006,27,2,2021-02-17,14,1195,32761,3188,2021-02-17,1613516400.0
8007,27,2,2021-02-18,123,1469,32884,4657,2021-02-18,1613602800.0
8008,27,2,2021-02-19,66,1203,32950,5860,2021-02-19,1613689200.0
8009,27,2,2021-02-20,56,579,33006,6439,2021-02-20,1613775600.0
8010,27,2,2021-02-21,0,0,33006,6439,2021-02-21,1613862000.0
8011,27,2,2021-02-22,20,1232,33026,7671,2021-02-22,1613948400.0
8012,27,2,2021-02-23,8,1344,33034,9015,2021-02-23,1614034800.0
8013,27,2,2021-02-24,29,1308,33063,10323,2021-02-24,1614121200.0
8014,27,2,2021-02-25,24,1266,33087,11589,2021-02-25,1614207600.0
8015,27,2,2021-02-26,38,1235,33125,12824,2021-02-26,1614294000.0
8016,27,2,2021-02-27,3,453,33128,13277,2021-02-27,1614380400.0
8017,27,2,2021-02-28,1,1,33129,13278,2021-02-28,1614466800.0
8018,27,2,2021-03-01,74,1571,33203,14849,2021-03-01,1614553200.0
8019,27,2,2021-03-02,80,2105,33283,16954,2021-03-02,1614639600.0
8020,27,2,2021-03-03,103,1906,33386,18860,2021-03-03,1614726000.0
8021,27,2,2021-03-04,143,1772,33529,20632,2021-03-04,1614812400.0
8022,27,2,2021-03-05,113,1631,33642,22263,2021-03-05,1614898800.0
8023,27,2,2021-03-06,87,649,33729,22912,2021-03-06,1614985200.0
8024,27,2,2021-03-07,0,6,33729,22918,2021-03-07,1615071600.0
8025,27,2,2021-03-08,157,2470,33886,25388,2021-03-08,1615158000.0
8026,27,2,2021-03-09,229,1865,34115,27253,2021-03-09,1615244400.0
8027,27,2,2021-03-10,171,1586,34286,28839,2021-03-10,1615330800.0
8028,27,2,2021-03-11,156,1428,34442,30267,2021-03-11,1615417200.0
8029,27,2,2021-03-12,205,1038,34647,31305,2021-03-12,1615503600.0
8030,27,2,2021-03-13,142,300,34789,31605,2021-03-13,1615590000.0
8031,27,2,2021-03-14,0,47,34789,31652,2021-03-14,1615676400.0
8032,27,2,2021-03-15,677,347,35466,31999,2021-03-15,1615762800.0
8033,27,2,2021-03-16,1239,157,36705,32156,2021-03-16,1615849200.0
8034,27,2,2021-03-17,1942,18,38647,32174,2021-03-17,1615935600.0
8035,27,2,2021-03-18,1593,104,40240,32278,2021-03-18,1616022000.0
8036,27,2,2021-03-19,1336,125,41576,32403,2021-03-19,1616108400.0
8037,27,2,2021-03-20,1377,37,42953,32440,2021-03-20,1616194800.0
8038,27,2,2021-03-21,161,0,43114,32440,2021-03-21,1616281200.0
8039,27,2,2021-03-22,980,11,44094,32451,2021-03-22,1616367600.0
8040,27,2,2021-03-23,1223,7,45317,32458,2021-03-23,1616454000.0
8041,27,2,2021-03-24,2112,4,47429,32462,2021-03-24,1616540400.0
8042,27,2,2021-03-25,2368,19,49797,32481,2021-03-25,1616626800.0
8043,27,2,2021-03-26,1399,37,51196,32518,2021-03-26,1616713200.0
8044,27,2,2021-03-27,1016,0,52212,32518,2021-03-27,1616799600.0
8045,27,2,2021-03-28,193,0,52405,32518,2021-03-28,1616886000.0
8046,27,2,2021-03-29,821,66,53226,32584,2021-03-29,1616972400.0
8047,27,2,2021-03-30,1445,62,54671,32646,2021-03-30,1617058800.0
8048,27,2,2021-03-31,2577,67,57248,32713,2021-03-31,1617145200.0
8049,27,2,2021-04-01,3302,135,60550,32848,2021-04-01,1617231600.0
8050,27,2,2021-04-02,2537,64,63087,32912,2021-04-02,1617318000.0
8051,27,2,2021-04-03,846,61,63933,32973,2021-04-03,1617404400.0
8052,27,2,2021-04-04,3,3,63936,32976,2021-04-04,1617490800.0
8053,27,2,2021-04-05,1,0,63937,32976,2021-04-05,1617577200.0
8054,27,2,2021-04-06,1873,278,65810,33254,2021-04-06,1617663600.0
8055,27,2,2021-04-07,1912,61,67722,33315,2021-04-07,1617750000.0
8056,27,2,2021-04-08,2953,188,70675,33503,2021-04-08,1617836400.0
8057,27,2,2021-04-09,2154,255,72829,33758,2021-04-09,1617922800.0
8058,27,2,2021-04-10,585,125,73414,33883,2021-04-10,1618009200.0
8059,27,2,2021-04-11,120,0,73534,33883,2021-04-11,1618095600.0
8060,27,2,2021-04-12,278,717,73812,34600,2021-04-12,1618185600.0
8061,27,2,2021-04-13,341,1162,74153,35762,2021-04-13,1618272000.0
8062,27,2,2021-04-14,319,1805,74472,37567,2021-04-14,1618358400.0
8063,27,2,2021-04-15,359,1453,74831,39020,2021-04-15,1618444800.0
8064,27,2,2021-04-16,388,1204,75219,40224,2021-04-16,1618531200.0
8065,27,2,2021-04-17,99,962,75318,41186,2021-04-17,1618617600.0
8066,27,2,2021-04-18,2,148,75320,41334,2021-04-18,1618704000.0
8067,27,2,2021-04-19,756,1158,76076,42492,2021-04-19,1618790400.0
8068,27,2,2021-04-20,1120,1051,77196,43543,2021-04-20,1618876800.0
8069,27,2,2021-04-21,1475,1965,78671,45508,2021-04-21,1618963200.0
8070,27,2,2021-04-22,2009,2440,80680,47948,2021-04-22,1619049600.0
8071,27,2,2021-04-23,2109,1485,82789,49433,2021-04-23,1619136000.0
8072,27,2,2021-04-24,1392,672,84181,50105,2021-04-24,1619222400.0
8073,27,2,2021-04-25,59,163,84240,50268,2021-04-25,1619308800.0
8074,27,2,2021-04-26,240,886,84480,51154,2021-04-26,1619395200.0
8075,27,2,2021-04-27,784,1551,85264,52705,2021-04-27,1619481600.0
8076,27,2,2021-04-28,1413,2367,86677,55072,2021-04-28,1619568000.0
8077,27,2,2021-04-29,839,2947,87516,58019,2021-04-29,1619654400.0
8078,27,2,2021-04-30,332,2154,87848,60173,2021-04-30,1619740800.0
8079,27,2,2021-05-01,6,96,87854,60269,2021-05-01,1619827200.0
8080,27,2,2021-05-02,0,0,87854,60269,2021-05-02,1619913600.0
8081,27,2,2021-05-03,278,421,88132,60690,2021-05-03,1620000000.0
8082,27,2,2021-05-04,235,1984,88367,62674,2021-05-04,1620086400.0
8083,27,2,2021-05-05,143,2044,88510,64718,2021-05-05,1620172800.0
8084,27,2,2021-05-06,254,2674,88764,67392,2021-05-06,1620259200.0
8085,27,2,2021-05-07,308,2147,89072,69539,2021-05-07,1620345600.0
8086,27,2,2021-05-08,26,202,89098,69741,2021-05-08,1620432000.0
8087,27,2,2021-05-09,72,140,89170,69881,2021-05-09,1620518400.0
8088,27,2,2021-05-10,662,339,89832,70220,2021-05-10,1620604800.0
8089,27,2,2021-05-11,1272,560,91104,70780,2021-05-11,1620691200.0
8090,27,2,2021-05-12,1722,376,92826,71156,2021-05-12,1620777600.0
8091,27,2,2021-05-13,2735,78,95561,71234,2021-05-13,1620864000.0
8092,27,2,2021-05-14,3505,256,99066,71490,2021-05-14,1620950400.0
8093,27,2,2021-05-15,6778,57,105844,71547,2021-05-15,1621036800.0
8094,27,2,2021-05-16,330,1,106174,71548,2021-05-16,1621123200.0
8095,27,2,2021-05-17,2533,299,108707,71847,2021-05-17,1621206000.0
8096,27,2,2021-05-18,2636,845,111343,72692,2021-05-18,1621292400.0
8097,27,2,2021-05-19,1432,270,112775,72962,2021-05-19,1621378800.0
8098,27,2,2021-05-20,1965,226,114740,73188,2021-05-20,1621465200.0
8099,27,2,2021-05-21,2679,363,117419,73551,2021-05-21,1621551600.0
8100,27,2,2021-05-22,997,103,118416,73654,2021-05-22,1621638000.0
8101,27,2,2021-05-23,0,3,118416,73657,2021-05-23,1621724400.0
8102,27,2,2021-05-24,2188,18,120604,73675,2021-05-24,1621810800.0
8103,27,2,2021-05-25,2319,344,122923,74019,2021-05-25,1621897200.0
8104,27,2,2021-05-26,2702,292,125625,74311,2021-05-26,1621983600.0
8105,27,2,2021-05-27,2566,261,128191,74572,2021-05-27,1622070000.0
8106,27,2,2021-05-28,3020,426,131211,74998,2021-05-28,1622156400.0
8107,27,2,2021-05-29,2297,169,133508,75167,2021-05-29,1622242800.0
8108,27,2,2021-05-30,211,18,133719,75185,2021-05-30,1622329200.0
8109,27,2,2021-05-31,3260,790,136979,75975,2021-05-31,1622415600.0
8110,27,2,2021-06-01,3371,1371,140350,77346,2021-06-01,1622502000.0
8111,27,2,2021-06-02,2697,1912,143047,79258,2021-06-02,1622588400.0
8112,27,2,2021-06-03,3155,1086,146202,80344,2021-06-03,1622674800.0
8113,27,2,2021-06-04,4305,1386,150507,81730,2021-06-04,1622761200.0
8114,27,2,2021-06-05,2617,1107,153124,82837,2021-06-05,1622847600.0
8115,27,2,2021-06-06,679,50,153803,82887,2021-06-06,1622934000.0
8116,27,2,2021-06-07,1219,741,155022,83628,2021-06-07,1623020400.0
8117,27,2,2021-06-08,1839,1232,156861,84860,2021-06-08,1623106800.0
8118,27,2,2021-06-09,1359,743,158220,85603,2021-06-09,1623193200.0
8119,27,2,2021-06-10,1661,301,159881,85904,2021-06-10,1623279600.0
8120,27,2,2021-06-11,2416,478,162297,86382,2021-06-11,1623366000.0
8121,27,2,2021-06-12,1563,169,163860,86551,2021-06-12,1623452400.0
8122,27,2,2021-06-13,147,10,164007,86561,2021-06-13,1623538800.0
8123,27,2,2021-06-14,1052,415,165059,86976,2021-06-14,1623625200.0
8124,27,2,2021-06-15,1487,329,166546,87305,2021-06-15,1623711600.0
8125,27,2,2021-06-16,1154,426,167700,87731,2021-06-16,1623798000.0
8126,27,2,2021-06-17,1277,399,168977,88130,2021-06-17,1623884400.0
8127,27,2,2021-06-18,1953,844,170930,88974,2021-06-18,1623970800.0
8128,27,2,2021-06-19,1031,299,171961,89273,2021-06-19,1624057200.0
8129,27,2,2021-06-20,86,7,172047,89280,2021-06-20,1624143600.0
8130,27,2,2021-06-21,548,1984,172595,91264,2021-06-21,1624230000.0
8131,27,2,2021-06-22,1016,2052,173611,93316,2021-06-22,1624316400.0
8132,27,2,2021-06-23,838,2594,174449,95910,2021-06-23,1624402800.0
8133,27,2,2021-06-24,1138,1958,175587,97868,2021-06-24,1624489200.0
8134,27,2,2021-06-25,1450,3753,177037,101621,2021-06-25,1624575600.0
8135,27,2,2021-06-26,666,5108,177703,106729,2021-06-26,1624662000.0
8136,27,2,2021-06-27,51,334,177754,107063,2021-06-27,1624748400.0
8137,27,2,2021-06-28,391,2786,178145,109849,2021-06-28,1624834800.0
8138,27,2,2021-06-29,705,3372,178850,113221,2021-06-29,1624921200.0
8139,27,2,2021-06-30,614,1892,179464,115113,2021-06-30,1625007600.0
8140,27,2,2021-07-01,803,2266,180267,117379,2021-07-01,1625094000.0
8141,27,2,2021-07-02,1044,2633,181311,120012,2021-07-02,1625180400.0
8142,27,2,2021-07-03,617,801,181928,120813,2021-07-03,1625266800.0
8143,27,2,2021-07-04,63,102,181991,120915,2021-07-04,1625353200.0
8144,27,2,2021-07-05,324,2900,182315,123815,2021-07-05,1625439600.0
8145,27,2,2021-07-06,492,2571,182807,126386,2021-07-06,1625526000.0
8146,27,2,2021-07-07,465,3229,183272,129615,2021-07-07,1625612400.0
8147,27,2,2021-07-08,598,3122,183870,132737,2021-07-08,1625698800.0
8148,27,3,2020-12-27,0,0,0,0,2020-12-27,1609023600.0
8149,27,3,2020-12-28,0,0,0,0,2020-12-28,1609110000.0
8150,27,3,2020-12-29,0,0,0,0,2020-12-29,1609196400.0
8151,27,3,2020-12-30,0,0,0,0,2020-12-30,1609282800.0
8152,27,3,2020-12-31,0,0,0,0,2020-12-31,1609369200.0
8153,27,3,2021-01-01,0,0,0,0,2021-01-01,1609455600.0
8154,27,3,2021-01-02,0,0,0,0,2021-01-02,1609542000.0
8155,27,3,2021-01-03,0,0,0,0,2021-01-03,1609628400.0
8156,27,3,2021-01-04,0,0,0,0,2021-01-04,1609714800.0
8157,27,3,2021-01-05,0,0,0,0,2021-01-05,1609801200.0
8158,27,3,2021-01-06,0,0,0,0,2021-01-06,1609887600.0
8159,27,3,2021-01-07,0,0,0,0,2021-01-07,1609974000.0
8160,27,3,2021-01-08,0,0,0,0,2021-01-08,1610060400.0
8161,27,3,2021-01-09,0,0,0,0,2021-01-09,1610146800.0
8162,27,3,2021-01-10,0,0,0,0,2021-01-10,1610233200.0
8163,27,3,2021-01-11,0,0,0,0,2021-01-11,1610319600.0
8164,27,3,2021-01-12,0,0,0,0,2021-01-12,1610406000.0
8165,27,3,2021-01-13,0,0,0,0,2021-01-13,1610492400.0
8166,27,3,2021-01-14,0,0,0,0,2021-01-14,1610578800.0
8167,27,3,2021-01-15,0,0,0,0,2021-01-15,1610665200.0
8168,27,3,2021-01-16,0,0,0,0,2021-01-16,1610751600.0
8169,27,3,2021-01-17,0,0,0,0,2021-01-17,1610838000.0
8170,27,3,2021-01-18,0,0,0,0,2021-01-18,1610924400.0
8171,27,3,2021-01-19,0,0,0,0,2021-01-19,1611010800.0
8172,27,3,2021-01-20,0,0,0,0,2021-01-20,1611097200.0
8173,27,3,2021-01-21,0,0,0,0,2021-01-21,1611183600.0
8174,27,3,2021-01-22,0,0,0,0,2021-01-22,1611270000.0
8175,27,3,2021-01-23,0,0,0,0,2021-01-23,1611356400.0
8176,27,3,2021-01-24,0,0,0,0,2021-01-24,1611442800.0
8177,27,3,2021-01-25,0,0,0,0,2021-01-25,1611529200.0
8178,27,3,2021-01-26,0,0,0,0,2021-01-26,1611615600.0
8179,27,3,2021-01-27,0,0,0,0,2021-01-27,1611702000.0
8180,27,3,2021-01-28,0,0,0,0,2021-01-28,1611788400.0
8181,27,3,2021-01-29,0,0,0,0,2021-01-29,1611874800.0
8182,27,3,2021-01-30,0,0,0,0,2021-01-30,1611961200.0
8183,27,3,2021-01-31,0,0,0,0,2021-01-31,1612047600.0
8184,27,3,2021-02-01,0,0,0,0,2021-02-01,1612134000.0
8185,27,3,2021-02-02,0,0,0,0,2021-02-02,1612220400.0
8186,27,3,2021-02-03,0,0,0,0,2021-02-03,1612306800.0
8187,27,3,2021-02-04,0,0,0,0,2021-02-04,1612393200.0
8188,27,3,2021-02-05,0,0,0,0,2021-02-05,1612479600.0
8189,27,3,2021-02-06,4,0,4,0,2021-02-06,1612566000.0
8190,27,3,2021-02-07,0,0,4,0,2021-02-07,1612652400.0
8191,27,3,2021-02-08,57,0,61,0,2021-02-08,1612738800.0
8192,27,3,2021-02-09,260,0,321,0,2021-02-09,1612825200.0
8193,27,3,2021-02-10,578,0,899,0,2021-02-10,1612911600.0
8194,27,3,2021-02-11,369,0,1268,0,2021-02-11,1612998000.0
8195,27,3,2021-02-12,464,0,1732,0,2021-02-12,1613084400.0
8196,27,3,2021-02-13,268,0,2000,0,2021-02-13,1613170800.0
8197,27,3,2021-02-14,221,0,2221,0,2021-02-14,1613257200.0
8198,27,3,2021-02-15,322,0,2543,0,2021-02-15,1613343600.0
8199,27,3,2021-02-16,328,0,2871,0,2021-02-16,1613430000.0
8200,27,3,2021-02-17,374,0,3245,0,2021-02-17,1613516400.0
8201,27,3,2021-02-18,516,0,3761,0,2021-02-18,1613602800.0
8202,27,3,2021-02-19,329,0,4090,0,2021-02-19,1613689200.0
8203,27,3,2021-02-20,114,0,4204,0,2021-02-20,1613775600.0
8204,27,3,2021-02-21,1,0,4205,0,2021-02-21,1613862000.0
8205,27,3,2021-02-22,410,0,4615,0,2021-02-22,1613948400.0
8206,27,3,2021-02-23,581,0,5196,0,2021-02-23,1614034800.0
8207,27,3,2021-02-24,803,0,5999,0,2021-02-24,1614121200.0
8208,27,3,2021-02-25,2152,0,8151,0,2021-02-25,1614207600.0
8209,27,3,2021-02-26,2819,0,10970,0,2021-02-26,1614294000.0
8210,27,3,2021-02-27,1602,0,12572,0,2021-02-27,1614380400.0
8211,27,3,2021-02-28,102,0,12674,0,2021-02-28,1614466800.0
8212,27,3,2021-03-01,1109,0,13783,0,2021-03-01,1614553200.0
8213,27,3,2021-03-02,2081,0,15864,0,2021-03-02,1614639600.0
8214,27,3,2021-03-03,2306,1,18170,1,2021-03-03,1614726000.0
8215,27,3,2021-03-04,3229,1,21399,2,2021-03-04,1614812400.0
8216,27,3,2021-03-05,5373,0,26772,2,2021-03-05,1614898800.0
8217,27,3,2021-03-06,5125,1,31897,3,2021-03-06,1614985200.0
8218,27,3,2021-03-07,858,0,32755,3,2021-03-07,1615071600.0
8219,27,3,2021-03-08,1521,1,34276,4,2021-03-08,1615158000.0
8220,27,3,2021-03-09,3616,3,37892,7,2021-03-09,1615244400.0
8221,27,3,2021-03-10,3285,1,41177,8,2021-03-10,1615330800.0
8222,27,3,2021-03-11,4493,0,45670,8,2021-03-11,1615417200.0
8223,27,3,2021-03-12,6531,3,52201,11,2021-03-12,1615503600.0
8224,27,3,2021-03-13,5462,1,57663,12,2021-03-13,1615590000.0
8225,27,3,2021-03-14,210,0,57873,12,2021-03-14,1615676400.0
8226,27,3,2021-03-15,1628,1,59501,13,2021-03-15,1615762800.0
8227,27,3,2021-03-16,30,0,59531,13,2021-03-16,1615849200.0
8228,27,3,2021-03-17,26,1,59557,14,2021-03-17,1615935600.0
8229,27,3,2021-03-18,68,1,59625,15,2021-03-18,1616022000.0
8230,27,3,2021-03-19,3001,2,62626,17,2021-03-19,1616108400.0
8231,27,3,2021-03-20,3081,1,65707,18,2021-03-20,1616194800.0
8232,27,3,2021-03-21,75,0,65782,18,2021-03-21,1616281200.0
8233,27,3,2021-03-22,1199,0,66981,18,2021-03-22,1616367600.0
8234,27,3,2021-03-23,3957,3,70938,21,2021-03-23,1616454000.0
8235,27,3,2021-03-24,4197,3,75135,24,2021-03-24,1616540400.0
8236,27,3,2021-03-25,6745,9,81880,33,2021-03-25,1616626800.0
8237,27,3,2021-03-26,7665,15,89545,48,2021-03-26,1616713200.0
8238,27,3,2021-03-27,2942,20,92487,68,2021-03-27,1616799600.0
8239,27,3,2021-03-28,197,0,92684,68,2021-03-28,1616886000.0
8240,27,3,2021-03-29,2400,4,95084,72,2021-03-29,1616972400.0
8241,27,3,2021-03-30,4376,1,99460,73,2021-03-30,1617058800.0
8242,27,3,2021-03-31,2923,7,102383,80,2021-03-31,1617145200.0
8243,27,3,2021-04-01,3976,3,106359,83,2021-04-01,1617231600.0
8244,27,3,2021-04-02,3958,18,110317,101,2021-04-02,1617318000.0
8245,27,3,2021-04-03,1511,3,111828,104,2021-04-03,1617404400.0
8246,27,3,2021-04-04,27,0,111855,104,2021-04-04,1617490800.0
8247,27,3,2021-04-05,137,0,111992,104,2021-04-05,1617577200.0
8248,27,3,2021-04-06,1450,22,113442,126,2021-04-06,1617663600.0
8249,27,3,2021-04-07,1428,3,114870,129,2021-04-07,1617750000.0
8250,27,3,2021-04-08,4224,5,119094,134,2021-04-08,1617836400.0
8251,27,3,2021-04-09,7674,21,126768,155,2021-04-09,1617922800.0
8252,27,3,2021-04-10,3546,31,130314,186,2021-04-10,1618009200.0
8253,27,3,2021-04-11,223,1,130537,187,2021-04-11,1618095600.0
8254,27,3,2021-04-12,1924,8,132461,195,2021-04-12,1618185600.0
8255,27,3,2021-04-13,4078,14,136539,209,2021-04-13,1618272000.0
8256,27,3,2021-04-14,2731,23,139270,232,2021-04-14,1618358400.0
8257,27,3,2021-04-15,4101,14,143371,246,2021-04-15,1618444800.0
8258,27,3,2021-04-16,4856,7,148227,253,2021-04-16,1618531200.0
8259,27,3,2021-04-17,2181,5,150408,258,2021-04-17,1618617600.0
8260,27,3,2021-04-18,271,0,150679,258,2021-04-18,1618704000.0
8261,27,3,2021-04-19,1011,10,151690,268,2021-04-19,1618790400.0
8262,27,3,2021-04-20,2084,18,153774,286,2021-04-20,1618876800.0
8263,27,3,2021-04-21,1584,60,155358,346,2021-04-21,1618963200.0
8264,27,3,2021-04-22,2393,87,157751,433,2021-04-22,1619049600.0
8265,27,3,2021-04-23,3297,93,161048,526,2021-04-23,1619136000.0
8266,27,3,2021-04-24,1604,38,162652,564,2021-04-24,1619222400.0
8267,27,3,2021-04-25,87,0,162739,564,2021-04-25,1619308800.0
8268,27,3,2021-04-26,731,34,163470,598,2021-04-26,1619395200.0
8269,27,3,2021-04-27,1787,42,165257,640,2021-04-27,1619481600.0
8270,27,3,2021-04-28,1156,127,166413,767,2021-04-28,1619568000.0
8271,27,3,2021-04-29,2462,317,168875,1084,2021-04-29,1619654400.0
8272,27,3,2021-04-30,3022,381,171897,1465,2021-04-30,1619740800.0
8273,27,3,2021-05-01,221,166,172118,1631,2021-05-01,1619827200.0
8274,27,3,2021-05-02,18,20,172136,1651,2021-05-02,1619913600.0
8275,27,3,2021-05-03,531,173,172667,1824,2021-05-03,1620000000.0
8276,27,3,2021-05-04,1136,369,173803,2193,2021-05-04,1620086400.0
8277,27,3,2021-05-05,759,471,174562,2664,2021-05-05,1620172800.0
8278,27,3,2021-05-06,1789,922,176351,3586,2021-05-06,1620259200.0
8279,27,3,2021-05-07,2324,1411,178675,4997,2021-05-07,1620345600.0
8280,27,3,2021-05-08,284,279,178959,5276,2021-05-08,1620432000.0
8281,27,3,2021-05-09,70,122,179029,5398,2021-05-09,1620518400.0
8282,27,3,2021-05-10,663,497,179692,5895,2021-05-10,1620604800.0
8283,27,3,2021-05-11,1353,1233,181045,7128,2021-05-11,1620691200.0
8284,27,3,2021-05-12,808,1109,181853,8237,2021-05-12,1620777600.0
8285,27,3,2021-05-13,86,183,181939,8420,2021-05-13,1620864000.0
8286,27,3,2021-05-14,698,974,182637,9394,2021-05-14,1620950400.0
8287,27,3,2021-05-15,307,1054,182944,10448,2021-05-15,1621036800.0
8288,27,3,2021-05-16,18,21,182962,10469,2021-05-16,1621123200.0
8289,27,3,2021-05-17,316,539,183278,11008,2021-05-17,1621206000.0
8290,27,3,2021-05-18,532,1296,183810,12304,2021-05-18,1621292400.0
8291,27,3,2021-05-19,351,1229,184161,13533,2021-05-19,1621378800.0
8292,27,3,2021-05-20,577,2041,184738,15574,2021-05-20,1621465200.0
8293,27,3,2021-05-21,659,2617,185397,18191,2021-05-21,1621551600.0
8294,27,3,2021-05-22,284,1663,185681,19854,2021-05-22,1621638000.0
8295,27,3,2021-05-23,23,104,185704,19958,2021-05-23,1621724400.0
8296,27,3,2021-05-24,50,179,185754,20137,2021-05-24,1621810800.0
8297,27,3,2021-05-25,111,1905,185865,22042,2021-05-25,1621897200.0
8298,27,3,2021-05-26,195,2009,186060,24051,2021-05-26,1621983600.0
8299,27,3,2021-05-27,254,3228,186314,27279,2021-05-27,1622070000.0
8300,27,3,2021-05-28,356,3907,186670,31186,2021-05-28,1622156400.0
8301,27,3,2021-05-29,158,2215,186828,33401,2021-05-29,1622242800.0
8302,27,3,2021-05-30,34,99,186862,33500,2021-05-30,1622329200.0
8303,27,3,2021-05-31,91,1374,186953,34874,2021-05-31,1622415600.0
8304,27,3,2021-06-01,121,2915,187074,37789,2021-06-01,1622502000.0
8305,27,3,2021-06-02,81,2577,187155,40366,2021-06-02,1622588400.0
8306,27,3,2021-06-03,150,3565,187305,43931,2021-06-03,1622674800.0
8307,27,3,2021-06-04,171,3993,187476,47924,2021-06-04,1622761200.0
8308,27,3,2021-06-05,86,2485,187562,50409,2021-06-05,1622847600.0
8309,27,3,2021-06-06,4,210,187566,50619,2021-06-06,1622934000.0
8310,27,3,2021-06-07,26,1098,187592,51717,2021-06-07,1623020400.0
8311,27,3,2021-06-08,64,2352,187656,54069,2021-06-08,1623106800.0
8312,27,3,2021-06-09,60,1801,187716,55870,2021-06-09,1623193200.0
8313,27,3,2021-06-10,57,3058,187773,58928,2021-06-10,1623279600.0
8314,27,3,2021-06-11,114,4314,187887,63242,2021-06-11,1623366000.0
8315,27,3,2021-06-12,40,1945,187927,65187,2021-06-12,1623452400.0
8316,27,3,2021-06-13,21,226,187948,65413,2021-06-13,1623538800.0
8317,27,3,2021-06-14,28,1818,187976,67231,2021-06-14,1623625200.0
8318,27,3,2021-06-15,72,3789,188048,71020,2021-06-15,1623711600.0
8319,27,3,2021-06-16,56,2881,188104,73901,2021-06-16,1623798000.0
8320,27,3,2021-06-17,53,4734,188157,78635,2021-06-17,1623884400.0
8321,27,3,2021-06-18,83,5237,188240,83872,2021-06-18,1623970800.0
8322,27,3,2021-06-19,27,1427,188267,85299,2021-06-19,1624057200.0
8323,27,3,2021-06-20,0,74,188267,85373,2021-06-20,1624143600.0
8324,27,3,2021-06-21,10,1614,188277,86987,2021-06-21,1624230000.0
8325,27,3,2021-06-22,42,3398,188319,90385,2021-06-22,1624316400.0
8326,27,3,2021-06-23,24,2124,188343,92509,2021-06-23,1624402800.0
8327,27,3,2021-06-24,61,3659,188404,96168,2021-06-24,1624489200.0
8328,27,3,2021-06-25,72,4183,188476,100351,2021-06-25,1624575600.0
8329,27,3,2021-06-26,21,1526,188497,101877,2021-06-26,1624662000.0
8330,27,3,2021-06-27,21,167,188518,102044,2021-06-27,1624748400.0
8331,27,3,2021-06-28,19,1156,188537,103200,2021-06-28,1624834800.0
8332,27,3,2021-06-29,23,2860,188560,106060,2021-06-29,1624921200.0
8333,27,3,2021-06-30,24,1811,188584,107871,2021-06-30,1625007600.0
8334,27,3,2021-07-01,52,3393,188636,111264,2021-07-01,1625094000.0
8335,27,3,2021-07-02,34,4019,188670,115283,2021-07-02,1625180400.0
8336,27,3,2021-07-03,25,1401,188695,116684,2021-07-03,1625266800.0
8337,27,3,2021-07-04,7,184,188702,116868,2021-07-04,1625353200.0
8338,27,3,2021-07-05,8,1474,188710,118342,2021-07-05,1625439600.0
8339,27,3,2021-07-06,24,2721,188734,121063,2021-07-06,1625526000.0
8340,27,3,2021-07-07,32,1888,188766,122951,2021-07-07,1625612400.0
8341,27,3,2021-07-08,39,2798,188805,125749,2021-07-08,1625698800.0
8342,27,4,2020-12-27,0,0,0,0,2020-12-27,1609023600.0
8343,27,4,2020-12-28,0,0,0,0,2020-12-28,1609110000.0
8344,27,4,2020-12-29,0,0,0,0,2020-12-29,1609196400.0
8345,27,4,2020-12-30,0,0,0,0,2020-12-30,1609282800.0
8346,27,4,2020-12-31,0,0,0,0,2020-12-31,1609369200.0
8347,27,4,2021-01-01,0,0,0,0,2021-01-01,1609455600.0
8348,27,4,2021-01-02,0,0,0,0,2021-01-02,1609542000.0
8349,27,4,2021-01-03,0,0,0,0,2021-01-03,1609628400.0
8350,27,4,2021-01-04,0,0,0,0,2021-01-04,1609714800.0
8351,27,4,2021-01-05,0,0,0,0,2021-01-05,1609801200.0
8352,27,4,2021-01-06,0,0,0,0,2021-01-06,1609887600.0
8353,27,4,2021-01-07,0,0,0,0,2021-01-07,1609974000.0
8354,27,4,2021-01-08,0,0,0,0,2021-01-08,1610060400.0
8355,27,4,2021-01-09,0,0,0,0,2021-01-09,1610146800.0
8356,27,4,2021-01-10,0,0,0,0,2021-01-10,1610233200.0
8357,27,4,2021-01-11,0,0,0,0,2021-01-11,1610319600.0
8358,27,4,2021-01-12,0,0,0,0,2021-01-12,1610406000.0
8359,27,4,2021-01-13,0,0,0,0,2021-01-13,1610492400.0
8360,27,4,2021-01-14,0,0,0,0,2021-01-14,1610578800.0
8361,27,4,2021-01-15,0,0,0,0,2021-01-15,1610665200.0
8362,27,4,2021-01-16,0,0,0,0,2021-01-16,1610751600.0
8363,27,4,2021-01-17,0,0,0,0,2021-01-17,1610838000.0
8364,27,4,2021-01-18,0,0,0,0,2021-01-18,1610924400.0
8365,27,4,2021-01-19,0,0,0,0,2021-01-19,1611010800.0
8366,27,4,2021-01-20,0,0,0,0,2021-01-20,1611097200.0
8367,27,4,2021-01-21,0,0,0,0,2021-01-21,1611183600.0
8368,27,4,2021-01-22,0,0,0,0,2021-01-22,1611270000.0
8369,27,4,2021-01-23,0,0,0,0,2021-01-23,1611356400.0
8370,27,4,2021-01-24,0,0,0,0,2021-01-24,1611442800.0
8371,27,4,2021-01-25,0,0,0,0,2021-01-25,1611529200.0
8372,27,4,2021-01-26,0,0,0,0,2021-01-26,1611615600.0
8373,27,4,2021-01-27,0,0,0,0,2021-01-27,1611702000.0
8374,27,4,2021-01-28,0,0,0,0,2021-01-28,1611788400.0
8375,27,4,2021-01-29,0,0,0,0,2021-01-29,1611874800.0
8376,27,4,2021-01-30,0,0,0,0,2021-01-30,1611961200.0
8377,27,4,2021-01-31,0,0,0,0,2021-01-31,1612047600.0
8378,27,4,2021-02-01,0,0,0,0,2021-02-01,1612134000.0
8379,27,4,2021-02-02,0,0,0,0,2021-02-02,1612220400.0
8380,27,4,2021-02-03,0,0,0,0,2021-02-03,1612306800.0
8381,27,4,2021-02-04,0,0,0,0,2021-02-04,1612393200.0
8382,27,4,2021-02-05,0,0,0,0,2021-02-05,1612479600.0
8383,27,4,2021-02-06,0,0,0,0,2021-02-06,1612566000.0
8384,27,4,2021-02-07,0,0,0,0,2021-02-07,1612652400.0
8385,27,4,2021-02-08,0,0,0,0,2021-02-08,1612738800.0
8386,27,4,2021-02-09,0,0,0,0,2021-02-09,1612825200.0
8387,27,4,2021-02-10,0,0,0,0,2021-02-10,1612911600.0
8388,27,4,2021-02-11,0,0,0,0,2021-02-11,1612998000.0
8389,27,4,2021-02-12,0,0,0,0,2021-02-12,1613084400.0
8390,27,4,2021-02-13,0,0,0,0,2021-02-13,1613170800.0
8391,27,4,2021-02-14,0,0,0,0,2021-02-14,1613257200.0
8392,27,4,2021-02-15,0,0,0,0,2021-02-15,1613343600.0
8393,27,4,2021-02-16,0,0,0,0,2021-02-16,1613430000.0
8394,27,4,2021-02-17,0,0,0,0,2021-02-17,1613516400.0
8395,27,4,2021-02-18,0,0,0,0,2021-02-18,1613602800.0
8396,27,4,2021-02-19,0,0,0,0,2021-02-19,1613689200.0
8397,27,4,2021-02-20,0,0,0,0,2021-02-20,1613775600.0
8398,27,4,2021-02-21,0,0,0,0,2021-02-21,1613862000.0
8399,27,4,2021-02-22,0,0,0,0,2021-02-22,1613948400.0
8400,27,4,2021-02-23,0,0,0,0,2021-02-23,1614034800.0
8401,27,4,2021-02-24,0,0,0,0,2021-02-24,1614121200.0
8402,27,4,2021-02-25,0,0,0,0,2021-02-25,1614207600.0
8403,27,4,2021-02-26,0,0,0,0,2021-02-26,1614294000.0
8404,27,4,2021-02-27,0,0,0,0,2021-02-27,1614380400.0
8405,27,4,2021-02-28,0,0,0,0,2021-02-28,1614466800.0
8406,27,4,2021-03-01,0,0,0,0,2021-03-01,1614553200.0
8407,27,4,2021-03-02,0,0,0,0,2021-03-02,1614639600.0
8408,27,4,2021-03-03,0,0,0,0,2021-03-03,1614726000.0
8409,27,4,2021-03-04,0,0,0,0,2021-03-04,1614812400.0
8410,27,4,2021-03-05,0,0,0,0,2021-03-05,1614898800.0
8411,27,4,2021-03-06,0,0,0,0,2021-03-06,1614985200.0
8412,27,4,2021-03-07,0,0,0,0,2021-03-07,1615071600.0
8413,27,4,2021-03-08,0,0,0,0,2021-03-08,1615158000.0
8414,27,4,2021-03-09,0,0,0,0,2021-03-09,1615244400.0
8415,27,4,2021-03-10,0,0,0,0,2021-03-10,1615330800.0
8416,27,4,2021-03-11,0,0,0,0,2021-03-11,1615417200.0
8417,27,4,2021-03-12,0,0,0,0,2021-03-12,1615503600.0
8418,27,4,2021-03-13,0,0,0,0,2021-03-13,1615590000.0
8419,27,4,2021-03-14,0,0,0,0,2021-03-14,1615676400.0
8420,27,4,2021-03-15,0,0,0,0,2021-03-15,1615762800.0
8421,27,4,2021-03-16,0,0,0,0,2021-03-16,1615849200.0
8422,27,4,2021-03-17,0,0,0,0,2021-03-17,1615935600.0
8423,27,4,2021-03-18,0,0,0,0,2021-03-18,1616022000.0
8424,27,4,2021-03-19,0,0,0,0,2021-03-19,1616108400.0
8425,27,4,2021-03-20,0,0,0,0,2021-03-20,1616194800.0
8426,27,4,2021-03-21,0,0,0,0,2021-03-21,1616281200.0
8427,27,4,2021-03-22,0,0,0,0,2021-03-22,1616367600.0
8428,27,4,2021-03-23,0,0,0,0,2021-03-23,1616454000.0
8429,27,4,2021-03-24,0,0,0,0,2021-03-24,1616540400.0
8430,27,4,2021-03-25,0,0,0,0,2021-03-25,1616626800.0
8431,27,4,2021-03-26,0,0,0,0,2021-03-26,1616713200.0
8432,27,4,2021-03-27,0,0,0,0,2021-03-27,1616799600.0
8433,27,4,2021-03-28,0,0,0,0,2021-03-28,1616886000.0
8434,27,4,2021-03-29,0,0,0,0,2021-03-29,1616972400.0
8435,27,4,2021-03-30,0,0,0,0,2021-03-30,1617058800.0
8436,27,4,2021-03-31,0,0,0,0,2021-03-31,1617145200.0
8437,27,4,2021-04-01,0,0,0,0,2021-04-01,1617231600.0
8438,27,4,2021-04-02,0,0,0,0,2021-04-02,1617318000.0
8439,27,4,2021-04-03,0,0,0,0,2021-04-03,1617404400.0
8440,27,4,2021-04-04,0,0,0,0,2021-04-04,1617490800.0
8441,27,4,2021-04-05,0,0,0,0,2021-04-05,1617577200.0
8442,27,4,2021-04-06,0,0,0,0,2021-04-06,1617663600.0
8443,27,4,2021-04-07,0,0,0,0,2021-04-07,1617750000.0
8444,27,4,2021-04-08,0,0,0,0,2021-04-08,1617836400.0
8445,27,4,2021-04-09,0,0,0,0,2021-04-09,1617922800.0
8446,27,4,2021-04-10,0,0,0,0,2021-04-10,1618009200.0
8447,27,4,2021-04-11,0,0,0,0,2021-04-11,1618095600.0
8448,27,4,2021-04-12,0,0,0,0,2021-04-12,1618185600.0
8449,27,4,2021-04-13,0,0,0,0,2021-04-13,1618272000.0
8450,27,4,2021-04-14,0,0,0,0,2021-04-14,1618358400.0
8451,27,4,2021-04-15,0,0,0,0,2021-04-15,1618444800.0
8452,27,4,2021-04-16,0,0,0,0,2021-04-16,1618531200.0
8453,27,4,2021-04-17,0,0,0,0,2021-04-17,1618617600.0
8454,27,4,2021-04-18,0,0,0,0,2021-04-18,1618704000.0
8455,27,4,2021-04-19,0,0,0,0,2021-04-19,1618790400.0
8456,27,4,2021-04-20,0,0,0,0,2021-04-20,1618876800.0
8457,27,4,2021-04-21,0,0,0,0,2021-04-21,1618963200.0
8458,27,4,2021-04-22,0,0,0,0,2021-04-22,1619049600.0
8459,27,4,2021-04-23,8,0,8,0,2021-04-23,1619136000.0
8460,27,4,2021-04-24,0,0,8,0,2021-04-24,1619222400.0
8461,27,4,2021-04-25,0,0,8,0,2021-04-25,1619308800.0
8462,27,4,2021-04-26,6,0,14,0,2021-04-26,1619395200.0
8463,27,4,2021-04-27,223,0,237,0,2021-04-27,1619481600.0
8464,27,4,2021-04-28,446,0,683,0,2021-04-28,1619568000.0
8465,27,4,2021-04-29,899,1,1582,1,2021-04-29,1619654400.0
8466,27,4,2021-04-30,1032,1,2614,2,2021-04-30,1619740800.0
8467,27,4,2021-05-01,90,0,2704,2,2021-05-01,1619827200.0
8468,27,4,2021-05-02,18,0,2722,2,2021-05-02,1619913600.0
8469,27,4,2021-05-03,218,0,2940,2,2021-05-03,1620000000.0
8470,27,4,2021-05-04,501,0,3441,2,2021-05-04,1620086400.0
8471,27,4,2021-05-05,257,0,3698,2,2021-05-05,1620172800.0
8472,27,4,2021-05-06,598,0,4296,2,2021-05-06,1620259200.0
8473,27,4,2021-05-07,859,0,5155,2,2021-05-07,1620345600.0
8474,27,4,2021-05-08,164,0,5319,2,2021-05-08,1620432000.0
8475,27,4,2021-05-09,10,0,5329,2,2021-05-09,1620518400.0
8476,27,4,2021-05-10,351,1,5680,3,2021-05-10,1620604800.0
8477,27,4,2021-05-11,623,0,6303,3,2021-05-11,1620691200.0
8478,27,4,2021-05-12,420,0,6723,3,2021-05-12,1620777600.0
8479,27,4,2021-05-13,45,0,6768,3,2021-05-13,1620864000.0
8480,27,4,2021-05-14,383,0,7151,3,2021-05-14,1620950400.0
8481,27,4,2021-05-15,106,0,7257,3,2021-05-15,1621036800.0
8482,27,4,2021-05-16,1,0,7258,3,2021-05-16,1621123200.0
8483,27,4,2021-05-17,137,0,7395,3,2021-05-17,1621206000.0
8484,27,4,2021-05-18,246,0,7641,3,2021-05-18,1621292400.0
8485,27,4,2021-05-19,229,0,7870,3,2021-05-19,1621378800.0
8486,27,4,2021-05-20,369,2,8239,5,2021-05-20,1621465200.0
8487,27,4,2021-05-21,517,0,8756,5,2021-05-21,1621551600.0
8488,27,4,2021-05-22,289,0,9045,5,2021-05-22,1621638000.0
8489,27,4,2021-05-23,11,0,9056,5,2021-05-23,1621724400.0
8490,27,4,2021-05-24,78,0,9134,5,2021-05-24,1621810800.0
8491,27,4,2021-05-25,267,0,9401,5,2021-05-25,1621897200.0
8492,27,4,2021-05-26,346,2,9747,7,2021-05-26,1621983600.0
8493,27,4,2021-05-27,702,1,10449,8,2021-05-27,1622070000.0
8494,27,4,2021-05-28,1290,2,11739,10,2021-05-28,1622156400.0
8495,27,4,2021-05-29,560,0,12299,10,2021-05-29,1622242800.0
8496,27,4,2021-05-30,35,0,12334,10,2021-05-30,1622329200.0
8497,27,4,2021-05-31,568,0,12902,10,2021-05-31,1622415600.0
8498,27,4,2021-06-01,890,1,13792,11,2021-06-01,1622502000.0
8499,27,4,2021-06-02,519,0,14311,11,2021-06-02,1622588400.0
8500,27,4,2021-06-03,848,0,15159,11,2021-06-03,1622674800.0
8501,27,4,2021-06-04,1071,2,16230,13,2021-06-04,1622761200.0
8502,27,4,2021-06-05,478,0,16708,13,2021-06-05,1622847600.0
8503,27,4,2021-06-06,62,0,16770,13,2021-06-06,1622934000.0
8504,27,4,2021-06-07,431,1,17201,14,2021-06-07,1623020400.0
8505,27,4,2021-06-08,575,0,17776,14,2021-06-08,1623106800.0
8506,27,4,2021-06-09,452,0,18228,14,2021-06-09,1623193200.0
8507,27,4,2021-06-10,683,0,18911,14,2021-06-10,1623279600.0
8508,27,4,2021-06-11,745,0,19656,14,2021-06-11,1623366000.0
8509,27,4,2021-06-12,352,0,20008,14,2021-06-12,1623452400.0
8510,27,4,2021-06-13,60,1,20068,15,2021-06-13,1623538800.0
8511,27,4,2021-06-14,260,3,20328,18,2021-06-14,1623625200.0
8512,27,4,2021-06-15,471,1,20799,19,2021-06-15,1623711600.0
8513,27,4,2021-06-16,361,0,21160,19,2021-06-16,1623798000.0
8514,27,4,2021-06-17,448,0,21608,19,2021-06-17,1623884400.0
8515,27,4,2021-06-18,530,0,22138,19,2021-06-18,1623970800.0
8516,27,4,2021-06-19,324,0,22462,19,2021-06-19,1624057200.0
8517,27,4,2021-06-20,13,0,22475,19,2021-06-20,1624143600.0
8518,27,4,2021-06-21,224,0,22699,19,2021-06-21,1624230000.0
8519,27,4,2021-06-22,287,1,22986,20,2021-06-22,1624316400.0
8520,27,4,2021-06-23,250,0,23236,20,2021-06-23,1624402800.0
8521,27,4,2021-06-24,387,4,23623,24,2021-06-24,1624489200.0
8522,27,4,2021-06-25,446,1,24069,25,2021-06-25,1624575600.0
8523,27,4,2021-06-26,226,3,24295,28,2021-06-26,1624662000.0
8524,27,4,2021-06-27,13,0,24308,28,2021-06-27,1624748400.0
8525,27,4,2021-06-28,194,0,24502,28,2021-06-28,1624834800.0
8526,27,4,2021-06-29,284,1,24786,29,2021-06-29,1624921200.0
8527,27,4,2021-06-30,239,0,25025,29,2021-06-30,1625007600.0
8528,27,4,2021-07-01,357,1,25382,30,2021-07-01,1625094000.0
8529,27,4,2021-07-02,348,0,25730,30,2021-07-02,1625180400.0
8530,27,4,2021-07-03,201,0,25931,30,2021-07-03,1625266800.0
8531,27,4,2021-07-04,20,0,25951,30,2021-07-04,1625353200.0
8532,27,4,2021-07-05,168,0,26119,30,2021-07-05,1625439600.0
8533,27,4,2021-07-06,289,2,26408,32,2021-07-06,1625526000.0
8534,27,4,2021-07-07,296,1,26704,33,2021-07-07,1625612400.0
8535,27,4,2021-07-08,436,0,27140,33,2021-07-08,1625698800.0
8536,28,1,2020-12-27,0,0,0,0,2020-12-27,1609023600.0
8537,28,1,2020-12-28,1,0,1,0,2020-12-28,1609110000.0
8538,28,1,2020-12-29,2,0,3,0,2020-12-29,1609196400.0
8539,28,1,2020-12-30,0,0,3,0,2020-12-30,1609282800.0
8540,28,1,2020-12-31,1,0,4,0,2020-12-31,1609369200.0
8541,28,1,2021-01-01,1,0,5,0,2021-01-01,1609455600.0
8542,28,1,2021-01-02,1,0,6,0,2021-01-02,1609542000.0
8543,28,1,2021-01-03,1,0,7,0,2021-01-03,1609628400.0
8544,28,1,2021-01-04,16,0,23,0,2021-01-04,1609714800.0
8545,28,1,2021-01-05,169,0,192,0,2021-01-05,1609801200.0
8546,28,1,2021-01-06,1393,0,1585,0,2021-01-06,1609887600.0
8547,28,1,2021-01-07,2600,0,4185,0,2021-01-07,1609974000.0
8548,28,1,2021-01-08,3428,0,7613,0,2021-01-08,1610060400.0
8549,28,1,2021-01-09,1333,0,8946,0,2021-01-09,1610146800.0
8550,28,1,2021-01-10,705,0,9651,0,2021-01-10,1610233200.0
8551,28,1,2021-01-11,3178,0,12829,0,2021-01-11,1610319600.0
8552,28,1,2021-01-12,3978,0,16807,0,2021-01-12,1610406000.0
8553,28,1,2021-01-13,4302,0,21109,0,2021-01-13,1610492400.0
8554,28,1,2021-01-14,8098,0,29207,0,2021-01-14,1610578800.0
8555,28,1,2021-01-15,6219,0,35426,0,2021-01-15,1610665200.0
8556,28,1,2021-01-16,2087,8,37513,8,2021-01-16,1610751600.0
8557,28,1,2021-01-17,4073,16,41586,24,2021-01-17,1610838000.0
8558,28,1,2021-01-18,8784,8,50370,32,2021-01-18,1610924400.0
8559,28,1,2021-01-19,7141,2,57511,34,2021-01-19,1611010800.0
8560,28,1,2021-01-20,6509,4,64020,38,2021-01-20,1611097200.0
8561,28,1,2021-01-21,5992,3,70012,41,2021-01-21,1611183600.0
8562,28,1,2021-01-22,5440,7,75452,48,2021-01-22,1611270000.0
8563,28,1,2021-01-23,2019,6,77471,54,2021-01-23,1611356400.0
8564,28,1,2021-01-24,1447,11,78918,65,2021-01-24,1611442800.0
8565,28,1,2021-01-25,6240,173,85158,238,2021-01-25,1611529200.0
8566,28,1,2021-01-26,4576,391,89734,629,2021-01-26,1611615600.0
8567,28,1,2021-01-27,4034,762,93768,1391,2021-01-27,1611702000.0
8568,28,1,2021-01-28,3755,1044,97523,2435,2021-01-28,1611788400.0
8569,28,1,2021-01-29,3489,1298,101012,3733,2021-01-29,1611874800.0
8570,28,1,2021-01-30,1386,516,102398,4249,2021-01-30,1611961200.0
8571,28,1,2021-01-31,195,124,102593,4373,2021-01-31,1612047600.0
8572,28,1,2021-02-01,2781,1659,105374,6032,2021-02-01,1612134000.0
8573,28,1,2021-02-02,2984,2388,108358,8420,2021-02-02,1612220400.0
8574,28,1,2021-02-03,2950,2665,111308,11085,2021-02-03,1612306800.0
8575,28,1,2021-02-04,3725,5199,115033,16284,2021-02-04,1612393200.0
8576,28,1,2021-02-05,3887,4380,118920,20664,2021-02-05,1612479600.0
8577,28,1,2021-02-06,1126,1546,120046,22210,2021-02-06,1612566000.0
8578,28,1,2021-02-07,632,1971,120678,24181,2021-02-07,1612652400.0
8579,28,1,2021-02-08,3257,6841,123935,31022,2021-02-08,1612738800.0
8580,28,1,2021-02-09,2716,6003,126651,37025,2021-02-09,1612825200.0
8581,28,1,2021-02-10,2127,5048,128778,42073,2021-02-10,1612911600.0
8582,28,1,2021-02-11,1922,4848,130700,46921,2021-02-11,1612998000.0
8583,28,1,2021-02-12,1924,4579,132624,51500,2021-02-12,1613084400.0
8584,28,1,2021-02-13,672,1570,133296,53070,2021-02-13,1613170800.0
8585,28,1,2021-02-14,263,1385,133559,54455,2021-02-14,1613257200.0
8586,28,1,2021-02-15,1124,6247,134683,60702,2021-02-15,1613343600.0
8587,28,1,2021-02-16,1036,5617,135719,66319,2021-02-16,1613430000.0
8588,28,1,2021-02-17,851,4547,136570,70866,2021-02-17,1613516400.0
8589,28,1,2021-02-18,749,4256,137319,75122,2021-02-18,1613602800.0
8590,28,1,2021-02-19,735,3660,138054,78782,2021-02-19,1613689200.0
8591,28,1,2021-02-20,451,1252,138505,80034,2021-02-20,1613775600.0
8592,28,1,2021-02-21,18,416,138523,80450,2021-02-21,1613862000.0
8593,28,1,2021-02-22,791,4173,139314,84623,2021-02-22,1613948400.0
8594,28,1,2021-02-23,1096,3801,140410,88424,2021-02-23,1614034800.0
8595,28,1,2021-02-24,1100,3869,141510,92293,2021-02-24,1614121200.0
8596,28,1,2021-02-25,1361,4128,142871,96421,2021-02-25,1614207600.0
8597,28,1,2021-02-26,1465,3662,144336,100083,2021-02-26,1614294000.0
8598,28,1,2021-02-27,483,1010,144819,101093,2021-02-27,1614380400.0
8599,28,1,2021-02-28,156,383,144975,101476,2021-02-28,1614466800.0
8600,28,1,2021-03-01,1757,4622,146732,106098,2021-03-01,1614553200.0
8601,28,1,2021-03-02,2083,4040,148815,110138,2021-03-02,1614639600.0
8602,28,1,2021-03-03,2282,3452,151097,113590,2021-03-03,1614726000.0
8603,28,1,2021-03-04,2849,2796,153946,116386,2021-03-04,1614812400.0
8604,28,1,2021-03-05,3898,2349,157844,118735,2021-03-05,1614898800.0
8605,28,1,2021-03-06,5104,688,162948,119423,2021-03-06,1614985200.0
8606,28,1,2021-03-07,2754,100,165702,119523,2021-03-07,1615071600.0
8607,28,1,2021-03-08,3896,2660,169598,122183,2021-03-08,1615158000.0
8608,28,1,2021-03-09,5248,2131,174846,124314,2021-03-09,1615244400.0
8609,28,1,2021-03-10,5784,1808,180630,126122,2021-03-10,1615330800.0
8610,28,1,2021-03-11,6518,1277,187148,127399,2021-03-11,1615417200.0
8611,28,1,2021-03-12,7203,1030,194351,128429,2021-03-12,1615503600.0
8612,28,1,2021-03-13,3301,420,197652,128849,2021-03-13,1615590000.0
8613,28,1,2021-03-14,1505,69,199157,128918,2021-03-14,1615676400.0
8614,28,1,2021-03-15,6829,645,205986,129563,2021-03-15,1615762800.0
8615,28,1,2021-03-16,6929,704,212915,130267,2021-03-16,1615849200.0
8616,28,1,2021-03-17,7120,951,220035,131218,2021-03-17,1615935600.0
8617,28,1,2021-03-18,7531,964,227566,132182,2021-03-18,1616022000.0
8618,28,1,2021-03-19,7310,770,234876,132952,2021-03-19,1616108400.0
8619,28,1,2021-03-20,4964,148,239840,133100,2021-03-20,1616194800.0
8620,28,1,2021-03-21,1747,7,241587,133107,2021-03-21,1616281200.0
8621,28,1,2021-03-22,6993,1192,248580,134299,2021-03-22,1616367600.0
8622,28,1,2021-03-23,7297,1069,255877,135368,2021-03-23,1616454000.0
8623,28,1,2021-03-24,7119,1237,262996,136605,2021-03-24,1616540400.0
8624,28,1,2021-03-25,8103,1368,271099,137973,2021-03-25,1616626800.0
8625,28,1,2021-03-26,8263,1152,279362,139125,2021-03-26,1616713200.0
8626,28,1,2021-03-27,5346,579,284708,139704,2021-03-27,1616799600.0
8627,28,1,2021-03-28,1392,48,286100,139752,2021-03-28,1616886000.0
8628,28,1,2021-03-29,7597,2729,293697,142481,2021-03-29,1616972400.0
8629,28,1,2021-03-30,8418,2742,302115,145223,2021-03-30,1617058800.0
8630,28,1,2021-03-31,9642,2962,311757,148185,2021-03-31,1617145200.0
8631,28,1,2021-04-01,11826,4537,323583,152722,2021-04-01,1617231600.0
8632,28,1,2021-04-02,10446,5517,334029,158239,2021-04-02,1617318000.0
8633,28,1,2021-04-03,4176,2969,338205,161208,2021-04-03,1617404400.0
8634,28,1,2021-04-04,1500,175,339705,161383,2021-04-04,1617490800.0
8635,28,1,2021-04-05,2294,671,341999,162054,2021-04-05,1617577200.0
8636,28,1,2021-04-06,8497,6574,350496,168628,2021-04-06,1617663600.0
8637,28,1,2021-04-07,10270,6360,360766,174988,2021-04-07,1617750000.0
8638,28,1,2021-04-08,11331,6806,372097,181794,2021-04-08,1617836400.0
8639,28,1,2021-04-09,11405,7038,383502,188832,2021-04-09,1617922800.0
8640,28,1,2021-04-10,9028,3113,392530,191945,2021-04-10,1618009200.0
8641,28,1,2021-04-11,2572,790,395102,192735,2021-04-11,1618095600.0
8642,28,1,2021-04-12,9265,7416,404367,200151,2021-04-12,1618185600.0
8643,28,1,2021-04-13,10373,7341,414740,207492,2021-04-13,1618272000.0
8644,28,1,2021-04-14,9669,7148,424409,214640,2021-04-14,1618358400.0
8645,28,1,2021-04-15,10463,7446,434872,222086,2021-04-15,1618444800.0
8646,28,1,2021-04-16,11091,6995,445963,229081,2021-04-16,1618531200.0
8647,28,1,2021-04-17,7578,4020,453541,233101,2021-04-17,1618617600.0
8648,28,1,2021-04-18,1567,1027,455108,234128,2021-04-18,1618704000.0
8649,28,1,2021-04-19,8347,7523,463455,241651,2021-04-19,1618790400.0
8650,28,1,2021-04-20,9685,7761,473140,249412,2021-04-20,1618876800.0
8651,28,1,2021-04-21,9706,7996,482846,257408,2021-04-21,1618963200.0
8652,28,1,2021-04-22,10144,9924,492990,267332,2021-04-22,1619049600.0
8653,28,1,2021-04-23,9823,9685,502813,277017,2021-04-23,1619136000.0
8654,28,1,2021-04-24,8979,5080,511792,282097,2021-04-24,1619222400.0
8655,28,1,2021-04-25,2888,546,514680,282643,2021-04-25,1619308800.0
8656,28,1,2021-04-26,9223,8456,523903,291099,2021-04-26,1619395200.0
8657,28,1,2021-04-27,10907,8714,534810,299813,2021-04-27,1619481600.0
8658,28,1,2021-04-28,11013,7637,545823,307450,2021-04-28,1619568000.0
8659,28,1,2021-04-29,13016,7975,558839,315425,2021-04-29,1619654400.0
8660,28,1,2021-04-30,13744,7709,572583,323134,2021-04-30,1619740800.0
8661,28,1,2021-05-01,7951,1893,580534,325027,2021-05-01,1619827200.0
8662,28,1,2021-05-02,5715,1399,586249,326426,2021-05-02,1619913600.0
8663,28,1,2021-05-03,11180,8009,597429,334435,2021-05-03,1620000000.0
8664,28,1,2021-05-04,10982,10346,608411,344781,2021-05-04,1620086400.0
8665,28,1,2021-05-05,11847,11825,620258,356606,2021-05-05,1620172800.0
8666,28,1,2021-05-06,14526,10936,634784,367542,2021-05-06,1620259200.0
8667,28,1,2021-05-07,12616,12161,647400,379703,2021-05-07,1620345600.0
8668,28,1,2021-05-08,8450,3702,655850,383405,2021-05-08,1620432000.0
8669,28,1,2021-05-09,4955,1286,660805,384691,2021-05-09,1620518400.0
8670,28,1,2021-05-10,11722,11637,672527,396328,2021-05-10,1620604800.0
8671,28,1,2021-05-11,13581,11293,686108,407621,2021-05-11,1620691200.0
8672,28,1,2021-05-12,14595,10214,700703,417835,2021-05-12,1620777600.0
8673,28,1,2021-05-13,16275,1969,716978,419804,2021-05-13,1620864000.0
8674,28,1,2021-05-14,21808,8136,738786,427940,2021-05-14,1620950400.0
8675,28,1,2021-05-15,18547,4569,757333,432509,2021-05-15,1621036800.0
8676,28,1,2021-05-16,7485,676,764818,433185,2021-05-16,1621123200.0
8677,28,1,2021-05-17,14450,6994,779268,440179,2021-05-17,1621206000.0
8678,28,1,2021-05-18,18326,5537,797594,445716,2021-05-18,1621292400.0
8679,28,1,2021-05-19,18500,5307,816094,451023,2021-05-19,1621378800.0
8680,28,1,2021-05-20,19533,4646,835627,455669,2021-05-20,1621465200.0
8681,28,1,2021-05-21,17160,5942,852787,461611,2021-05-21,1621551600.0
8682,28,1,2021-05-22,11923,2591,864710,464202,2021-05-22,1621638000.0
8683,28,1,2021-05-23,4139,357,868849,464559,2021-05-23,1621724400.0
8684,28,1,2021-05-24,12736,2054,881585,466613,2021-05-24,1621810800.0
8685,28,1,2021-05-25,17803,8163,899388,474776,2021-05-25,1621897200.0
8686,28,1,2021-05-26,17984,6011,917372,480787,2021-05-26,1621983600.0
8687,28,1,2021-05-27,19355,6289,936727,487076,2021-05-27,1622070000.0
8688,28,1,2021-05-28,17911,7592,954638,494668,2021-05-28,1622156400.0
8689,28,1,2021-05-29,13051,4524,967689,499192,2021-05-29,1622242800.0
8690,28,1,2021-05-30,5859,646,973548,499838,2021-05-30,1622329200.0
8691,28,1,2021-05-31,17203,7353,990751,507191,2021-05-31,1622415600.0
8692,28,1,2021-06-01,18666,7550,1009417,514741,2021-06-01,1622502000.0
8693,28,1,2021-06-02,17813,6712,1027230,521453,2021-06-02,1622588400.0
8694,28,1,2021-06-03,21183,6655,1048413,528108,2021-06-03,1622674800.0
8695,28,1,2021-06-04,18296,8226,1066709,536334,2021-06-04,1622761200.0
8696,28,1,2021-06-05,15010,6981,1081719,543315,2021-06-05,1622847600.0
8697,28,1,2021-06-06,7084,1705,1088803,545020,2021-06-06,1622934000.0
8698,28,1,2021-06-07,16920,10002,1105723,555022,2021-06-07,1623020400.0
8699,28,1,2021-06-08,18852,10346,1124575,565368,2021-06-08,1623106800.0
8700,28,1,2021-06-09,17174,9328,1141749,574696,2021-06-09,1623193200.0
8701,28,1,2021-06-10,18039,7472,1159788,582168,2021-06-10,1623279600.0
8702,28,1,2021-06-11,16826,11174,1176614,593342,2021-06-11,1623366000.0
8703,28,1,2021-06-12,15249,9344,1191863,602686,2021-06-12,1623452400.0
8704,28,1,2021-06-13,6149,4128,1198012,606814,2021-06-13,1623538800.0
8705,28,1,2021-06-14,11843,13483,1209855,620297,2021-06-14,1623625200.0
8706,28,1,2021-06-15,13451,12133,1223306,632430,2021-06-15,1623711600.0
8707,28,1,2021-06-16,14411,12116,1237717,644546,2021-06-16,1623798000.0
8708,28,1,2021-06-17,14124,11669,1251841,656215,2021-06-17,1623884400.0
8709,28,1,2021-06-18,14683,13040,1266524,669255,2021-06-18,1623970800.0
8710,28,1,2021-06-19,12577,9163,1279101,678418,2021-06-19,1624057200.0
8711,28,1,2021-06-20,4809,3732,1283910,682150,2021-06-20,1624143600.0
8712,28,1,2021-06-21,9890,15957,1293800,698107,2021-06-21,1624230000.0
8713,28,1,2021-06-22,10396,16465,1304196,714572,2021-06-22,1624316400.0
8714,28,1,2021-06-23,10177,16187,1314373,730759,2021-06-23,1624402800.0
8715,28,1,2021-06-24,10163,15407,1324536,746166,2021-06-24,1624489200.0
8716,28,1,2021-06-25,9553,19230,1334089,765396,2021-06-25,1624575600.0
8717,28,1,2021-06-26,7825,14975,1341914,780371,2021-06-26,1624662000.0
8718,28,1,2021-06-27,2657,5202,1344571,785573,2021-06-27,1624748400.0
8719,28,1,2021-06-28,7500,18178,1352071,803751,2021-06-28,1624834800.0
8720,28,1,2021-06-29,8131,19885,1360202,823636,2021-06-29,1624921200.0
8721,28,1,2021-06-30,9711,18379,1369913,842015,2021-06-30,1625007600.0
8722,28,1,2021-07-01,10512,15517,1380425,857532,2021-07-01,1625094000.0
8723,28,1,2021-07-02,9121,18565,1389546,876097,2021-07-02,1625180400.0
8724,28,1,2021-07-03,7111,12253,1396657,888350,2021-07-03,1625266800.0
8725,28,1,2021-07-04,2768,4565,1399425,892915,2021-07-04,1625353200.0
8726,28,1,2021-07-05,7802,18179,1407227,911094,2021-07-05,1625439600.0
8727,28,1,2021-07-06,8606,19928,1415833,931022,2021-07-06,1625526000.0
8728,28,1,2021-07-07,9462,18814,1425295,949836,2021-07-07,1625612400.0
8729,28,1,2021-07-08,9984,17062,1435279,966898,2021-07-08,1625698800.0
8730,28,2,2020-12-27,0,0,0,0,2020-12-27,1609023600.0
8731,28,2,2020-12-28,0,0,0,0,2020-12-28,1609110000.0
8732,28,2,2020-12-29,0,0,0,0,2020-12-29,1609196400.0
8733,28,2,2020-12-30,0,0,0,0,2020-12-30,1609282800.0
8734,28,2,2020-12-31,0,0,0,0,2020-12-31,1609369200.0
8735,28,2,2021-01-01,0,0,0,0,2021-01-01,1609455600.0
8736,28,2,2021-01-02,0,0,0,0,2021-01-02,1609542000.0
8737,28,2,2021-01-03,0,0,0,0,2021-01-03,1609628400.0
8738,28,2,2021-01-04,0,0,0,0,2021-01-04,1609714800.0
8739,28,2,2021-01-05,0,0,0,0,2021-01-05,1609801200.0
8740,28,2,2021-01-06,0,0,0,0,2021-01-06,1609887600.0
8741,28,2,2021-01-07,0,0,0,0,2021-01-07,1609974000.0
8742,28,2,2021-01-08,0,0,0,0,2021-01-08,1610060400.0
8743,28,2,2021-01-09,0,0,0,0,2021-01-09,1610146800.0
8744,28,2,2021-01-10,0,0,0,0,2021-01-10,1610233200.0
8745,28,2,2021-01-11,0,0,0,0,2021-01-11,1610319600.0
8746,28,2,2021-01-12,0,0,0,0,2021-01-12,1610406000.0
8747,28,2,2021-01-13,0,0,0,0,2021-01-13,1610492400.0
8748,28,2,2021-01-14,0,0,0,0,2021-01-14,1610578800.0
8749,28,2,2021-01-15,0,0,0,0,2021-01-15,1610665200.0
8750,28,2,2021-01-16,0,0,0,0,2021-01-16,1610751600.0
8751,28,2,2021-01-17,0,0,0,0,2021-01-17,1610838000.0
8752,28,2,2021-01-18,1,0,1,0,2021-01-18,1610924400.0
8753,28,2,2021-01-19,1,0,2,0,2021-01-19,1611010800.0
8754,28,2,2021-01-20,0,0,2,0,2021-01-20,1611097200.0
8755,28,2,2021-01-21,0,0,2,0,2021-01-21,1611183600.0
8756,28,2,2021-01-22,0,0,2,0,2021-01-22,1611270000.0
8757,28,2,2021-01-23,0,0,2,0,2021-01-23,1611356400.0
8758,28,2,2021-01-24,0,0,2,0,2021-01-24,1611442800.0
8759,28,2,2021-01-25,2,0,4,0,2021-01-25,1611529200.0
8760,28,2,2021-01-26,1,0,5,0,2021-01-26,1611615600.0
8761,28,2,2021-01-27,0,0,5,0,2021-01-27,1611702000.0
8762,28,2,2021-01-28,0,0,5,0,2021-01-28,1611788400.0
8763,28,2,2021-01-29,0,0,5,0,2021-01-29,1611874800.0
8764,28,2,2021-01-30,0,0,5,0,2021-01-30,1611961200.0
8765,28,2,2021-01-31,0,0,5,0,2021-01-31,1612047600.0
8766,28,2,2021-02-01,1,0,6,0,2021-02-01,1612134000.0
8767,28,2,2021-02-02,1,0,7,0,2021-02-02,1612220400.0
8768,28,2,2021-02-03,0,0,7,0,2021-02-03,1612306800.0
8769,28,2,2021-02-04,0,0,7,0,2021-02-04,1612393200.0
8770,28,2,2021-02-05,0,0,7,0,2021-02-05,1612479600.0
8771,28,2,2021-02-06,1,0,8,0,2021-02-06,1612566000.0
8772,28,2,2021-02-07,0,0,8,0,2021-02-07,1612652400.0
8773,28,2,2021-02-08,414,0,422,0,2021-02-08,1612738800.0
8774,28,2,2021-02-09,520,1,942,1,2021-02-09,1612825200.0
8775,28,2,2021-02-10,575,1,1517,2,2021-02-10,1612911600.0
8776,28,2,2021-02-11,740,0,2257,2,2021-02-11,1612998000.0
8777,28,2,2021-02-12,579,0,2836,2,2021-02-12,1613084400.0
8778,28,2,2021-02-13,29,0,2865,2,2021-02-13,1613170800.0
8779,28,2,2021-02-14,0,0,2865,2,2021-02-14,1613257200.0
8780,28,2,2021-02-15,149,1,3014,3,2021-02-15,1613343600.0
8781,28,2,2021-02-16,458,0,3472,3,2021-02-16,1613430000.0
8782,28,2,2021-02-17,215,1,3687,4,2021-02-17,1613516400.0
8783,28,2,2021-02-18,345,0,4032,4,2021-02-18,1613602800.0
8784,28,2,2021-02-19,454,0,4486,4,2021-02-19,1613689200.0
8785,28,2,2021-02-20,314,1,4800,5,2021-02-20,1613775600.0
8786,28,2,2021-02-21,83,0,4883,5,2021-02-21,1613862000.0
8787,28,2,2021-02-22,289,2,5172,7,2021-02-22,1613948400.0
8788,28,2,2021-02-23,274,3,5446,10,2021-02-23,1614034800.0
8789,28,2,2021-02-24,198,0,5644,10,2021-02-24,1614121200.0
8790,28,2,2021-02-25,232,1,5876,11,2021-02-25,1614207600.0
8791,28,2,2021-02-26,377,1,6253,12,2021-02-26,1614294000.0
8792,28,2,2021-02-27,448,0,6701,12,2021-02-27,1614380400.0
8793,28,2,2021-02-28,96,0,6797,12,2021-02-28,1614466800.0
8794,28,2,2021-03-01,22,1,6819,13,2021-03-01,1614553200.0
8795,28,2,2021-03-02,66,1,6885,14,2021-03-02,1614639600.0
8796,28,2,2021-03-03,216,0,7101,14,2021-03-03,1614726000.0
8797,28,2,2021-03-04,565,2,7666,16,2021-03-04,1614812400.0
8798,28,2,2021-03-05,335,3,8001,19,2021-03-05,1614898800.0
8799,28,2,2021-03-06,900,23,8901,42,2021-03-06,1614985200.0
8800,28,2,2021-03-07,700,17,9601,59,2021-03-07,1615071600.0
8801,28,2,2021-03-08,237,564,9838,623,2021-03-08,1615158000.0
8802,28,2,2021-03-09,456,595,10294,1218,2021-03-09,1615244400.0
8803,28,2,2021-03-10,249,559,10543,1777,2021-03-10,1615330800.0
8804,28,2,2021-03-11,448,626,10991,2403,2021-03-11,1615417200.0
8805,28,2,2021-03-12,363,345,11354,2748,2021-03-12,1615503600.0
8806,28,2,2021-03-13,818,46,12172,2794,2021-03-13,1615590000.0
8807,28,2,2021-03-14,349,11,12521,2805,2021-03-14,1615676400.0
8808,28,2,2021-03-15,265,155,12786,2960,2021-03-15,1615762800.0
8809,28,2,2021-03-16,533,439,13319,3399,2021-03-16,1615849200.0
8810,28,2,2021-03-17,567,173,13886,3572,2021-03-17,1615935600.0
8811,28,2,2021-03-18,595,337,14481,3909,2021-03-18,1616022000.0
8812,28,2,2021-03-19,326,550,14807,4459,2021-03-19,1616108400.0
8813,28,2,2021-03-20,626,300,15433,4759,2021-03-20,1616194800.0
8814,28,2,2021-03-21,220,0,15653,4759,2021-03-21,1616281200.0
8815,28,2,2021-03-22,1150,294,16803,5053,2021-03-22,1616367600.0
8816,28,2,2021-03-23,1588,278,18391,5331,2021-03-23,1616454000.0
8817,28,2,2021-03-24,1789,190,20180,5521,2021-03-24,1616540400.0
8818,28,2,2021-03-25,1596,229,21776,5750,2021-03-25,1616626800.0
8819,28,2,2021-03-26,2102,476,23878,6226,2021-03-26,1616713200.0
8820,28,2,2021-03-27,1745,405,25623,6631,2021-03-27,1616799600.0
8821,28,2,2021-03-28,1283,2,26906,6633,2021-03-28,1616886000.0
8822,28,2,2021-03-29,1353,57,28259,6690,2021-03-29,1616972400.0
8823,28,2,2021-03-30,1842,74,30101,6764,2021-03-30,1617058800.0
8824,28,2,2021-03-31,1779,192,31880,6956,2021-03-31,1617145200.0
8825,28,2,2021-04-01,1806,543,33686,7499,2021-04-01,1617231600.0
8826,28,2,2021-04-02,1321,482,35007,7981,2021-04-02,1617318000.0
8827,28,2,2021-04-03,765,871,35772,8852,2021-04-03,1617404400.0
8828,28,2,2021-04-04,191,591,35963,9443,2021-04-04,1617490800.0
8829,28,2,2021-04-05,955,28,36918,9471,2021-04-05,1617577200.0
8830,28,2,2021-04-06,1175,589,38093,10060,2021-04-06,1617663600.0
8831,28,2,2021-04-07,1103,344,39196,10404,2021-04-07,1617750000.0
8832,28,2,2021-04-08,1628,400,40824,10804,2021-04-08,1617836400.0
8833,28,2,2021-04-09,1676,381,42500,11185,2021-04-09,1617922800.0
8834,28,2,2021-04-10,303,785,42803,11970,2021-04-10,1618009200.0
8835,28,2,2021-04-11,200,340,43003,12310,2021-04-11,1618095600.0
8836,28,2,2021-04-12,1333,336,44336,12646,2021-04-12,1618185600.0
8837,28,2,2021-04-13,1090,394,45426,13040,2021-04-13,1618272000.0
8838,28,2,2021-04-14,1195,515,46621,13555,2021-04-14,1618358400.0
8839,28,2,2021-04-15,1073,532,47694,14087,2021-04-15,1618444800.0
8840,28,2,2021-04-16,1380,300,49074,14387,2021-04-16,1618531200.0
8841,28,2,2021-04-17,1437,669,50511,15056,2021-04-17,1618617600.0
8842,28,2,2021-04-18,222,121,50733,15177,2021-04-18,1618704000.0
8843,28,2,2021-04-19,894,1066,51627,16243,2021-04-19,1618790400.0
8844,28,2,2021-04-20,1539,1624,53166,17867,2021-04-20,1618876800.0
8845,28,2,2021-04-21,1223,1628,54389,19495,2021-04-21,1618963200.0
8846,28,2,2021-04-22,1371,1476,55760,20971,2021-04-22,1619049600.0
8847,28,2,2021-04-23,1596,1928,57356,22899,2021-04-23,1619136000.0
8848,28,2,2021-04-24,690,1625,58046,24524,2021-04-24,1619222400.0
8849,28,2,2021-04-25,96,1265,58142,25789,2021-04-25,1619308800.0
8850,28,2,2021-04-26,1301,1086,59443,26875,2021-04-26,1619395200.0
8851,28,2,2021-04-27,893,1910,60336,28785,2021-04-27,1619481600.0
8852,28,2,2021-04-28,1182,1868,61518,30653,2021-04-28,1619568000.0
8853,28,2,2021-04-29,1001,1852,62519,32505,2021-04-29,1619654400.0
8854,28,2,2021-04-30,1074,1554,63593,34059,2021-04-30,1619740800.0
8855,28,2,2021-05-01,3800,432,67393,34491,2021-05-01,1619827200.0
8856,28,2,2021-05-02,75,193,67468,34684,2021-05-02,1619913600.0
8857,28,2,2021-05-03,628,1152,68096,35836,2021-05-03,1620000000.0
8858,28,2,2021-05-04,573,1369,68669,37205,2021-05-04,1620086400.0
8859,28,2,2021-05-05,589,1213,69258,38418,2021-05-05,1620172800.0
8860,28,2,2021-05-06,580,1518,69838,39936,2021-05-06,1620259200.0
8861,28,2,2021-05-07,974,1669,70812,41605,2021-05-07,1620345600.0
8862,28,2,2021-05-08,3581,129,74393,41734,2021-05-08,1620432000.0
8863,28,2,2021-05-09,2106,200,76499,41934,2021-05-09,1620518400.0
8864,28,2,2021-05-10,764,1530,77263,43464,2021-05-10,1620604800.0
8865,28,2,2021-05-11,1447,1234,78710,44698,2021-05-11,1620691200.0
8866,28,2,2021-05-12,2409,1111,81119,45809,2021-05-12,1620777600.0
8867,28,2,2021-05-13,3244,866,84363,46675,2021-05-13,1620864000.0
8868,28,2,2021-05-14,2802,956,87165,47631,2021-05-14,1620950400.0
8869,28,2,2021-05-15,7740,297,94905,47928,2021-05-15,1621036800.0
8870,28,2,2021-05-16,6564,174,101469,48102,2021-05-16,1621123200.0
8871,28,2,2021-05-17,1032,673,102501,48775,2021-05-17,1621206000.0
8872,28,2,2021-05-18,1397,495,103898,49270,2021-05-18,1621292400.0
8873,28,2,2021-05-19,1318,475,105216,49745,2021-05-19,1621378800.0
8874,28,2,2021-05-20,1995,349,107211,50094,2021-05-20,1621465200.0
8875,28,2,2021-05-21,2504,374,109715,50468,2021-05-21,1621551600.0
8876,28,2,2021-05-22,5050,110,114765,50578,2021-05-22,1621638000.0
8877,28,2,2021-05-23,4954,30,119719,50608,2021-05-23,1621724400.0
8878,28,2,2021-05-24,622,227,120341,50835,2021-05-24,1621810800.0
8879,28,2,2021-05-25,694,430,121035,51265,2021-05-25,1621897200.0
8880,28,2,2021-05-26,751,402,121786,51667,2021-05-26,1621983600.0
8881,28,2,2021-05-27,973,377,122759,52044,2021-05-27,1622070000.0
8882,28,2,2021-05-28,1454,720,124213,52764,2021-05-28,1622156400.0
8883,28,2,2021-05-29,3697,1189,127910,53953,2021-05-29,1622242800.0
8884,28,2,2021-05-30,335,10,128245,53963,2021-05-30,1622329200.0
8885,28,2,2021-05-31,1922,1342,130167,55305,2021-05-31,1622415600.0
8886,28,2,2021-06-01,3688,1058,133855,56363,2021-06-01,1622502000.0
8887,28,2,2021-06-02,2112,1088,135967,57451,2021-06-02,1622588400.0
8888,28,2,2021-06-03,3992,1385,139959,58836,2021-06-03,1622674800.0
8889,28,2,2021-06-04,4466,1729,144425,60565,2021-06-04,1622761200.0
8890,28,2,2021-06-05,2537,324,146962,60889,2021-06-05,1622847600.0
8891,28,2,2021-06-06,480,62,147442,60951,2021-06-06,1622934000.0
8892,28,2,2021-06-07,1663,1063,149105,62014,2021-06-07,1623020400.0
8893,28,2,2021-06-08,2758,814,151863,62828,2021-06-08,1623106800.0
8894,28,2,2021-06-09,1823,1349,153686,64177,2021-06-09,1623193200.0
8895,28,2,2021-06-10,2279,1034,155965,65211,2021-06-10,1623279600.0
8896,28,2,2021-06-11,2990,1229,158955,66440,2021-06-11,1623366000.0
8897,28,2,2021-06-12,2162,3916,161117,70356,2021-06-12,1623452400.0
8898,28,2,2021-06-13,133,1092,161250,71448,2021-06-13,1623538800.0
8899,28,2,2021-06-14,1658,1044,162908,72492,2021-06-14,1623625200.0
8900,28,2,2021-06-15,2056,959,164964,73451,2021-06-15,1623711600.0
8901,28,2,2021-06-16,1725,1633,166689,75084,2021-06-16,1623798000.0
8902,28,2,2021-06-17,2365,1329,169054,76413,2021-06-17,1623884400.0
8903,28,2,2021-06-18,2946,1461,172000,77874,2021-06-18,1623970800.0
8904,28,2,2021-06-19,1886,2840,173886,80714,2021-06-19,1624057200.0
8905,28,2,2021-06-20,136,895,174022,81609,2021-06-20,1624143600.0
8906,28,2,2021-06-21,1136,1406,175158,83015,2021-06-21,1624230000.0
8907,28,2,2021-06-22,1773,2081,176931,85096,2021-06-22,1624316400.0
8908,28,2,2021-06-23,1329,3779,178260,88875,2021-06-23,1624402800.0
8909,28,2,2021-06-24,1908,2997,180168,91872,2021-06-24,1624489200.0
8910,28,2,2021-06-25,2175,2734,182343,94606,2021-06-25,1624575600.0
8911,28,2,2021-06-26,997,5195,183340,99801,2021-06-26,1624662000.0
8912,28,2,2021-06-27,214,4346,183554,104147,2021-06-27,1624748400.0
8913,28,2,2021-06-28,555,1734,184109,105881,2021-06-28,1624834800.0
8914,28,2,2021-06-29,1181,1601,185290,107482,2021-06-29,1624921200.0
8915,28,2,2021-06-30,1033,1758,186323,109240,2021-06-30,1625007600.0
8916,28,2,2021-07-01,1163,2212,187486,111452,2021-07-01,1625094000.0
8917,28,2,2021-07-02,1370,2818,188856,114270,2021-07-02,1625180400.0
8918,28,2,2021-07-03,665,5474,189521,119744,2021-07-03,1625266800.0
8919,28,2,2021-07-04,111,3990,189632,123734,2021-07-04,1625353200.0
8920,28,2,2021-07-05,393,1280,190025,125014,2021-07-05,1625439600.0
8921,28,2,2021-07-06,716,1664,190741,126678,2021-07-06,1625526000.0
8922,28,2,2021-07-07,590,1649,191331,128327,2021-07-07,1625612400.0
8923,28,2,2021-07-08,920,2056,192251,130383,2021-07-08,1625698800.0
8924,28,3,2020-12-27,0,0,0,0,2020-12-27,1609023600.0
8925,28,3,2020-12-28,0,0,0,0,2020-12-28,1609110000.0
8926,28,3,2020-12-29,0,0,0,0,2020-12-29,1609196400.0
8927,28,3,2020-12-30,0,0,0,0,2020-12-30,1609282800.0
8928,28,3,2020-12-31,0,0,0,0,2020-12-31,1609369200.0
8929,28,3,2021-01-01,0,0,0,0,2021-01-01,1609455600.0
8930,28,3,2021-01-02,0,0,0,0,2021-01-02,1609542000.0
8931,28,3,2021-01-03,0,0,0,0,2021-01-03,1609628400.0
8932,28,3,2021-01-04,0,0,0,0,2021-01-04,1609714800.0
8933,28,3,2021-01-05,0,0,0,0,2021-01-05,1609801200.0
8934,28,3,2021-01-06,0,0,0,0,2021-01-06,1609887600.0
8935,28,3,2021-01-07,0,0,0,0,2021-01-07,1609974000.0
8936,28,3,2021-01-08,0,0,0,0,2021-01-08,1610060400.0
8937,28,3,2021-01-09,0,0,0,0,2021-01-09,1610146800.0
8938,28,3,2021-01-10,0,0,0,0,2021-01-10,1610233200.0
8939,28,3,2021-01-11,0,0,0,0,2021-01-11,1610319600.0
8940,28,3,2021-01-12,0,0,0,0,2021-01-12,1610406000.0
8941,28,3,2021-01-13,0,0,0,0,2021-01-13,1610492400.0
8942,28,3,2021-01-14,0,0,0,0,2021-01-14,1610578800.0
8943,28,3,2021-01-15,0,0,0,0,2021-01-15,1610665200.0
8944,28,3,2021-01-16,0,0,0,0,2021-01-16,1610751600.0
8945,28,3,2021-01-17,0,0,0,0,2021-01-17,1610838000.0
8946,28,3,2021-01-18,0,0,0,0,2021-01-18,1610924400.0
8947,28,3,2021-01-19,0,0,0,0,2021-01-19,1611010800.0
8948,28,3,2021-01-20,0,0,0,0,2021-01-20,1611097200.0
8949,28,3,2021-01-21,0,0,0,0,2021-01-21,1611183600.0
8950,28,3,2021-01-22,0,0,0,0,2021-01-22,1611270000.0
8951,28,3,2021-01-23,0,0,0,0,2021-01-23,1611356400.0
8952,28,3,2021-01-24,0,0,0,0,2021-01-24,1611442800.0
8953,28,3,2021-01-25,0,0,0,0,2021-01-25,1611529200.0
8954,28,3,2021-01-26,0,0,0,0,2021-01-26,1611615600.0
8955,28,3,2021-01-27,0,0,0,0,2021-01-27,1611702000.0
8956,28,3,2021-01-28,0,0,0,0,2021-01-28,1611788400.0
8957,28,3,2021-01-29,0,0,0,0,2021-01-29,1611874800.0
8958,28,3,2021-01-30,0,0,0,0,2021-01-30,1611961200.0
8959,28,3,2021-01-31,0,0,0,0,2021-01-31,1612047600.0
8960,28,3,2021-02-01,0,0,0,0,2021-02-01,1612134000.0
8961,28,3,2021-02-02,0,0,0,0,2021-02-02,1612220400.0
8962,28,3,2021-02-03,0,0,0,0,2021-02-03,1612306800.0
8963,28,3,2021-02-04,0,0,0,0,2021-02-04,1612393200.0
8964,28,3,2021-02-05,0,0,0,0,2021-02-05,1612479600.0
8965,28,3,2021-02-06,13,0,13,0,2021-02-06,1612566000.0
8966,28,3,2021-02-07,83,0,96,0,2021-02-07,1612652400.0
8967,28,3,2021-02-08,131,0,227,0,2021-02-08,1612738800.0
8968,28,3,2021-02-09,226,0,453,0,2021-02-09,1612825200.0
8969,28,3,2021-02-10,753,0,1206,0,2021-02-10,1612911600.0
8970,28,3,2021-02-11,1549,0,2755,0,2021-02-11,1612998000.0
8971,28,3,2021-02-12,1540,0,4295,0,2021-02-12,1613084400.0
8972,28,3,2021-02-13,423,0,4718,0,2021-02-13,1613170800.0
8973,28,3,2021-02-14,22,0,4740,0,2021-02-14,1613257200.0
8974,28,3,2021-02-15,938,0,5678,0,2021-02-15,1613343600.0
8975,28,3,2021-02-16,1161,0,6839,0,2021-02-16,1613430000.0
8976,28,3,2021-02-17,883,0,7722,0,2021-02-17,1613516400.0
8977,28,3,2021-02-18,1475,0,9197,0,2021-02-18,1613602800.0
8978,28,3,2021-02-19,1359,0,10556,0,2021-02-19,1613689200.0
8979,28,3,2021-02-20,180,0,10736,0,2021-02-20,1613775600.0
8980,28,3,2021-02-21,2,0,10738,0,2021-02-21,1613862000.0
8981,28,3,2021-02-22,586,0,11324,0,2021-02-22,1613948400.0
8982,28,3,2021-02-23,801,0,12125,0,2021-02-23,1614034800.0
8983,28,3,2021-02-24,1076,0,13201,0,2021-02-24,1614121200.0
8984,28,3,2021-02-25,3179,0,16380,0,2021-02-25,1614207600.0
8985,28,3,2021-02-26,4119,0,20499,0,2021-02-26,1614294000.0
8986,28,3,2021-02-27,2077,1,22576,1,2021-02-27,1614380400.0
8987,28,3,2021-02-28,88,0,22664,1,2021-02-28,1614466800.0
8988,28,3,2021-03-01,747,1,23411,2,2021-03-01,1614553200.0
8989,28,3,2021-03-02,1751,2,25162,4,2021-03-02,1614639600.0
8990,28,3,2021-03-03,2295,0,27457,4,2021-03-03,1614726000.0
8991,28,3,2021-03-04,3889,1,31346,5,2021-03-04,1614812400.0
8992,28,3,2021-03-05,5915,0,37261,5,2021-03-05,1614898800.0
8993,28,3,2021-03-06,3806,3,41067,8,2021-03-06,1614985200.0
8994,28,3,2021-03-07,319,0,41386,8,2021-03-07,1615071600.0
8995,28,3,2021-03-08,1734,0,43120,8,2021-03-08,1615158000.0
8996,28,3,2021-03-09,3579,1,46699,9,2021-03-09,1615244400.0
8997,28,3,2021-03-10,3771,2,50470,11,2021-03-10,1615330800.0
8998,28,3,2021-03-11,6998,1,57468,12,2021-03-11,1615417200.0
8999,28,3,2021-03-12,10427,6,67895,18,2021-03-12,1615503600.0
9000,28,3,2021-03-13,7035,3,74930,21,2021-03-13,1615590000.0
9001,28,3,2021-03-14,405,0,75335,21,2021-03-14,1615676400.0
9002,28,3,2021-03-15,1557,0,76892,21,2021-03-15,1615762800.0
9003,28,3,2021-03-16,28,0,76920,21,2021-03-16,1615849200.0
9004,28,3,2021-03-17,32,0,76952,21,2021-03-17,1615935600.0
9005,28,3,2021-03-18,39,0,76991,21,2021-03-18,1616022000.0
9006,28,3,2021-03-19,3928,1,80919,22,2021-03-19,1616108400.0
9007,28,3,2021-03-20,4080,1,84999,23,2021-03-20,1616194800.0
9008,28,3,2021-03-21,443,0,85442,23,2021-03-21,1616281200.0
9009,28,3,2021-03-22,1242,3,86684,26,2021-03-22,1616367600.0
9010,28,3,2021-03-23,3599,0,90283,26,2021-03-23,1616454000.0
9011,28,3,2021-03-24,4351,1,94634,27,2021-03-24,1616540400.0
9012,28,3,2021-03-25,7920,2,102554,29,2021-03-25,1616626800.0
9013,28,3,2021-03-26,10465,7,113019,36,2021-03-26,1616713200.0
9014,28,3,2021-03-27,4407,2,117426,38,2021-03-27,1616799600.0
9015,28,3,2021-03-28,291,0,117717,38,2021-03-28,1616886000.0
9016,28,3,2021-03-29,2822,3,120539,41,2021-03-29,1616972400.0
9017,28,3,2021-03-30,4160,1,124699,42,2021-03-30,1617058800.0
9018,28,3,2021-03-31,2972,1,127671,43,2021-03-31,1617145200.0
9019,28,3,2021-04-01,4405,2,132076,45,2021-04-01,1617231600.0
9020,28,3,2021-04-02,5049,2,137125,47,2021-04-02,1617318000.0
9021,28,3,2021-04-03,2066,5,139191,52,2021-04-03,1617404400.0
9022,28,3,2021-04-04,87,0,139278,52,2021-04-04,1617490800.0
9023,28,3,2021-04-05,41,0,139319,52,2021-04-05,1617577200.0
9024,28,3,2021-04-06,1144,4,140463,56,2021-04-06,1617663600.0
9025,28,3,2021-04-07,1321,2,141784,58,2021-04-07,1617750000.0
9026,28,3,2021-04-08,4715,14,146499,72,2021-04-08,1617836400.0
9027,28,3,2021-04-09,10740,15,157239,87,2021-04-09,1617922800.0
9028,28,3,2021-04-10,4511,15,161750,102,2021-04-10,1618009200.0
9029,28,3,2021-04-11,256,0,162006,102,2021-04-11,1618095600.0
9030,28,3,2021-04-12,3190,3,165196,105,2021-04-12,1618185600.0
9031,28,3,2021-04-13,4721,8,169917,113,2021-04-13,1618272000.0
9032,28,3,2021-04-14,3465,23,173382,136,2021-04-14,1618358400.0
9033,28,3,2021-04-15,5696,31,179078,167,2021-04-15,1618444800.0
9034,28,3,2021-04-16,7810,67,186888,234,2021-04-16,1618531200.0
9035,28,3,2021-04-17,3735,28,190623,262,2021-04-17,1618617600.0
9036,28,3,2021-04-18,500,0,191123,262,2021-04-18,1618704000.0
9037,28,3,2021-04-19,1625,15,192748,277,2021-04-19,1618790400.0
9038,28,3,2021-04-20,2679,26,195427,303,2021-04-20,1618876800.0
9039,28,3,2021-04-21,2356,17,197783,320,2021-04-21,1618963200.0
9040,28,3,2021-04-22,3782,80,201565,400,2021-04-22,1619049600.0
9041,28,3,2021-04-23,4997,74,206562,474,2021-04-23,1619136000.0
9042,28,3,2021-04-24,2813,82,209375,556,2021-04-24,1619222400.0
9043,28,3,2021-04-25,303,10,209678,566,2021-04-25,1619308800.0
9044,28,3,2021-04-26,1775,75,211453,641,2021-04-26,1619395200.0
9045,28,3,2021-04-27,2389,55,213842,696,2021-04-27,1619481600.0
9046,28,3,2021-04-28,2266,203,216108,899,2021-04-28,1619568000.0
9047,28,3,2021-04-29,3487,424,219595,1323,2021-04-29,1619654400.0
9048,28,3,2021-04-30,4288,703,223883,2026,2021-04-30,1619740800.0
9049,28,3,2021-05-01,935,94,224818,2120,2021-05-01,1619827200.0
9050,28,3,2021-05-02,185,44,225003,2164,2021-05-02,1619913600.0
9051,28,3,2021-05-03,770,153,225773,2317,2021-05-03,1620000000.0
9052,28,3,2021-05-04,1654,360,227427,2677,2021-05-04,1620086400.0
9053,28,3,2021-05-05,1159,613,228586,3290,2021-05-05,1620172800.0
9054,28,3,2021-05-06,2547,1272,231133,4562,2021-05-06,1620259200.0
9055,28,3,2021-05-07,2953,1576,234086,6138,2021-05-07,1620345600.0
9056,28,3,2021-05-08,503,379,234589,6517,2021-05-08,1620432000.0
9057,28,3,2021-05-09,73,61,234662,6578,2021-05-09,1620518400.0
9058,28,3,2021-05-10,1331,680,235993,7258,2021-05-10,1620604800.0
9059,28,3,2021-05-11,2283,1348,238276,8606,2021-05-11,1620691200.0
9060,28,3,2021-05-12,1308,1418,239584,10024,2021-05-12,1620777600.0
9061,28,3,2021-05-13,101,118,239685,10142,2021-05-13,1620864000.0
9062,28,3,2021-05-14,1219,1789,240904,11931,2021-05-14,1620950400.0
9063,28,3,2021-05-15,447,985,241351,12916,2021-05-15,1621036800.0
9064,28,3,2021-05-16,70,128,241421,13044,2021-05-16,1621123200.0
9065,28,3,2021-05-17,560,924,241981,13968,2021-05-17,1621206000.0
9066,28,3,2021-05-18,1009,1472,242990,15440,2021-05-18,1621292400.0
9067,28,3,2021-05-19,817,1568,243807,17008,2021-05-19,1621378800.0
9068,28,3,2021-05-20,1055,3136,244862,20144,2021-05-20,1621465200.0
9069,28,3,2021-05-21,928,3982,245790,24126,2021-05-21,1621551600.0
9070,28,3,2021-05-22,310,2208,246100,26334,2021-05-22,1621638000.0
9071,28,3,2021-05-23,38,174,246138,26508,2021-05-23,1621724400.0
9072,28,3,2021-05-24,20,214,246158,26722,2021-05-24,1621810800.0
9073,28,3,2021-05-25,322,1648,246480,28370,2021-05-25,1621897200.0
9074,28,3,2021-05-26,315,2200,246795,30570,2021-05-26,1621983600.0
9075,28,3,2021-05-27,441,3525,247236,34095,2021-05-27,1622070000.0
9076,28,3,2021-05-28,514,5380,247750,39475,2021-05-28,1622156400.0
9077,28,3,2021-05-29,207,2971,247957,42446,2021-05-29,1622242800.0
9078,28,3,2021-05-30,31,250,247988,42696,2021-05-30,1622329200.0
9079,28,3,2021-05-31,107,1658,248095,44354,2021-05-31,1622415600.0
9080,28,3,2021-06-01,191,2943,248286,47297,2021-06-01,1622502000.0
9081,28,3,2021-06-02,141,2639,248427,49936,2021-06-02,1622588400.0
9082,28,3,2021-06-03,180,4298,248607,54234,2021-06-03,1622674800.0
9083,28,3,2021-06-04,256,6151,248863,60385,2021-06-04,1622761200.0
9084,28,3,2021-06-05,123,3152,248986,63537,2021-06-05,1622847600.0
9085,28,3,2021-06-06,32,185,249018,63722,2021-06-06,1622934000.0
9086,28,3,2021-06-07,63,1456,249081,65178,2021-06-07,1623020400.0
9087,28,3,2021-06-08,87,2225,249168,67403,2021-06-08,1623106800.0
9088,28,3,2021-06-09,91,2229,249259,69632,2021-06-09,1623193200.0
9089,28,3,2021-06-10,132,4234,249391,73866,2021-06-10,1623279600.0
9090,28,3,2021-06-11,135,6484,249526,80350,2021-06-11,1623366000.0
9091,28,3,2021-06-12,77,2514,249603,82864,2021-06-12,1623452400.0
9092,28,3,2021-06-13,5,243,249608,83107,2021-06-13,1623538800.0
9093,28,3,2021-06-14,67,2026,249675,85133,2021-06-14,1623625200.0
9094,28,3,2021-06-15,80,4035,249755,89168,2021-06-15,1623711600.0
9095,28,3,2021-06-16,73,3381,249828,92549,2021-06-16,1623798000.0
9096,28,3,2021-06-17,54,5659,249882,98208,2021-06-17,1623884400.0
9097,28,3,2021-06-18,119,7929,250001,106137,2021-06-18,1623970800.0
9098,28,3,2021-06-19,34,2576,250035,108713,2021-06-19,1624057200.0
9099,28,3,2021-06-20,4,114,250039,108827,2021-06-20,1624143600.0
9100,28,3,2021-06-21,40,2304,250079,111131,2021-06-21,1624230000.0
9101,28,3,2021-06-22,34,3769,250113,114900,2021-06-22,1624316400.0
9102,28,3,2021-06-23,22,2345,250135,117245,2021-06-23,1624402800.0
9103,28,3,2021-06-24,52,4390,250187,121635,2021-06-24,1624489200.0
9104,28,3,2021-06-25,103,5703,250290,127338,2021-06-25,1624575600.0
9105,28,3,2021-06-26,35,2084,250325,129422,2021-06-26,1624662000.0
9106,28,3,2021-06-27,3,254,250328,129676,2021-06-27,1624748400.0
9107,28,3,2021-06-28,27,1998,250355,131674,2021-06-28,1624834800.0
9108,28,3,2021-06-29,48,3234,250403,134908,2021-06-29,1624921200.0
9109,28,3,2021-06-30,47,2668,250450,137576,2021-06-30,1625007600.0
9110,28,3,2021-07-01,55,4210,250505,141786,2021-07-01,1625094000.0
9111,28,3,2021-07-02,53,6420,250558,148206,2021-07-02,1625180400.0
9112,28,3,2021-07-03,42,2271,250600,150477,2021-07-03,1625266800.0
9113,28,3,2021-07-04,1,207,250601,150684,2021-07-04,1625353200.0
9114,28,3,2021-07-05,33,2094,250634,152778,2021-07-05,1625439600.0
9115,28,3,2021-07-06,48,3754,250682,156532,2021-07-06,1625526000.0
9116,28,3,2021-07-07,59,2761,250741,159293,2021-07-07,1625612400.0
9117,28,3,2021-07-08,39,4274,250780,163567,2021-07-08,1625698800.0
9118,28,4,2020-12-27,0,0,0,0,2020-12-27,1609023600.0
9119,28,4,2020-12-28,0,0,0,0,2020-12-28,1609110000.0
9120,28,4,2020-12-29,0,0,0,0,2020-12-29,1609196400.0
9121,28,4,2020-12-30,0,0,0,0,2020-12-30,1609282800.0
9122,28,4,2020-12-31,0,0,0,0,2020-12-31,1609369200.0
9123,28,4,2021-01-01,0,0,0,0,2021-01-01,1609455600.0
9124,28,4,2021-01-02,0,0,0,0,2021-01-02,1609542000.0
9125,28,4,2021-01-03,0,0,0,0,2021-01-03,1609628400.0
9126,28,4,2021-01-04,0,0,0,0,2021-01-04,1609714800.0
9127,28,4,2021-01-05,0,0,0,0,2021-01-05,1609801200.0
9128,28,4,2021-01-06,0,0,0,0,2021-01-06,1609887600.0
9129,28,4,2021-01-07,0,0,0,0,2021-01-07,1609974000.0
9130,28,4,2021-01-08,0,0,0,0,2021-01-08,1610060400.0
9131,28,4,2021-01-09,0,0,0,0,2021-01-09,1610146800.0
9132,28,4,2021-01-10,0,0,0,0,2021-01-10,1610233200.0
9133,28,4,2021-01-11,0,0,0,0,2021-01-11,1610319600.0
9134,28,4,2021-01-12,0,0,0,0,2021-01-12,1610406000.0
9135,28,4,2021-01-13,0,0,0,0,2021-01-13,1610492400.0
9136,28,4,2021-01-14,0,0,0,0,2021-01-14,1610578800.0
9137,28,4,2021-01-15,0,0,0,0,2021-01-15,1610665200.0
9138,28,4,2021-01-16,0,0,0,0,2021-01-16,1610751600.0
9139,28,4,2021-01-17,0,0,0,0,2021-01-17,1610838000.0
9140,28,4,2021-01-18,0,0,0,0,2021-01-18,1610924400.0
9141,28,4,2021-01-19,0,0,0,0,2021-01-19,1611010800.0
9142,28,4,2021-01-20,0,0,0,0,2021-01-20,1611097200.0
9143,28,4,2021-01-21,0,0,0,0,2021-01-21,1611183600.0
9144,28,4,2021-01-22,0,0,0,0,2021-01-22,1611270000.0
9145,28,4,2021-01-23,0,0,0,0,2021-01-23,1611356400.0
9146,28,4,2021-01-24,0,0,0,0,2021-01-24,1611442800.0
9147,28,4,2021-01-25,0,0,0,0,2021-01-25,1611529200.0
9148,28,4,2021-01-26,0,0,0,0,2021-01-26,1611615600.0
9149,28,4,2021-01-27,0,0,0,0,2021-01-27,1611702000.0
9150,28,4,2021-01-28,0,0,0,0,2021-01-28,1611788400.0
9151,28,4,2021-01-29,0,0,0,0,2021-01-29,1611874800.0
9152,28,4,2021-01-30,0,0,0,0,2021-01-30,1611961200.0
9153,28,4,2021-01-31,0,0,0,0,2021-01-31,1612047600.0
9154,28,4,2021-02-01,0,0,0,0,2021-02-01,1612134000.0
9155,28,4,2021-02-02,0,0,0,0,2021-02-02,1612220400.0
9156,28,4,2021-02-03,0,0,0,0,2021-02-03,1612306800.0
9157,28,4,2021-02-04,0,0,0,0,2021-02-04,1612393200.0
9158,28,4,2021-02-05,0,0,0,0,2021-02-05,1612479600.0
9159,28,4,2021-02-06,0,0,0,0,2021-02-06,1612566000.0
9160,28,4,2021-02-07,0,0,0,0,2021-02-07,1612652400.0
9161,28,4,2021-02-08,0,0,0,0,2021-02-08,1612738800.0
9162,28,4,2021-02-09,0,0,0,0,2021-02-09,1612825200.0
9163,28,4,2021-02-10,0,0,0,0,2021-02-10,1612911600.0
9164,28,4,2021-02-11,0,0,0,0,2021-02-11,1612998000.0
9165,28,4,2021-02-12,0,0,0,0,2021-02-12,1613084400.0
9166,28,4,2021-02-13,0,0,0,0,2021-02-13,1613170800.0
9167,28,4,2021-02-14,0,0,0,0,2021-02-14,1613257200.0
9168,28,4,2021-02-15,0,0,0,0,2021-02-15,1613343600.0
9169,28,4,2021-02-16,0,0,0,0,2021-02-16,1613430000.0
9170,28,4,2021-02-17,0,0,0,0,2021-02-17,1613516400.0
9171,28,4,2021-02-18,0,0,0,0,2021-02-18,1613602800.0
9172,28,4,2021-02-19,0,0,0,0,2021-02-19,1613689200.0
9173,28,4,2021-02-20,0,0,0,0,2021-02-20,1613775600.0
9174,28,4,2021-02-21,0,0,0,0,2021-02-21,1613862000.0
9175,28,4,2021-02-22,0,0,0,0,2021-02-22,1613948400.0
9176,28,4,2021-02-23,0,0,0,0,2021-02-23,1614034800.0
9177,28,4,2021-02-24,0,0,0,0,2021-02-24,1614121200.0
9178,28,4,2021-02-25,0,0,0,0,2021-02-25,1614207600.0
9179,28,4,2021-02-26,0,0,0,0,2021-02-26,1614294000.0
9180,28,4,2021-02-27,0,0,0,0,2021-02-27,1614380400.0
9181,28,4,2021-02-28,0,0,0,0,2021-02-28,1614466800.0
9182,28,4,2021-03-01,0,0,0,0,2021-03-01,1614553200.0
9183,28,4,2021-03-02,0,0,0,0,2021-03-02,1614639600.0
9184,28,4,2021-03-03,0,0,0,0,2021-03-03,1614726000.0
9185,28,4,2021-03-04,0,0,0,0,2021-03-04,1614812400.0
9186,28,4,2021-03-05,0,0,0,0,2021-03-05,1614898800.0
9187,28,4,2021-03-06,0,0,0,0,2021-03-06,1614985200.0
9188,28,4,2021-03-07,0,0,0,0,2021-03-07,1615071600.0
9189,28,4,2021-03-08,0,0,0,0,2021-03-08,1615158000.0
9190,28,4,2021-03-09,0,0,0,0,2021-03-09,1615244400.0
9191,28,4,2021-03-10,0,0,0,0,2021-03-10,1615330800.0
9192,28,4,2021-03-11,0,0,0,0,2021-03-11,1615417200.0
9193,28,4,2021-03-12,0,0,0,0,2021-03-12,1615503600.0
9194,28,4,2021-03-13,0,0,0,0,2021-03-13,1615590000.0
9195,28,4,2021-03-14,0,0,0,0,2021-03-14,1615676400.0
9196,28,4,2021-03-15,0,0,0,0,2021-03-15,1615762800.0
9197,28,4,2021-03-16,0,0,0,0,2021-03-16,1615849200.0
9198,28,4,2021-03-17,0,0,0,0,2021-03-17,1615935600.0
9199,28,4,2021-03-18,0,0,0,0,2021-03-18,1616022000.0
9200,28,4,2021-03-19,0,0,0,0,2021-03-19,1616108400.0
9201,28,4,2021-03-20,0,0,0,0,2021-03-20,1616194800.0
9202,28,4,2021-03-21,0,0,0,0,2021-03-21,1616281200.0
9203,28,4,2021-03-22,0,0,0,0,2021-03-22,1616367600.0
9204,28,4,2021-03-23,0,0,0,0,2021-03-23,1616454000.0
9205,28,4,2021-03-24,0,0,0,0,2021-03-24,1616540400.0
9206,28,4,2021-03-25,0,0,0,0,2021-03-25,1616626800.0
9207,28,4,2021-03-26,0,0,0,0,2021-03-26,1616713200.0
9208,28,4,2021-03-27,0,0,0,0,2021-03-27,1616799600.0
9209,28,4,2021-03-28,0,0,0,0,2021-03-28,1616886000.0
9210,28,4,2021-03-29,0,0,0,0,2021-03-29,1616972400.0
9211,28,4,2021-03-30,0,0,0,0,2021-03-30,1617058800.0
9212,28,4,2021-03-31,0,0,0,0,2021-03-31,1617145200.0
9213,28,4,2021-04-01,0,0,0,0,2021-04-01,1617231600.0
9214,28,4,2021-04-02,0,0,0,0,2021-04-02,1617318000.0
9215,28,4,2021-04-03,0,0,0,0,2021-04-03,1617404400.0
9216,28,4,2021-04-04,0,0,0,0,2021-04-04,1617490800.0
9217,28,4,2021-04-05,0,0,0,0,2021-04-05,1617577200.0
9218,28,4,2021-04-06,0,0,0,0,2021-04-06,1617663600.0
9219,28,4,2021-04-07,0,0,0,0,2021-04-07,1617750000.0
9220,28,4,2021-04-08,0,0,0,0,2021-04-08,1617836400.0
9221,28,4,2021-04-09,0,0,0,0,2021-04-09,1617922800.0
9222,28,4,2021-04-10,0,0,0,0,2021-04-10,1618009200.0
9223,28,4,2021-04-11,0,0,0,0,2021-04-11,1618095600.0
9224,28,4,2021-04-12,0,0,0,0,2021-04-12,1618185600.0
9225,28,4,2021-04-13,0,0,0,0,2021-04-13,1618272000.0
9226,28,4,2021-04-14,0,0,0,0,2021-04-14,1618358400.0
9227,28,4,2021-04-15,0,0,0,0,2021-04-15,1618444800.0
9228,28,4,2021-04-16,0,0,0,0,2021-04-16,1618531200.0
9229,28,4,2021-04-17,0,0,0,0,2021-04-17,1618617600.0
9230,28,4,2021-04-18,0,0,0,0,2021-04-18,1618704000.0
9231,28,4,2021-04-19,0,0,0,0,2021-04-19,1618790400.0
9232,28,4,2021-04-20,0,0,0,0,2021-04-20,1618876800.0
9233,28,4,2021-04-21,0,0,0,0,2021-04-21,1618963200.0
9234,28,4,2021-04-22,0,0,0,0,2021-04-22,1619049600.0
9235,28,4,2021-04-23,31,0,31,0,2021-04-23,1619136000.0
9236,28,4,2021-04-24,104,0,135,0,2021-04-24,1619222400.0
9237,28,4,2021-04-25,6,0,141,0,2021-04-25,1619308800.0
9238,28,4,2021-04-26,241,0,382,0,2021-04-26,1619395200.0
9239,28,4,2021-04-27,676,0,1058,0,2021-04-27,1619481600.0
9240,28,4,2021-04-28,587,0,1645,0,2021-04-28,1619568000.0
9241,28,4,2021-04-29,950,1,2595,1,2021-04-29,1619654400.0
9242,28,4,2021-04-30,1285,0,3880,1,2021-04-30,1619740800.0
9243,28,4,2021-05-01,126,0,4006,1,2021-05-01,1619827200.0
9244,28,4,2021-05-02,16,0,4022,1,2021-05-02,1619913600.0
9245,28,4,2021-05-03,277,0,4299,1,2021-05-03,1620000000.0
9246,28,4,2021-05-04,607,1,4906,2,2021-05-04,1620086400.0
9247,28,4,2021-05-05,353,3,5259,5,2021-05-05,1620172800.0
9248,28,4,2021-05-06,673,0,5932,5,2021-05-06,1620259200.0
9249,28,4,2021-05-07,1297,0,7229,5,2021-05-07,1620345600.0
9250,28,4,2021-05-08,98,0,7327,5,2021-05-08,1620432000.0
9251,28,4,2021-05-09,20,1,7347,6,2021-05-09,1620518400.0
9252,28,4,2021-05-10,388,0,7735,6,2021-05-10,1620604800.0
9253,28,4,2021-05-11,801,1,8536,7,2021-05-11,1620691200.0
9254,28,4,2021-05-12,483,0,9019,7,2021-05-12,1620777600.0
9255,28,4,2021-05-13,59,0,9078,7,2021-05-13,1620864000.0
9256,28,4,2021-05-14,532,1,9610,8,2021-05-14,1620950400.0
9257,28,4,2021-05-15,208,0,9818,8,2021-05-15,1621036800.0
9258,28,4,2021-05-16,24,0,9842,8,2021-05-16,1621123200.0
9259,28,4,2021-05-17,176,0,10018,8,2021-05-17,1621206000.0
9260,28,4,2021-05-18,362,0,10380,8,2021-05-18,1621292400.0
9261,28,4,2021-05-19,276,2,10656,10,2021-05-19,1621378800.0
9262,28,4,2021-05-20,562,0,11218,10,2021-05-20,1621465200.0
9263,28,4,2021-05-21,856,1,12074,11,2021-05-21,1621551600.0
9264,28,4,2021-05-22,317,0,12391,11,2021-05-22,1621638000.0
9265,28,4,2021-05-23,6,0,12397,11,2021-05-23,1621724400.0
9266,28,4,2021-05-24,59,0,12456,11,2021-05-24,1621810800.0
9267,28,4,2021-05-25,382,1,12838,12,2021-05-25,1621897200.0
9268,28,4,2021-05-26,430,0,13268,12,2021-05-26,1621983600.0
9269,28,4,2021-05-27,1007,1,14275,13,2021-05-27,1622070000.0
9270,28,4,2021-05-28,1760,2,16035,15,2021-05-28,1622156400.0
9271,28,4,2021-05-29,614,1,16649,16,2021-05-29,1622242800.0
9272,28,4,2021-05-30,52,0,16701,16,2021-05-30,1622329200.0
9273,28,4,2021-05-31,636,0,17337,16,2021-05-31,1622415600.0
9274,28,4,2021-06-01,1193,0,18530,16,2021-06-01,1622502000.0
9275,28,4,2021-06-02,756,1,19286,17,2021-06-02,1622588400.0
9276,28,4,2021-06-03,1098,1,20384,18,2021-06-03,1622674800.0
9277,28,4,2021-06-04,1568,2,21952,20,2021-06-04,1622761200.0
9278,28,4,2021-06-05,691,1,22643,21,2021-06-05,1622847600.0
9279,28,4,2021-06-06,79,0,22722,21,2021-06-06,1622934000.0
9280,28,4,2021-06-07,582,1,23304,22,2021-06-07,1623020400.0
9281,28,4,2021-06-08,945,0,24249,22,2021-06-08,1623106800.0
9282,28,4,2021-06-09,667,1,24916,23,2021-06-09,1623193200.0
9283,28,4,2021-06-10,812,0,25728,23,2021-06-10,1623279600.0
9284,28,4,2021-06-11,1067,4,26795,27,2021-06-11,1623366000.0
9285,28,4,2021-06-12,423,1,27218,28,2021-06-12,1623452400.0
9286,28,4,2021-06-13,56,0,27274,28,2021-06-13,1623538800.0
9287,28,4,2021-06-14,332,1,27606,29,2021-06-14,1623625200.0
9288,28,4,2021-06-15,648,0,28254,29,2021-06-15,1623711600.0
9289,28,4,2021-06-16,482,3,28736,32,2021-06-16,1623798000.0
9290,28,4,2021-06-17,696,3,29432,35,2021-06-17,1623884400.0
9291,28,4,2021-06-18,762,0,30194,35,2021-06-18,1623970800.0
9292,28,4,2021-06-19,293,2,30487,37,2021-06-19,1624057200.0
9293,28,4,2021-06-20,32,0,30519,37,2021-06-20,1624143600.0
9294,28,4,2021-06-21,230,0,30749,37,2021-06-21,1624230000.0
9295,28,4,2021-06-22,527,2,31276,39,2021-06-22,1624316400.0
9296,28,4,2021-06-23,366,1,31642,40,2021-06-23,1624402800.0
9297,28,4,2021-06-24,513,0,32155,40,2021-06-24,1624489200.0
9298,28,4,2021-06-25,629,2,32784,42,2021-06-25,1624575600.0
9299,28,4,2021-06-26,357,0,33141,42,2021-06-26,1624662000.0
9300,28,4,2021-06-27,32,0,33173,42,2021-06-27,1624748400.0
9301,28,4,2021-06-28,205,2,33378,44,2021-06-28,1624834800.0
9302,28,4,2021-06-29,441,1,33819,45,2021-06-29,1624921200.0
9303,28,4,2021-06-30,331,0,34150,45,2021-06-30,1625007600.0
9304,28,4,2021-07-01,426,3,34576,48,2021-07-01,1625094000.0
9305,28,4,2021-07-02,533,3,35109,51,2021-07-02,1625180400.0
9306,28,4,2021-07-03,275,0,35384,51,2021-07-03,1625266800.0
9307,28,4,2021-07-04,28,0,35412,51,2021-07-04,1625353200.0
9308,28,4,2021-07-05,205,1,35617,52,2021-07-05,1625439600.0
9309,28,4,2021-07-06,460,1,36077,53,2021-07-06,1625526000.0
9310,28,4,2021-07-07,279,1,36356,54,2021-07-07,1625612400.0
9311,28,4,2021-07-08,572,1,36928,55,2021-07-08,1625698800.0
9312,32,1,2020-12-27,1,0,1,0,2020-12-27,1609023600.0
9313,32,1,2020-12-28,27,0,28,0,2020-12-28,1609110000.0
9314,32,1,2020-12-29,12,0,40,0,2020-12-29,1609196400.0
9315,32,1,2020-12-30,0,0,40,0,2020-12-30,1609282800.0
9316,32,1,2020-12-31,0,0,40,0,2020-12-31,1609369200.0
9317,32,1,2021-01-01,1,0,41,0,2021-01-01,1609455600.0
9318,32,1,2021-01-02,6,0,47,0,2021-01-02,1609542000.0
9319,32,1,2021-01-03,4,0,51,0,2021-01-03,1609628400.0
9320,32,1,2021-01-04,82,0,133,0,2021-01-04,1609714800.0
9321,32,1,2021-01-05,300,0,433,0,2021-01-05,1609801200.0
9322,32,1,2021-01-06,788,0,1221,0,2021-01-06,1609887600.0
9323,32,1,2021-01-07,2430,0,3651,0,2021-01-07,1609974000.0
9324,32,1,2021-01-08,3167,0,6818,0,2021-01-08,1610060400.0
9325,32,1,2021-01-09,957,0,7775,0,2021-01-09,1610146800.0
9326,32,1,2021-01-10,641,0,8416,0,2021-01-10,1610233200.0
9327,32,1,2021-01-11,3269,0,11685,0,2021-01-11,1610319600.0
9328,32,1,2021-01-12,5024,0,16709,0,2021-01-12,1610406000.0
9329,32,1,2021-01-13,4944,0,21653,0,2021-01-13,1610492400.0
9330,32,1,2021-01-14,5724,0,27377,0,2021-01-14,1610578800.0
9331,32,1,2021-01-15,5228,0,32605,0,2021-01-15,1610665200.0
9332,32,1,2021-01-16,1636,8,34241,8,2021-01-16,1610751600.0
9333,32,1,2021-01-17,860,2,35101,10,2021-01-17,1610838000.0
9334,32,1,2021-01-18,7234,16,42335,26,2021-01-18,1610924400.0
9335,32,1,2021-01-19,9901,26,52236,52,2021-01-19,1611010800.0
9336,32,1,2021-01-20,10369,15,62605,67,2021-01-20,1611097200.0
9337,32,1,2021-01-21,12717,29,75322,96,2021-01-21,1611183600.0
9338,32,1,2021-01-22,9882,11,85204,107,2021-01-22,1611270000.0
9339,32,1,2021-01-23,3413,1,88617,108,2021-01-23,1611356400.0
9340,32,1,2021-01-24,1119,2,89736,110,2021-01-24,1611442800.0
9341,32,1,2021-01-25,6865,68,96601,178,2021-01-25,1611529200.0
9342,32,1,2021-01-26,7446,163,104047,341,2021-01-26,1611615600.0
9343,32,1,2021-01-27,4837,506,108884,847,2021-01-27,1611702000.0
9344,32,1,2021-01-28,8597,1668,117481,2515,2021-01-28,1611788400.0
9345,32,1,2021-01-29,5384,1835,122865,4350,2021-01-29,1611874800.0
9346,32,1,2021-01-30,534,413,123399,4763,2021-01-30,1611961200.0
9347,32,1,2021-01-31,67,74,123466,4837,2021-01-31,1612047600.0
9348,32,1,2021-02-01,193,1814,123659,6651,2021-02-01,1612134000.0
9349,32,1,2021-02-02,765,3159,124424,9810,2021-02-02,1612220400.0
9350,32,1,2021-02-03,3857,3176,128281,12986,2021-02-03,1612306800.0
9351,32,1,2021-02-04,3137,3601,131418,16587,2021-02-04,1612393200.0
9352,32,1,2021-02-05,1243,3264,132661,19851,2021-02-05,1612479600.0
9353,32,1,2021-02-06,190,873,132851,20724,2021-02-06,1612566000.0
9354,32,1,2021-02-07,159,80,133010,20804,2021-02-07,1612652400.0
9355,32,1,2021-02-08,841,3662,133851,24466,2021-02-08,1612738800.0
9356,32,1,2021-02-09,1208,4341,135059,28807,2021-02-09,1612825200.0
9357,32,1,2021-02-10,1332,5307,136391,34114,2021-02-10,1612911600.0
9358,32,1,2021-02-11,2342,6135,138733,40249,2021-02-11,1612998000.0
9359,32,1,2021-02-12,2199,4556,140932,44805,2021-02-12,1613084400.0
9360,32,1,2021-02-13,652,1890,141584,46695,2021-02-13,1613170800.0
9361,32,1,2021-02-14,95,710,141679,47405,2021-02-14,1613257200.0
9362,32,1,2021-02-15,2276,6869,143955,54274,2021-02-15,1613343600.0
9363,32,1,2021-02-16,2802,8191,146757,62465,2021-02-16,1613430000.0
9364,32,1,2021-02-17,3107,8621,149864,71086,2021-02-17,1613516400.0
9365,32,1,2021-02-18,5031,11288,154895,82374,2021-02-18,1613602800.0
9366,32,1,2021-02-19,5526,8179,160421,90553,2021-02-19,1613689200.0
9367,32,1,2021-02-20,1995,2982,162416,93535,2021-02-20,1613775600.0
9368,32,1,2021-02-21,203,484,162619,94019,2021-02-21,1613862000.0
9369,32,1,2021-02-22,2441,5292,165060,99311,2021-02-22,1613948400.0
9370,32,1,2021-02-23,3943,5852,169003,105163,2021-02-23,1614034800.0
9371,32,1,2021-02-24,5576,5974,174579,111137,2021-02-24,1614121200.0
9372,32,1,2021-02-25,6442,4836,181021,115973,2021-02-25,1614207600.0
9373,32,1,2021-02-26,5938,2673,186959,118646,2021-02-26,1614294000.0
9374,32,1,2021-02-27,1461,199,188420,118845,2021-02-27,1614380400.0
9375,32,1,2021-02-28,90,131,188510,118976,2021-02-28,1614466800.0
9376,32,1,2021-03-01,5582,766,194092,119742,2021-03-01,1614553200.0
9377,32,1,2021-03-02,7217,739,201309,120481,2021-03-02,1614639600.0
9378,32,1,2021-03-03,7088,1309,208397,121790,2021-03-03,1614726000.0
9379,32,1,2021-03-04,6788,1708,215185,123498,2021-03-04,1614812400.0
9380,32,1,2021-03-05,7327,1285,222512,124783,2021-03-05,1614898800.0
9381,32,1,2021-03-06,15209,467,237721,125250,2021-03-06,1614985200.0
9382,32,1,2021-03-07,14532,269,252253,125519,2021-03-07,1615071600.0
9383,32,1,2021-03-08,6059,1538,258312,127057,2021-03-08,1615158000.0
9384,32,1,2021-03-09,7600,1977,265912,129034,2021-03-09,1615244400.0
9385,32,1,2021-03-10,8302,1666,274214,130700,2021-03-10,1615330800.0
9386,32,1,2021-03-11,8925,3160,283139,133860,2021-03-11,1615417200.0
9387,32,1,2021-03-12,8395,2617,291534,136477,2021-03-12,1615503600.0
9388,32,1,2021-03-13,22224,1269,313758,137746,2021-03-13,1615590000.0
9389,32,1,2021-03-14,18045,317,331803,138063,2021-03-14,1615676400.0
9390,32,1,2021-03-15,6928,2897,338731,140960,2021-03-15,1615762800.0
9391,32,1,2021-03-16,9535,3076,348266,144036,2021-03-16,1615849200.0
9392,32,1,2021-03-17,9450,3733,357716,147769,2021-03-17,1615935600.0
9393,32,1,2021-03-18,9530,4283,367246,152052,2021-03-18,1616022000.0
9394,32,1,2021-03-19,9776,3250,377022,155302,2021-03-19,1616108400.0
9395,32,1,2021-03-20,14496,1200,391518,156502,2021-03-20,1616194800.0
9396,32,1,2021-03-21,9465,296,400983,156798,2021-03-21,1616281200.0
9397,32,1,2021-03-22,7407,3667,408390,160465,2021-03-22,1616367600.0
9398,32,1,2021-03-23,8833,4982,417223,165447,2021-03-23,1616454000.0
9399,32,1,2021-03-24,8242,5214,425465,170661,2021-03-24,1616540400.0
9400,32,1,2021-03-25,10125,4519,435590,175180,2021-03-25,1616626800.0
9401,32,1,2021-03-26,11617,4735,447207,179915,2021-03-26,1616713200.0
9402,32,1,2021-03-27,25587,1142,472794,181057,2021-03-27,1616799600.0
9403,32,1,2021-03-28,14004,132,486798,181189,2021-03-28,1616886000.0
9404,32,1,2021-03-29,9273,6310,496071,187499,2021-03-29,1616972400.0
9405,32,1,2021-03-30,10785,7704,506856,195203,2021-03-30,1617058800.0
9406,32,1,2021-03-31,9328,8267,516184,203470,2021-03-31,1617145200.0
9407,32,1,2021-04-01,10381,9796,526565,213266,2021-04-01,1617231600.0
9408,32,1,2021-04-02,9535,11552,536100,224818,2021-04-02,1617318000.0
9409,32,1,2021-04-03,22897,9107,558997,233925,2021-04-03,1617404400.0
9410,32,1,2021-04-04,9675,4288,568672,238213,2021-04-04,1617490800.0
9411,32,1,2021-04-05,7360,1904,576032,240117,2021-04-05,1617577200.0
9412,32,1,2021-04-06,10103,10176,586135,250293,2021-04-06,1617663600.0
9413,32,1,2021-04-07,13389,11504,599524,261797,2021-04-07,1617750000.0
9414,32,1,2021-04-08,15137,11254,614661,273051,2021-04-08,1617836400.0
9415,32,1,2021-04-09,11578,11571,626239,284622,2021-04-09,1617922800.0
9416,32,1,2021-04-10,11340,17430,637579,302052,2021-04-10,1618009200.0
9417,32,1,2021-04-11,5903,11358,643482,313410,2021-04-11,1618095600.0
9418,32,1,2021-04-12,9001,8357,652483,321767,2021-04-12,1618185600.0
9419,32,1,2021-04-13,11505,10468,663988,332235,2021-04-13,1618272000.0
9420,32,1,2021-04-14,14003,9983,677991,342218,2021-04-14,1618358400.0
9421,32,1,2021-04-15,14869,9519,692860,351737,2021-04-15,1618444800.0
9422,32,1,2021-04-16,11653,10525,704513,362262,2021-04-16,1618531200.0
9423,32,1,2021-04-17,7073,11513,711586,373775,2021-04-17,1618617600.0
9424,32,1,2021-04-18,3748,6138,715334,379913,2021-04-18,1618704000.0
9425,32,1,2021-04-19,8719,8189,724053,388102,2021-04-19,1618790400.0
9426,32,1,2021-04-20,11611,9687,735664,397789,2021-04-20,1618876800.0
9427,32,1,2021-04-21,11441,9958,747105,407747,2021-04-21,1618963200.0
9428,32,1,2021-04-22,12219,12109,759324,419856,2021-04-22,1619049600.0
9429,32,1,2021-04-23,10436,12863,769760,432719,2021-04-23,1619136000.0
9430,32,1,2021-04-24,8535,18574,778295,451293,2021-04-24,1619222400.0
9431,32,1,2021-04-25,5328,9042,783623,460335,2021-04-25,1619308800.0
9432,32,1,2021-04-26,10286,8610,793909,468945,2021-04-26,1619395200.0
9433,32,1,2021-04-27,13769,11262,807678,480207,2021-04-27,1619481600.0
9434,32,1,2021-04-28,15318,12095,822996,492302,2021-04-28,1619568000.0
9435,32,1,2021-04-29,15912,15314,838908,507616,2021-04-29,1619654400.0
9436,32,1,2021-04-30,16528,15620,855436,523236,2021-04-30,1619740800.0
9437,32,1,2021-05-01,20879,11580,876315,534816,2021-05-01,1619827200.0
9438,32,1,2021-05-02,20151,8280,896466,543096,2021-05-02,1619913600.0
9439,32,1,2021-05-03,19805,8607,916271,551703,2021-05-03,1620000000.0
9440,32,1,2021-05-04,20932,12196,937203,563899,2021-05-04,1620086400.0
9441,32,1,2021-05-05,21526,12720,958729,576619,2021-05-05,1620172800.0
9442,32,1,2021-05-06,21178,12892,979907,589511,2021-05-06,1620259200.0
9443,32,1,2021-05-07,24464,13100,1004371,602611,2021-05-07,1620345600.0
9444,32,1,2021-05-08,33190,4961,1037561,607572,2021-05-08,1620432000.0
9445,32,1,2021-05-09,25795,3879,1063356,611451,2021-05-09,1620518400.0
9446,32,1,2021-05-10,21630,11316,1084986,622767,2021-05-10,1620604800.0
9447,32,1,2021-05-11,27227,12707,1112213,635474,2021-05-11,1620691200.0
9448,32,1,2021-05-12,32985,10832,1145198,646306,2021-05-12,1620777600.0
9449,32,1,2021-05-13,34995,4102,1180193,650408,2021-05-13,1620864000.0
9450,32,1,2021-05-14,34550,7417,1214743,657825,2021-05-14,1620950400.0
9451,32,1,2021-05-15,50034,3512,1264777,661337,2021-05-15,1621036800.0
9452,32,1,2021-05-16,37586,1131,1302363,662468,2021-05-16,1621123200.0
9453,32,1,2021-05-17,27405,5890,1329768,668358,2021-05-17,1621206000.0
9454,32,1,2021-05-18,31899,5595,1361667,673953,2021-05-18,1621292400.0
9455,32,1,2021-05-19,33885,4514,1395552,678467,2021-05-19,1621378800.0
9456,32,1,2021-05-20,34241,4771,1429793,683238,2021-05-20,1621465200.0
9457,32,1,2021-05-21,35630,4799,1465423,688037,2021-05-21,1621551600.0
9458,32,1,2021-05-22,47678,3085,1513101,691122,2021-05-22,1621638000.0
9459,32,1,2021-05-23,30048,1058,1543149,692180,2021-05-23,1621724400.0
9460,32,1,2021-05-24,26109,955,1569258,693135,2021-05-24,1621810800.0
9461,32,1,2021-05-25,28044,7496,1597302,700631,2021-05-25,1621897200.0
9462,32,1,2021-05-26,32094,7630,1629396,708261,2021-05-26,1621983600.0
9463,32,1,2021-05-27,30929,7732,1660325,715993,2021-05-27,1622070000.0
9464,32,1,2021-05-28,28483,9032,1688808,725025,2021-05-28,1622156400.0
9465,32,1,2021-05-29,32633,6818,1721441,731843,2021-05-29,1622242800.0
9466,32,1,2021-05-30,15162,1433,1736603,733276,2021-05-30,1622329200.0
9467,32,1,2021-05-31,23305,9287,1759908,742563,2021-05-31,1622415600.0
9468,32,1,2021-06-01,26147,11736,1786055,754299,2021-06-01,1622502000.0
9469,32,1,2021-06-02,27502,11136,1813557,765435,2021-06-02,1622588400.0
9470,32,1,2021-06-03,28143,10912,1841700,776347,2021-06-03,1622674800.0
9471,32,1,2021-06-04,27638,12013,1869338,788360,2021-06-04,1622761200.0
9472,32,1,2021-06-05,29046,10446,1898384,798806,2021-06-05,1622847600.0
9473,32,1,2021-06-06,15878,3357,1914262,802163,2021-06-06,1622934000.0
9474,32,1,2021-06-07,17965,12650,1932227,814813,2021-06-07,1623020400.0
9475,32,1,2021-06-08,20941,15027,1953168,829840,2021-06-08,1623106800.0
9476,32,1,2021-06-09,19923,16187,1973091,846027,2021-06-09,1623193200.0
9477,32,1,2021-06-10,19408,15510,1992499,861537,2021-06-10,1623279600.0
9478,32,1,2021-06-11,18946,20769,2011445,882306,2021-06-11,1623366000.0
9479,32,1,2021-06-12,21067,20995,2032512,903301,2021-06-12,1623452400.0
9480,32,1,2021-06-13,11293,12559,2043805,915860,2021-06-13,1623538800.0
9481,32,1,2021-06-14,10627,20521,2054432,936381,2021-06-14,1623625200.0
9482,32,1,2021-06-15,15458,23797,2069890,960178,2021-06-15,1623711600.0
9483,32,1,2021-06-16,17069,22585,2086959,982763,2021-06-16,1623798000.0
9484,32,1,2021-06-17,17218,21155,2104177,1003918,2021-06-17,1623884400.0
9485,32,1,2021-06-18,16060,25946,2120237,1029864,2021-06-18,1623970800.0
9486,32,1,2021-06-19,18108,33232,2138345,1063096,2021-06-19,1624057200.0
9487,32,1,2021-06-20,8950,16812,2147295,1079908,2021-06-20,1624143600.0
9488,32,1,2021-06-21,9342,28027,2156637,1107935,2021-06-21,1624230000.0
9489,32,1,2021-06-22,10242,31553,2166879,1139488,2021-06-22,1624316400.0
9490,32,1,2021-06-23,11660,33882,2178539,1173370,2021-06-23,1624402800.0
9491,32,1,2021-06-24,11736,30278,2190275,1203648,2021-06-24,1624489200.0
9492,32,1,2021-06-25,10429,34182,2200704,1237830,2021-06-25,1624575600.0
9493,32,1,2021-06-26,11850,42457,2212554,1280287,2021-06-26,1624662000.0
9494,32,1,2021-06-27,7085,24896,2219639,1305183,2021-06-27,1624748400.0
9495,32,1,2021-06-28,8649,30792,2228288,1335975,2021-06-28,1624834800.0
9496,32,1,2021-06-29,10767,33092,2239055,1369067,2021-06-29,1624921200.0
9497,32,1,2021-06-30,12426,32759,2251481,1401826,2021-06-30,1625007600.0
9498,32,1,2021-07-01,12534,31131,2264015,1432957,2021-07-01,1625094000.0
9499,32,1,2021-07-02,12800,32262,2276815,1465219,2021-07-02,1625180400.0
9500,32,1,2021-07-03,10670,42323,2287485,1507542,2021-07-03,1625266800.0
9501,32,1,2021-07-04,7474,23228,2294959,1530770,2021-07-04,1625353200.0
9502,32,1,2021-07-05,9853,26408,2304812,1557178,2021-07-05,1625439600.0
9503,32,1,2021-07-06,13091,29277,2317903,1586455,2021-07-06,1625526000.0
9504,32,1,2021-07-07,13786,29955,2331689,1616410,2021-07-07,1625612400.0
9505,32,1,2021-07-08,16378,26504,2348067,1642914,2021-07-08,1625698800.0
9506,32,2,2020-12-27,0,0,0,0,2020-12-27,1609023600.0
9507,32,2,2020-12-28,0,0,0,0,2020-12-28,1609110000.0
9508,32,2,2020-12-29,0,0,0,0,2020-12-29,1609196400.0
9509,32,2,2020-12-30,0,0,0,0,2020-12-30,1609282800.0
9510,32,2,2020-12-31,0,0,0,0,2020-12-31,1609369200.0
9511,32,2,2021-01-01,0,0,0,0,2021-01-01,1609455600.0
9512,32,2,2021-01-02,0,0,0,0,2021-01-02,1609542000.0
9513,32,2,2021-01-03,0,0,0,0,2021-01-03,1609628400.0
9514,32,2,2021-01-04,0,0,0,0,2021-01-04,1609714800.0
9515,32,2,2021-01-05,0,0,0,0,2021-01-05,1609801200.0
9516,32,2,2021-01-06,0,0,0,0,2021-01-06,1609887600.0
9517,32,2,2021-01-07,0,0,0,0,2021-01-07,1609974000.0
9518,32,2,2021-01-08,0,0,0,0,2021-01-08,1610060400.0
9519,32,2,2021-01-09,0,0,0,0,2021-01-09,1610146800.0
9520,32,2,2021-01-10,0,0,0,0,2021-01-10,1610233200.0
9521,32,2,2021-01-11,0,0,0,0,2021-01-11,1610319600.0
9522,32,2,2021-01-12,0,0,0,0,2021-01-12,1610406000.0
9523,32,2,2021-01-13,0,0,0,0,2021-01-13,1610492400.0
9524,32,2,2021-01-14,0,0,0,0,2021-01-14,1610578800.0
9525,32,2,2021-01-15,0,0,0,0,2021-01-15,1610665200.0
9526,32,2,2021-01-16,1,0,1,0,2021-01-16,1610751600.0
9527,32,2,2021-01-17,0,0,1,0,2021-01-17,1610838000.0
9528,32,2,2021-01-18,0,0,1,0,2021-01-18,1610924400.0
9529,32,2,2021-01-19,1,0,2,0,2021-01-19,1611010800.0
9530,32,2,2021-01-20,1,0,3,0,2021-01-20,1611097200.0
9531,32,2,2021-01-21,2,0,5,0,2021-01-21,1611183600.0
9532,32,2,2021-01-22,2,0,7,0,2021-01-22,1611270000.0
9533,32,2,2021-01-23,0,0,7,0,2021-01-23,1611356400.0
9534,32,2,2021-01-24,0,0,7,0,2021-01-24,1611442800.0
9535,32,2,2021-01-25,2,0,9,0,2021-01-25,1611529200.0
9536,32,2,2021-01-26,1,0,10,0,2021-01-26,1611615600.0
9537,32,2,2021-01-27,0,0,10,0,2021-01-27,1611702000.0
9538,32,2,2021-01-28,1,0,11,0,2021-01-28,1611788400.0
9539,32,2,2021-01-29,1,0,12,0,2021-01-29,1611874800.0
9540,32,2,2021-01-30,0,0,12,0,2021-01-30,1611961200.0
9541,32,2,2021-01-31,0,0,12,0,2021-01-31,1612047600.0
9542,32,2,2021-02-01,0,0,12,0,2021-02-01,1612134000.0
9543,32,2,2021-02-02,22,0,34,0,2021-02-02,1612220400.0
9544,32,2,2021-02-03,220,0,254,0,2021-02-03,1612306800.0
9545,32,2,2021-02-04,550,0,804,0,2021-02-04,1612393200.0
9546,32,2,2021-02-05,719,0,1523,0,2021-02-05,1612479600.0
9547,32,2,2021-02-06,275,0,1798,0,2021-02-06,1612566000.0
9548,32,2,2021-02-07,26,0,1824,0,2021-02-07,1612652400.0
9549,32,2,2021-02-08,866,2,2690,2,2021-02-08,1612738800.0
9550,32,2,2021-02-09,1060,2,3750,4,2021-02-09,1612825200.0
9551,32,2,2021-02-10,1046,0,4796,4,2021-02-10,1612911600.0
9552,32,2,2021-02-11,1248,0,6044,4,2021-02-11,1612998000.0
9553,32,2,2021-02-12,1344,1,7388,5,2021-02-12,1613084400.0
9554,32,2,2021-02-13,214,1,7602,6,2021-02-13,1613170800.0
9555,32,2,2021-02-14,21,0,7623,6,2021-02-14,1613257200.0
9556,32,2,2021-02-15,405,2,8028,8,2021-02-15,1613343600.0
9557,32,2,2021-02-16,304,0,8332,8,2021-02-16,1613430000.0
9558,32,2,2021-02-17,163,2,8495,10,2021-02-17,1613516400.0
9559,32,2,2021-02-18,363,1,8858,11,2021-02-18,1613602800.0
9560,32,2,2021-02-19,183,1,9041,12,2021-02-19,1613689200.0
9561,32,2,2021-02-20,40,0,9081,12,2021-02-20,1613775600.0
9562,32,2,2021-02-21,0,0,9081,12,2021-02-21,1613862000.0
9563,32,2,2021-02-22,280,0,9361,12,2021-02-22,1613948400.0
9564,32,2,2021-02-23,486,2,9847,14,2021-02-23,1614034800.0
9565,32,2,2021-02-24,437,1,10284,15,2021-02-24,1614121200.0
9566,32,2,2021-02-25,489,0,10773,15,2021-02-25,1614207600.0
9567,32,2,2021-02-26,342,0,11115,15,2021-02-26,1614294000.0
9568,32,2,2021-02-27,33,0,11148,15,2021-02-27,1614380400.0
9569,32,2,2021-02-28,0,0,11148,15,2021-02-28,1614466800.0
9570,32,2,2021-03-01,317,21,11465,36,2021-03-01,1614553200.0
9571,32,2,2021-03-02,422,98,11887,134,2021-03-02,1614639600.0
9572,32,2,2021-03-03,469,239,12356,373,2021-03-03,1614726000.0
9573,32,2,2021-03-04,560,474,12916,847,2021-03-04,1614812400.0
9574,32,2,2021-03-05,383,514,13299,1361,2021-03-05,1614898800.0
9575,32,2,2021-03-06,128,246,13427,1607,2021-03-06,1614985200.0
9576,32,2,2021-03-07,50,0,13477,1607,2021-03-07,1615071600.0
9577,32,2,2021-03-08,222,888,13699,2495,2021-03-08,1615158000.0
9578,32,2,2021-03-09,106,1081,13805,3576,2021-03-09,1615244400.0
9579,32,2,2021-03-10,194,1271,13999,4847,2021-03-10,1615330800.0
9580,32,2,2021-03-11,641,1117,14640,5964,2021-03-11,1615417200.0
9581,32,2,2021-03-12,371,1052,15011,7016,2021-03-12,1615503600.0
9582,32,2,2021-03-13,303,203,15314,7219,2021-03-13,1615590000.0
9583,32,2,2021-03-14,278,10,15592,7229,2021-03-14,1615676400.0
9584,32,2,2021-03-15,610,359,16202,7588,2021-03-15,1615762800.0
9585,32,2,2021-03-16,208,237,16410,7825,2021-03-16,1615849200.0
9586,32,2,2021-03-17,223,186,16633,8011,2021-03-17,1615935600.0
9587,32,2,2021-03-18,414,489,17047,8500,2021-03-18,1616022000.0
9588,32,2,2021-03-19,720,185,17767,8685,2021-03-19,1616108400.0
9589,32,2,2021-03-20,12433,62,30200,8747,2021-03-20,1616194800.0
9590,32,2,2021-03-21,9690,33,39890,8780,2021-03-21,1616281200.0
9591,32,2,2021-03-22,1562,304,41452,9084,2021-03-22,1616367600.0
9592,32,2,2021-03-23,1368,458,42820,9542,2021-03-23,1616454000.0
9593,32,2,2021-03-24,1411,427,44231,9969,2021-03-24,1616540400.0
9594,32,2,2021-03-25,1045,495,45276,10464,2021-03-25,1616626800.0
9595,32,2,2021-03-26,1321,336,46597,10800,2021-03-26,1616713200.0
9596,32,2,2021-03-27,1420,36,48017,10836,2021-03-27,1616799600.0
9597,32,2,2021-03-28,3081,3,51098,10839,2021-03-28,1616886000.0
9598,32,2,2021-03-29,990,292,52088,11131,2021-03-29,1616972400.0
9599,32,2,2021-03-30,445,398,52533,11529,2021-03-30,1617058800.0
9600,32,2,2021-03-31,1228,457,53761,11986,2021-03-31,1617145200.0
9601,32,2,2021-04-01,1020,539,54781,12525,2021-04-01,1617231600.0
9602,32,2,2021-04-02,1447,366,56228,12891,2021-04-02,1617318000.0
9603,32,2,2021-04-03,266,43,56494,12934,2021-04-03,1617404400.0
9604,32,2,2021-04-04,601,45,57095,12979,2021-04-04,1617490800.0
9605,32,2,2021-04-05,72,106,57167,13085,2021-04-05,1617577200.0
9606,32,2,2021-04-06,1251,130,58418,13215,2021-04-06,1617663600.0
9607,32,2,2021-04-07,1707,132,60125,13347,2021-04-07,1617750000.0
9608,32,2,2021-04-08,1782,538,61907,13885,2021-04-08,1617836400.0
9609,32,2,2021-04-09,1836,301,63743,14186,2021-04-09,1617922800.0
9610,32,2,2021-04-10,856,326,64599,14512,2021-04-10,1618009200.0
9611,32,2,2021-04-11,565,250,65164,14762,2021-04-11,1618095600.0
9612,32,2,2021-04-12,1019,511,66183,15273,2021-04-12,1618185600.0
9613,32,2,2021-04-13,1216,173,67399,15446,2021-04-13,1618272000.0
9614,32,2,2021-04-14,1231,205,68630,15651,2021-04-14,1618358400.0
9615,32,2,2021-04-15,1385,382,70015,16033,2021-04-15,1618444800.0
9616,32,2,2021-04-16,1182,759,71197,16792,2021-04-16,1618531200.0
9617,32,2,2021-04-17,1394,10587,72591,27379,2021-04-17,1618617600.0
9618,32,2,2021-04-18,962,7536,73553,34915,2021-04-18,1618704000.0
9619,32,2,2021-04-19,404,997,73957,35912,2021-04-19,1618790400.0
9620,32,2,2021-04-20,625,1870,74582,37782,2021-04-20,1618876800.0
9621,32,2,2021-04-21,613,1772,75195,39554,2021-04-21,1618963200.0
9622,32,2,2021-04-22,1215,1729,76410,41283,2021-04-22,1619049600.0
9623,32,2,2021-04-23,984,1975,77394,43258,2021-04-23,1619136000.0
9624,32,2,2021-04-24,534,1356,77928,44614,2021-04-24,1619222400.0
9625,32,2,2021-04-25,148,2791,78076,47405,2021-04-25,1619308800.0
9626,32,2,2021-04-26,460,970,78536,48375,2021-04-26,1619395200.0
9627,32,2,2021-04-27,711,512,79247,48887,2021-04-27,1619481600.0
9628,32,2,2021-04-28,632,1247,79879,50134,2021-04-28,1619568000.0
9629,32,2,2021-04-29,617,863,80496,50997,2021-04-29,1619654400.0
9630,32,2,2021-04-30,920,1251,81416,52248,2021-04-30,1619740800.0
9631,32,2,2021-05-01,108,316,81524,52564,2021-05-01,1619827200.0
9632,32,2,2021-05-02,88,718,81612,53282,2021-05-02,1619913600.0
9633,32,2,2021-05-03,431,595,82043,53877,2021-05-03,1620000000.0
9634,32,2,2021-05-04,347,1196,82390,55073,2021-05-04,1620086400.0
9635,32,2,2021-05-05,391,1729,82781,56802,2021-05-05,1620172800.0
9636,32,2,2021-05-06,389,2066,83170,58868,2021-05-06,1620259200.0
9637,32,2,2021-05-07,333,1882,83503,60750,2021-05-07,1620345600.0
9638,32,2,2021-05-08,151,324,83654,61074,2021-05-08,1620432000.0
9639,32,2,2021-05-09,748,133,84402,61207,2021-05-09,1620518400.0
9640,32,2,2021-05-10,421,1548,84823,62755,2021-05-10,1620604800.0
9641,32,2,2021-05-11,588,947,85411,63702,2021-05-11,1620691200.0
9642,32,2,2021-05-12,1593,1716,87004,65418,2021-05-12,1620777600.0
9643,32,2,2021-05-13,5193,110,92197,65528,2021-05-13,1620864000.0
9644,32,2,2021-05-14,4743,777,96940,66305,2021-05-14,1620950400.0
9645,32,2,2021-05-15,7699,522,104639,66827,2021-05-15,1621036800.0
9646,32,2,2021-05-16,10091,118,114730,66945,2021-05-16,1621123200.0
9647,32,2,2021-05-17,3014,557,117744,67502,2021-05-17,1621206000.0
9648,32,2,2021-05-18,2897,411,120641,67913,2021-05-18,1621292400.0
9649,32,2,2021-05-19,3486,394,124127,68307,2021-05-19,1621378800.0
9650,32,2,2021-05-20,3371,430,127498,68737,2021-05-20,1621465200.0
9651,32,2,2021-05-21,4156,588,131654,69325,2021-05-21,1621551600.0
9652,32,2,2021-05-22,8780,124,140434,69449,2021-05-22,1621638000.0
9653,32,2,2021-05-23,8797,68,149231,69517,2021-05-23,1621724400.0
9654,32,2,2021-05-24,2244,67,151475,69584,2021-05-24,1621810800.0
9655,32,2,2021-05-25,2035,632,153510,70216,2021-05-25,1621897200.0
9656,32,2,2021-05-26,1275,943,154785,71159,2021-05-26,1621983600.0
9657,32,2,2021-05-27,1910,988,156695,72147,2021-05-27,1622070000.0
9658,32,2,2021-05-28,2511,1077,159206,73224,2021-05-28,1622156400.0
9659,32,2,2021-05-29,2960,553,162166,73777,2021-05-29,1622242800.0
9660,32,2,2021-05-30,773,53,162939,73830,2021-05-30,1622329200.0
9661,32,2,2021-05-31,3164,927,166103,74757,2021-05-31,1622415600.0
9662,32,2,2021-06-01,4636,1121,170739,75878,2021-06-01,1622502000.0
9663,32,2,2021-06-02,3173,733,173912,76611,2021-06-02,1622588400.0
9664,32,2,2021-06-03,4304,1362,178216,77973,2021-06-03,1622674800.0
9665,32,2,2021-06-04,5807,778,184023,78751,2021-06-04,1622761200.0
9666,32,2,2021-06-05,3936,696,187959,79447,2021-06-05,1622847600.0
9667,32,2,2021-06-06,529,73,188488,79520,2021-06-06,1622934000.0
9668,32,2,2021-06-07,2460,775,190948,80295,2021-06-07,1623020400.0
9669,32,2,2021-06-08,3960,1029,194908,81324,2021-06-08,1623106800.0
9670,32,2,2021-06-09,3250,704,198158,82028,2021-06-09,1623193200.0
9671,32,2,2021-06-10,4042,685,202200,82713,2021-06-10,1623279600.0
9672,32,2,2021-06-11,5552,1061,207752,83774,2021-06-11,1623366000.0
9673,32,2,2021-06-12,3923,464,211675,84238,2021-06-12,1623452400.0
9674,32,2,2021-06-13,357,196,212032,84434,2021-06-13,1623538800.0
9675,32,2,2021-06-14,1999,994,214031,85428,2021-06-14,1623625200.0
9676,32,2,2021-06-15,3241,602,217272,86030,2021-06-15,1623711600.0
9677,32,2,2021-06-16,2681,572,219953,86602,2021-06-16,1623798000.0
9678,32,2,2021-06-17,3270,818,223223,87420,2021-06-17,1623884400.0
9679,32,2,2021-06-18,4230,883,227453,88303,2021-06-18,1623970800.0
9680,32,2,2021-06-19,3667,885,231120,89188,2021-06-19,1624057200.0
9681,32,2,2021-06-20,214,557,231334,89745,2021-06-20,1624143600.0
9682,32,2,2021-06-21,1650,1154,232984,90899,2021-06-21,1624230000.0
9683,32,2,2021-06-22,2697,1247,235681,92146,2021-06-22,1624316400.0
9684,32,2,2021-06-23,2031,2084,237712,94230,2021-06-23,1624402800.0
9685,32,2,2021-06-24,2676,5080,240388,99310,2021-06-24,1624489200.0
9686,32,2,2021-06-25,3364,6431,243752,105741,2021-06-25,1624575600.0
9687,32,2,2021-06-26,2508,7912,246260,113653,2021-06-26,1624662000.0
9688,32,2,2021-06-27,270,6487,246530,120140,2021-06-27,1624748400.0
9689,32,2,2021-06-28,1306,2555,247836,122695,2021-06-28,1624834800.0
9690,32,2,2021-06-29,1836,3614,249672,126309,2021-06-29,1624921200.0
9691,32,2,2021-06-30,1846,3669,251518,129978,2021-06-30,1625007600.0
9692,32,2,2021-07-01,2333,3768,253851,133746,2021-07-01,1625094000.0
9693,32,2,2021-07-02,2556,5640,256407,139386,2021-07-02,1625180400.0
9694,32,2,2021-07-03,1841,7913,258248,147299,2021-07-03,1625266800.0
9695,32,2,2021-07-04,241,6008,258489,153307,2021-07-04,1625353200.0
9696,32,2,2021-07-05,912,2544,259401,155851,2021-07-05,1625439600.0
9697,32,2,2021-07-06,1157,2145,260558,157996,2021-07-06,1625526000.0
9698,32,2,2021-07-07,1194,2180,261752,160176,2021-07-07,1625612400.0
9699,32,2,2021-07-08,1840,3373,263592,163549,2021-07-08,1625698800.0
9700,32,3,2020-12-27,0,0,0,0,2020-12-27,1609023600.0
9701,32,3,2020-12-28,0,0,0,0,2020-12-28,1609110000.0
9702,32,3,2020-12-29,0,0,0,0,2020-12-29,1609196400.0
9703,32,3,2020-12-30,0,0,0,0,2020-12-30,1609282800.0
9704,32,3,2020-12-31,0,0,0,0,2020-12-31,1609369200.0
9705,32,3,2021-01-01,0,0,0,0,2021-01-01,1609455600.0
9706,32,3,2021-01-02,0,0,0,0,2021-01-02,1609542000.0
9707,32,3,2021-01-03,0,0,0,0,2021-01-03,1609628400.0
9708,32,3,2021-01-04,0,0,0,0,2021-01-04,1609714800.0
9709,32,3,2021-01-05,0,0,0,0,2021-01-05,1609801200.0
9710,32,3,2021-01-06,0,0,0,0,2021-01-06,1609887600.0
9711,32,3,2021-01-07,0,0,0,0,2021-01-07,1609974000.0
9712,32,3,2021-01-08,0,0,0,0,2021-01-08,1610060400.0
9713,32,3,2021-01-09,0,0,0,0,2021-01-09,1610146800.0
9714,32,3,2021-01-10,0,0,0,0,2021-01-10,1610233200.0
9715,32,3,2021-01-11,0,0,0,0,2021-01-11,1610319600.0
9716,32,3,2021-01-12,0,0,0,0,2021-01-12,1610406000.0
9717,32,3,2021-01-13,0,0,0,0,2021-01-13,1610492400.0
9718,32,3,2021-01-14,0,0,0,0,2021-01-14,1610578800.0
9719,32,3,2021-01-15,0,0,0,0,2021-01-15,1610665200.0
9720,32,3,2021-01-16,0,0,0,0,2021-01-16,1610751600.0
9721,32,3,2021-01-17,0,0,0,0,2021-01-17,1610838000.0
9722,32,3,2021-01-18,0,0,0,0,2021-01-18,1610924400.0
9723,32,3,2021-01-19,0,0,0,0,2021-01-19,1611010800.0
9724,32,3,2021-01-20,0,0,0,0,2021-01-20,1611097200.0
9725,32,3,2021-01-21,0,0,0,0,2021-01-21,1611183600.0
9726,32,3,2021-01-22,0,0,0,0,2021-01-22,1611270000.0
9727,32,3,2021-01-23,0,0,0,0,2021-01-23,1611356400.0
9728,32,3,2021-01-24,0,0,0,0,2021-01-24,1611442800.0
9729,32,3,2021-01-25,0,0,0,0,2021-01-25,1611529200.0
9730,32,3,2021-01-26,0,0,0,0,2021-01-26,1611615600.0
9731,32,3,2021-01-27,0,0,0,0,2021-01-27,1611702000.0
9732,32,3,2021-01-28,0,0,0,0,2021-01-28,1611788400.0
9733,32,3,2021-01-29,0,0,0,0,2021-01-29,1611874800.0
9734,32,3,2021-01-30,0,0,0,0,2021-01-30,1611961200.0
9735,32,3,2021-01-31,0,0,0,0,2021-01-31,1612047600.0
9736,32,3,2021-02-01,0,0,0,0,2021-02-01,1612134000.0
9737,32,3,2021-02-02,0,0,0,0,2021-02-02,1612220400.0
9738,32,3,2021-02-03,0,0,0,0,2021-02-03,1612306800.0
9739,32,3,2021-02-04,0,0,0,0,2021-02-04,1612393200.0
9740,32,3,2021-02-05,0,0,0,0,2021-02-05,1612479600.0
9741,32,3,2021-02-06,52,0,52,0,2021-02-06,1612566000.0
9742,32,3,2021-02-07,356,0,408,0,2021-02-07,1612652400.0
9743,32,3,2021-02-08,158,0,566,0,2021-02-08,1612738800.0
9744,32,3,2021-02-09,282,0,848,0,2021-02-09,1612825200.0
9745,32,3,2021-02-10,606,0,1454,0,2021-02-10,1612911600.0
9746,32,3,2021-02-11,1191,0,2645,0,2021-02-11,1612998000.0
9747,32,3,2021-02-12,1551,0,4196,0,2021-02-12,1613084400.0
9748,32,3,2021-02-13,73,0,4269,0,2021-02-13,1613170800.0
9749,32,3,2021-02-14,0,0,4269,0,2021-02-14,1613257200.0
9750,32,3,2021-02-15,932,0,5201,0,2021-02-15,1613343600.0
9751,32,3,2021-02-16,922,0,6123,0,2021-02-16,1613430000.0
9752,32,3,2021-02-17,1034,0,7157,0,2021-02-17,1613516400.0
9753,32,3,2021-02-18,1648,0,8805,0,2021-02-18,1613602800.0
9754,32,3,2021-02-19,1376,0,10181,0,2021-02-19,1613689200.0
9755,32,3,2021-02-20,483,0,10664,0,2021-02-20,1613775600.0
9756,32,3,2021-02-21,231,0,10895,0,2021-02-21,1613862000.0
9757,32,3,2021-02-22,541,0,11436,0,2021-02-22,1613948400.0
9758,32,3,2021-02-23,1075,0,12511,0,2021-02-23,1614034800.0
9759,32,3,2021-02-24,1432,0,13943,0,2021-02-24,1614121200.0
9760,32,3,2021-02-25,5902,0,19845,0,2021-02-25,1614207600.0
9761,32,3,2021-02-26,6264,0,26109,0,2021-02-26,1614294000.0
9762,32,3,2021-02-27,5000,2,31109,2,2021-02-27,1614380400.0
9763,32,3,2021-02-28,274,0,31383,2,2021-02-28,1614466800.0
9764,32,3,2021-03-01,1350,0,32733,2,2021-03-01,1614553200.0
9765,32,3,2021-03-02,3326,0,36059,2,2021-03-02,1614639600.0
9766,32,3,2021-03-03,4441,2,40500,4,2021-03-03,1614726000.0
9767,32,3,2021-03-04,7765,3,48265,7,2021-03-04,1614812400.0
9768,32,3,2021-03-05,9425,1,57690,8,2021-03-05,1614898800.0
9769,32,3,2021-03-06,12767,5,70457,13,2021-03-06,1614985200.0
9770,32,3,2021-03-07,5280,5,75737,18,2021-03-07,1615071600.0
9771,32,3,2021-03-08,2646,1,78383,19,2021-03-08,1615158000.0
9772,32,3,2021-03-09,6594,0,84977,19,2021-03-09,1615244400.0
9773,32,3,2021-03-10,7278,5,92255,24,2021-03-10,1615330800.0
9774,32,3,2021-03-11,11362,7,103617,31,2021-03-11,1615417200.0
9775,32,3,2021-03-12,17308,4,120925,35,2021-03-12,1615503600.0
9776,32,3,2021-03-13,19105,2,140030,37,2021-03-13,1615590000.0
9777,32,3,2021-03-14,1776,1,141806,38,2021-03-14,1615676400.0
9778,32,3,2021-03-15,5520,3,147326,41,2021-03-15,1615762800.0
9779,32,3,2021-03-16,47,5,147373,46,2021-03-16,1615849200.0
9780,32,3,2021-03-17,42,1,147415,47,2021-03-17,1615935600.0
9781,32,3,2021-03-18,73,1,147488,48,2021-03-18,1616022000.0
9782,32,3,2021-03-19,7454,1,154942,49,2021-03-19,1616108400.0
9783,32,3,2021-03-20,9577,5,164519,54,2021-03-20,1616194800.0
9784,32,3,2021-03-21,685,0,165204,54,2021-03-21,1616281200.0
9785,32,3,2021-03-22,3185,3,168389,57,2021-03-22,1616367600.0
9786,32,3,2021-03-23,8732,4,177121,61,2021-03-23,1616454000.0
9787,32,3,2021-03-24,8278,7,185399,68,2021-03-24,1616540400.0
9788,32,3,2021-03-25,14136,7,199535,75,2021-03-25,1616626800.0
9789,32,3,2021-03-26,16051,28,215586,103,2021-03-26,1616713200.0
9790,32,3,2021-03-27,9678,13,225264,116,2021-03-27,1616799600.0
9791,32,3,2021-03-28,1560,2,226824,118,2021-03-28,1616886000.0
9792,32,3,2021-03-29,4314,10,231138,128,2021-03-29,1616972400.0
9793,32,3,2021-03-30,7647,3,238785,131,2021-03-30,1617058800.0
9794,32,3,2021-03-31,5240,14,244025,145,2021-03-31,1617145200.0
9795,32,3,2021-04-01,6827,13,250852,158,2021-04-01,1617231600.0
9796,32,3,2021-04-02,8998,4,259850,162,2021-04-02,1617318000.0
9797,32,3,2021-04-03,6872,20,266722,182,2021-04-03,1617404400.0
9798,32,3,2021-04-04,1377,1,268099,183,2021-04-04,1617490800.0
9799,32,3,2021-04-05,2166,2,270265,185,2021-04-05,1617577200.0
9800,32,3,2021-04-06,2922,3,273187,188,2021-04-06,1617663600.0
9801,32,3,2021-04-07,2992,4,276179,192,2021-04-07,1617750000.0
9802,32,3,2021-04-08,6598,32,282777,224,2021-04-08,1617836400.0
9803,32,3,2021-04-09,16541,24,299318,248,2021-04-09,1617922800.0
9804,32,3,2021-04-10,13979,66,313297,314,2021-04-10,1618009200.0
9805,32,3,2021-04-11,2683,1,315980,315,2021-04-11,1618095600.0
9806,32,3,2021-04-12,5378,19,321358,334,2021-04-12,1618185600.0
9807,32,3,2021-04-13,9075,6,330433,340,2021-04-13,1618272000.0
9808,32,3,2021-04-14,7274,10,337707,350,2021-04-14,1618358400.0
9809,32,3,2021-04-15,9506,35,347213,385,2021-04-15,1618444800.0
9810,32,3,2021-04-16,12489,47,359702,432,2021-04-16,1618531200.0
9811,32,3,2021-04-17,9532,47,369234,479,2021-04-17,1618617600.0
9812,32,3,2021-04-18,1681,3,370915,482,2021-04-18,1618704000.0
9813,32,3,2021-04-19,2535,27,373450,509,2021-04-19,1618790400.0
9814,32,3,2021-04-20,4178,9,377628,518,2021-04-20,1618876800.0
9815,32,3,2021-04-21,3734,23,381362,541,2021-04-21,1618963200.0
9816,32,3,2021-04-22,5607,65,386969,606,2021-04-22,1619049600.0
9817,32,3,2021-04-23,8155,115,395124,721,2021-04-23,1619136000.0
9818,32,3,2021-04-24,6141,121,401265,842,2021-04-24,1619222400.0
9819,32,3,2021-04-25,1478,35,402743,877,2021-04-25,1619308800.0
9820,32,3,2021-04-26,2103,72,404846,949,2021-04-26,1619395200.0
9821,32,3,2021-04-27,3033,212,407879,1161,2021-04-27,1619481600.0
9822,32,3,2021-04-28,2990,345,410869,1506,2021-04-28,1619568000.0
9823,32,3,2021-04-29,4269,925,415138,2431,2021-04-29,1619654400.0
9824,32,3,2021-04-30,5465,1178,420603,3609,2021-04-30,1619740800.0
9825,32,3,2021-05-01,1618,316,422221,3925,2021-05-01,1619827200.0
9826,32,3,2021-05-02,632,92,422853,4017,2021-05-02,1619913600.0
9827,32,3,2021-05-03,1276,393,424129,4410,2021-05-03,1620000000.0
9828,32,3,2021-05-04,1762,644,425891,5054,2021-05-04,1620086400.0
9829,32,3,2021-05-05,1543,1044,427434,6098,2021-05-05,1620172800.0
9830,32,3,2021-05-06,3113,2282,430547,8380,2021-05-06,1620259200.0
9831,32,3,2021-05-07,3842,2500,434389,10880,2021-05-07,1620345600.0
9832,32,3,2021-05-08,940,1472,435329,12352,2021-05-08,1620432000.0
9833,32,3,2021-05-09,206,862,435535,13214,2021-05-09,1620518400.0
9834,32,3,2021-05-10,1342,815,436877,14029,2021-05-10,1620604800.0
9835,32,3,2021-05-11,2191,2085,439068,16114,2021-05-11,1620691200.0
9836,32,3,2021-05-12,1562,2854,440630,18968,2021-05-12,1620777600.0
9837,32,3,2021-05-13,247,476,440877,19444,2021-05-13,1620864000.0
9838,32,3,2021-05-14,1638,2813,442515,22257,2021-05-14,1620950400.0
9839,32,3,2021-05-15,1261,3664,443776,25921,2021-05-15,1621036800.0
9840,32,3,2021-05-16,142,472,443918,26393,2021-05-16,1621123200.0
9841,32,3,2021-05-17,685,1637,444603,28030,2021-05-17,1621206000.0
9842,32,3,2021-05-18,1216,3079,445819,31109,2021-05-18,1621292400.0
9843,32,3,2021-05-19,903,3182,446722,34291,2021-05-19,1621378800.0
9844,32,3,2021-05-20,1344,5827,448066,40118,2021-05-20,1621465200.0
9845,32,3,2021-05-21,1252,7073,449318,47191,2021-05-21,1621551600.0
9846,32,3,2021-05-22,689,5116,450007,52307,2021-05-22,1621638000.0
9847,32,3,2021-05-23,57,373,450064,52680,2021-05-23,1621724400.0
9848,32,3,2021-05-24,84,493,450148,53173,2021-05-24,1621810800.0
9849,32,3,2021-05-25,438,3497,450586,56670,2021-05-25,1621897200.0
9850,32,3,2021-05-26,448,4878,451034,61548,2021-05-26,1621983600.0
9851,32,3,2021-05-27,628,7968,451662,69516,2021-05-27,1622070000.0
9852,32,3,2021-05-28,693,9573,452355,79089,2021-05-28,1622156400.0
9853,32,3,2021-05-29,453,7970,452808,87059,2021-05-29,1622242800.0
9854,32,3,2021-05-30,56,627,452864,87686,2021-05-30,1622329200.0
9855,32,3,2021-05-31,185,2864,453049,90550,2021-05-31,1622415600.0
9856,32,3,2021-06-01,283,6704,453332,97254,2021-06-01,1622502000.0
9857,32,3,2021-06-02,259,5630,453591,102884,2021-06-02,1622588400.0
9858,32,3,2021-06-03,265,8186,453856,111070,2021-06-03,1622674800.0
9859,32,3,2021-06-04,434,9828,454290,120898,2021-06-04,1622761200.0
9860,32,3,2021-06-05,257,7634,454547,128532,2021-06-05,1622847600.0
9861,32,3,2021-06-06,44,754,454591,129286,2021-06-06,1622934000.0
9862,32,3,2021-06-07,103,3280,454694,132566,2021-06-07,1623020400.0
9863,32,3,2021-06-08,159,4556,454853,137122,2021-06-08,1623106800.0
9864,32,3,2021-06-09,102,3985,454955,141107,2021-06-09,1623193200.0
9865,32,3,2021-06-10,185,6375,455140,147482,2021-06-10,1623279600.0
9866,32,3,2021-06-11,235,9936,455375,157418,2021-06-11,1623366000.0
9867,32,3,2021-06-12,157,6574,455532,163992,2021-06-12,1623452400.0
9868,32,3,2021-06-13,23,670,455555,164662,2021-06-13,1623538800.0
9869,32,3,2021-06-14,74,4552,455629,169214,2021-06-14,1623625200.0
9870,32,3,2021-06-15,82,7329,455711,176543,2021-06-15,1623711600.0
9871,32,3,2021-06-16,101,6390,455812,182933,2021-06-16,1623798000.0
9872,32,3,2021-06-17,133,9789,455945,192722,2021-06-17,1623884400.0
9873,32,3,2021-06-18,178,12308,456123,205030,2021-06-18,1623970800.0
9874,32,3,2021-06-19,106,6586,456229,211616,2021-06-19,1624057200.0
9875,32,3,2021-06-20,7,503,456236,212119,2021-06-20,1624143600.0
9876,32,3,2021-06-21,26,3832,456262,215951,2021-06-21,1624230000.0
9877,32,3,2021-06-22,97,6467,456359,222418,2021-06-22,1624316400.0
9878,32,3,2021-06-23,77,5021,456436,227439,2021-06-23,1624402800.0
9879,32,3,2021-06-24,117,7383,456553,234822,2021-06-24,1624489200.0
9880,32,3,2021-06-25,139,9684,456692,244506,2021-06-25,1624575600.0
9881,32,3,2021-06-26,65,6326,456757,250832,2021-06-26,1624662000.0
9882,32,3,2021-06-27,10,993,456767,251825,2021-06-27,1624748400.0
9883,32,3,2021-06-28,40,3653,456807,255478,2021-06-28,1624834800.0
9884,32,3,2021-06-29,63,5519,456870,260997,2021-06-29,1624921200.0
9885,32,3,2021-06-30,68,4652,456938,265649,2021-06-30,1625007600.0
9886,32,3,2021-07-01,92,6405,457030,272054,2021-07-01,1625094000.0
9887,32,3,2021-07-02,154,10398,457184,282452,2021-07-02,1625180400.0
9888,32,3,2021-07-03,97,6795,457281,289247,2021-07-03,1625266800.0
9889,32,3,2021-07-04,13,964,457294,290211,2021-07-04,1625353200.0
9890,32,3,2021-07-05,49,4246,457343,294457,2021-07-05,1625439600.0
9891,32,3,2021-07-06,96,5540,457439,299997,2021-07-06,1625526000.0
9892,32,3,2021-07-07,64,4192,457503,304189,2021-07-07,1625612400.0
9893,32,3,2021-07-08,101,6253,457604,310442,2021-07-08,1625698800.0
9894,32,4,2020-12-27,0,0,0,0,2020-12-27,1609023600.0
9895,32,4,2020-12-28,0,0,0,0,2020-12-28,1609110000.0
9896,32,4,2020-12-29,0,0,0,0,2020-12-29,1609196400.0
9897,32,4,2020-12-30,0,0,0,0,2020-12-30,1609282800.0
9898,32,4,2020-12-31,0,0,0,0,2020-12-31,1609369200.0
9899,32,4,2021-01-01,0,0,0,0,2021-01-01,1609455600.0
9900,32,4,2021-01-02,0,0,0,0,2021-01-02,1609542000.0
9901,32,4,2021-01-03,0,0,0,0,2021-01-03,1609628400.0
9902,32,4,2021-01-04,0,0,0,0,2021-01-04,1609714800.0
9903,32,4,2021-01-05,0,0,0,0,2021-01-05,1609801200.0
9904,32,4,2021-01-06,0,0,0,0,2021-01-06,1609887600.0
9905,32,4,2021-01-07,0,0,0,0,2021-01-07,1609974000.0
9906,32,4,2021-01-08,0,0,0,0,2021-01-08,1610060400.0
9907,32,4,2021-01-09,0,0,0,0,2021-01-09,1610146800.0
9908,32,4,2021-01-10,0,0,0,0,2021-01-10,1610233200.0
9909,32,4,2021-01-11,0,0,0,0,2021-01-11,1610319600.0
9910,32,4,2021-01-12,0,0,0,0,2021-01-12,1610406000.0
9911,32,4,2021-01-13,0,0,0,0,2021-01-13,1610492400.0
9912,32,4,2021-01-14,0,0,0,0,2021-01-14,1610578800.0
9913,32,4,2021-01-15,0,0,0,0,2021-01-15,1610665200.0
9914,32,4,2021-01-16,0,0,0,0,2021-01-16,1610751600.0
9915,32,4,2021-01-17,0,0,0,0,2021-01-17,1610838000.0
9916,32,4,2021-01-18,0,0,0,0,2021-01-18,1610924400.0
9917,32,4,2021-01-19,0,0,0,0,2021-01-19,1611010800.0
9918,32,4,2021-01-20,0,0,0,0,2021-01-20,1611097200.0
9919,32,4,2021-01-21,0,0,0,0,2021-01-21,1611183600.0
9920,32,4,2021-01-22,0,0,0,0,2021-01-22,1611270000.0
9921,32,4,2021-01-23,0,0,0,0,2021-01-23,1611356400.0
9922,32,4,2021-01-24,0,0,0,0,2021-01-24,1611442800.0
9923,32,4,2021-01-25,0,0,0,0,2021-01-25,1611529200.0
9924,32,4,2021-01-26,0,0,0,0,2021-01-26,1611615600.0
9925,32,4,2021-01-27,0,0,0,0,2021-01-27,1611702000.0
9926,32,4,2021-01-28,0,0,0,0,2021-01-28,1611788400.0
9927,32,4,2021-01-29,0,0,0,0,2021-01-29,1611874800.0
9928,32,4,2021-01-30,0,0,0,0,2021-01-30,1611961200.0
9929,32,4,2021-01-31,0,0,0,0,2021-01-31,1612047600.0
9930,32,4,2021-02-01,0,0,0,0,2021-02-01,1612134000.0
9931,32,4,2021-02-02,0,0,0,0,2021-02-02,1612220400.0
9932,32,4,2021-02-03,0,0,0,0,2021-02-03,1612306800.0
9933,32,4,2021-02-04,0,0,0,0,2021-02-04,1612393200.0
9934,32,4,2021-02-05,0,0,0,0,2021-02-05,1612479600.0
9935,32,4,2021-02-06,0,0,0,0,2021-02-06,1612566000.0
9936,32,4,2021-02-07,0,0,0,0,2021-02-07,1612652400.0
9937,32,4,2021-02-08,0,0,0,0,2021-02-08,1612738800.0
9938,32,4,2021-02-09,0,0,0,0,2021-02-09,1612825200.0
9939,32,4,2021-02-10,0,0,0,0,2021-02-10,1612911600.0
9940,32,4,2021-02-11,0,0,0,0,2021-02-11,1612998000.0
9941,32,4,2021-02-12,0,0,0,0,2021-02-12,1613084400.0
9942,32,4,2021-02-13,0,0,0,0,2021-02-13,1613170800.0
9943,32,4,2021-02-14,0,0,0,0,2021-02-14,1613257200.0
9944,32,4,2021-02-15,0,0,0,0,2021-02-15,1613343600.0
9945,32,4,2021-02-16,0,0,0,0,2021-02-16,1613430000.0
9946,32,4,2021-02-17,0,0,0,0,2021-02-17,1613516400.0
9947,32,4,2021-02-18,0,0,0,0,2021-02-18,1613602800.0
9948,32,4,2021-02-19,0,0,0,0,2021-02-19,1613689200.0
9949,32,4,2021-02-20,0,0,0,0,2021-02-20,1613775600.0
9950,32,4,2021-02-21,0,0,0,0,2021-02-21,1613862000.0
9951,32,4,2021-02-22,0,0,0,0,2021-02-22,1613948400.0
9952,32,4,2021-02-23,0,0,0,0,2021-02-23,1614034800.0
9953,32,4,2021-02-24,0,0,0,0,2021-02-24,1614121200.0
9954,32,4,2021-02-25,0,0,0,0,2021-02-25,1614207600.0
9955,32,4,2021-02-26,0,0,0,0,2021-02-26,1614294000.0
9956,32,4,2021-02-27,0,0,0,0,2021-02-27,1614380400.0
9957,32,4,2021-02-28,0,0,0,0,2021-02-28,1614466800.0
9958,32,4,2021-03-01,0,0,0,0,2021-03-01,1614553200.0
9959,32,4,2021-03-02,0,0,0,0,2021-03-02,1614639600.0
9960,32,4,2021-03-03,0,0,0,0,2021-03-03,1614726000.0
9961,32,4,2021-03-04,0,0,0,0,2021-03-04,1614812400.0
9962,32,4,2021-03-05,0,0,0,0,2021-03-05,1614898800.0
9963,32,4,2021-03-06,0,0,0,0,2021-03-06,1614985200.0
9964,32,4,2021-03-07,0,0,0,0,2021-03-07,1615071600.0
9965,32,4,2021-03-08,0,0,0,0,2021-03-08,1615158000.0
9966,32,4,2021-03-09,0,0,0,0,2021-03-09,1615244400.0
9967,32,4,2021-03-10,0,0,0,0,2021-03-10,1615330800.0
9968,32,4,2021-03-11,0,0,0,0,2021-03-11,1615417200.0
9969,32,4,2021-03-12,0,0,0,0,2021-03-12,1615503600.0
9970,32,4,2021-03-13,0,0,0,0,2021-03-13,1615590000.0
9971,32,4,2021-03-14,0,0,0,0,2021-03-14,1615676400.0
9972,32,4,2021-03-15,0,0,0,0,2021-03-15,1615762800.0
9973,32,4,2021-03-16,0,0,0,0,2021-03-16,1615849200.0
9974,32,4,2021-03-17,0,0,0,0,2021-03-17,1615935600.0
9975,32,4,2021-03-18,0,0,0,0,2021-03-18,1616022000.0
9976,32,4,2021-03-19,0,0,0,0,2021-03-19,1616108400.0
9977,32,4,2021-03-20,0,0,0,0,2021-03-20,1616194800.0
9978,32,4,2021-03-21,0,0,0,0,2021-03-21,1616281200.0
9979,32,4,2021-03-22,0,0,0,0,2021-03-22,1616367600.0
9980,32,4,2021-03-23,0,0,0,0,2021-03-23,1616454000.0
9981,32,4,2021-03-24,0,0,0,0,2021-03-24,1616540400.0
9982,32,4,2021-03-25,0,0,0,0,2021-03-25,1616626800.0
9983,32,4,2021-03-26,0,0,0,0,2021-03-26,1616713200.0
9984,32,4,2021-03-27,0,0,0,0,2021-03-27,1616799600.0
9985,32,4,2021-03-28,0,0,0,0,2021-03-28,1616886000.0
9986,32,4,2021-03-29,0,0,0,0,2021-03-29,1616972400.0
9987,32,4,2021-03-30,0,0,0,0,2021-03-30,1617058800.0
9988,32,4,2021-03-31,0,0,0,0,2021-03-31,1617145200.0
9989,32,4,2021-04-01,0,0,0,0,2021-04-01,1617231600.0
9990,32,4,2021-04-02,0,0,0,0,2021-04-02,1617318000.0
9991,32,4,2021-04-03,0,0,0,0,2021-04-03,1617404400.0
9992,32,4,2021-04-04,0,0,0,0,2021-04-04,1617490800.0
9993,32,4,2021-04-05,0,0,0,0,2021-04-05,1617577200.0
9994,32,4,2021-04-06,0,0,0,0,2021-04-06,1617663600.0
9995,32,4,2021-04-07,0,0,0,0,2021-04-07,1617750000.0
9996,32,4,2021-04-08,0,0,0,0,2021-04-08,1617836400.0
9997,32,4,2021-04-09,0,0,0,0,2021-04-09,1617922800.0
9998,32,4,2021-04-10,0,0,0,0,2021-04-10,1618009200.0
9999,32,4,2021-04-11,0,0,0,0,2021-04-11,1618095600.0
10000,32,4,2021-04-12,0,0,0,0,2021-04-12,1618185600.0
10001,32,4,2021-04-13,0,0,0,0,2021-04-13,1618272000.0
10002,32,4,2021-04-14,0,0,0,0,2021-04-14,1618358400.0
10003,32,4,2021-04-15,0,0,0,0,2021-04-15,1618444800.0
10004,32,4,2021-04-16,0,0,0,0,2021-04-16,1618531200.0
10005,32,4,2021-04-17,0,0,0,0,2021-04-17,1618617600.0
10006,32,4,2021-04-18,0,0,0,0,2021-04-18,1618704000.0
10007,32,4,2021-04-19,0,0,0,0,2021-04-19,1618790400.0
10008,32,4,2021-04-20,0,0,0,0,2021-04-20,1618876800.0
10009,32,4,2021-04-21,0,0,0,0,2021-04-21,1618963200.0
10010,32,4,2021-04-22,0,0,0,0,2021-04-22,1619049600.0
10011,32,4,2021-04-23,74,0,74,0,2021-04-23,1619136000.0
10012,32,4,2021-04-24,252,0,326,0,2021-04-24,1619222400.0
10013,32,4,2021-04-25,11,0,337,0,2021-04-25,1619308800.0
10014,32,4,2021-04-26,363,0,700,0,2021-04-26,1619395200.0
10015,32,4,2021-04-27,1179,1,1879,1,2021-04-27,1619481600.0
10016,32,4,2021-04-28,1254,1,3133,2,2021-04-28,1619568000.0
10017,32,4,2021-04-29,1608,0,4741,2,2021-04-29,1619654400.0
10018,32,4,2021-04-30,2098,0,6839,2,2021-04-30,1619740800.0
10019,32,4,2021-05-01,431,0,7270,2,2021-05-01,1619827200.0
10020,32,4,2021-05-02,78,0,7348,2,2021-05-02,1619913600.0
10021,32,4,2021-05-03,421,0,7769,2,2021-05-03,1620000000.0
10022,32,4,2021-05-04,802,0,8571,2,2021-05-04,1620086400.0
10023,32,4,2021-05-05,488,0,9059,2,2021-05-05,1620172800.0
10024,32,4,2021-05-06,1054,1,10113,3,2021-05-06,1620259200.0
10025,32,4,2021-05-07,2094,0,12207,3,2021-05-07,1620345600.0
10026,32,4,2021-05-08,312,0,12519,3,2021-05-08,1620432000.0
10027,32,4,2021-05-09,51,0,12570,3,2021-05-09,1620518400.0
10028,32,4,2021-05-10,827,0,13397,3,2021-05-10,1620604800.0
10029,32,4,2021-05-11,1304,0,14701,3,2021-05-11,1620691200.0
10030,32,4,2021-05-12,1148,0,15849,3,2021-05-12,1620777600.0
10031,32,4,2021-05-13,93,0,15942,3,2021-05-13,1620864000.0
10032,32,4,2021-05-14,856,0,16798,3,2021-05-14,1620950400.0
10033,32,4,2021-05-15,662,0,17460,3,2021-05-15,1621036800.0
10034,32,4,2021-05-16,66,0,17526,3,2021-05-16,1621123200.0
10035,32,4,2021-05-17,364,0,17890,3,2021-05-17,1621206000.0
10036,32,4,2021-05-18,829,0,18719,3,2021-05-18,1621292400.0
10037,32,4,2021-05-19,579,0,19298,3,2021-05-19,1621378800.0
10038,32,4,2021-05-20,848,1,20146,4,2021-05-20,1621465200.0
10039,32,4,2021-05-21,1364,3,21510,7,2021-05-21,1621551600.0
10040,32,4,2021-05-22,737,1,22247,8,2021-05-22,1621638000.0
10041,32,4,2021-05-23,85,0,22332,8,2021-05-23,1621724400.0
10042,32,4,2021-05-24,100,0,22432,8,2021-05-24,1621810800.0
10043,32,4,2021-05-25,689,2,23121,10,2021-05-25,1621897200.0
10044,32,4,2021-05-26,565,1,23686,11,2021-05-26,1621983600.0
10045,32,4,2021-05-27,1270,5,24956,16,2021-05-27,1622070000.0
10046,32,4,2021-05-28,2637,3,27593,19,2021-05-28,1622156400.0
10047,32,4,2021-05-29,1432,2,29025,21,2021-05-29,1622242800.0
10048,32,4,2021-05-30,122,0,29147,21,2021-05-30,1622329200.0
10049,32,4,2021-05-31,1248,0,30395,21,2021-05-31,1622415600.0
10050,32,4,2021-06-01,1721,1,32116,22,2021-06-01,1622502000.0
10051,32,4,2021-06-02,1346,1,33462,23,2021-06-02,1622588400.0
10052,32,4,2021-06-03,1651,2,35113,25,2021-06-03,1622674800.0
10053,32,4,2021-06-04,2033,1,37146,26,2021-06-04,1622761200.0
10054,32,4,2021-06-05,1168,2,38314,28,2021-06-05,1622847600.0
10055,32,4,2021-06-06,78,0,38392,28,2021-06-06,1622934000.0
10056,32,4,2021-06-07,658,0,39050,28,2021-06-07,1623020400.0
10057,32,4,2021-06-08,1265,1,40315,29,2021-06-08,1623106800.0
10058,32,4,2021-06-09,1125,1,41440,30,2021-06-09,1623193200.0
10059,32,4,2021-06-10,1358,4,42798,34,2021-06-10,1623279600.0
10060,32,4,2021-06-11,1611,5,44409,39,2021-06-11,1623366000.0
10061,32,4,2021-06-12,836,0,45245,39,2021-06-12,1623452400.0
10062,32,4,2021-06-13,132,0,45377,39,2021-06-13,1623538800.0
10063,32,4,2021-06-14,531,2,45908,41,2021-06-14,1623625200.0
10064,32,4,2021-06-15,824,2,46732,43,2021-06-15,1623711600.0
10065,32,4,2021-06-16,662,1,47394,44,2021-06-16,1623798000.0
10066,32,4,2021-06-17,782,2,48176,46,2021-06-17,1623884400.0
10067,32,4,2021-06-18,1101,4,49277,50,2021-06-18,1623970800.0
10068,32,4,2021-06-19,711,6,49988,56,2021-06-19,1624057200.0
10069,32,4,2021-06-20,48,0,50036,56,2021-06-20,1624143600.0
10070,32,4,2021-06-21,357,0,50393,56,2021-06-21,1624230000.0
10071,32,4,2021-06-22,647,0,51040,56,2021-06-22,1624316400.0
10072,32,4,2021-06-23,564,1,51604,57,2021-06-23,1624402800.0
10073,32,4,2021-06-24,798,2,52402,59,2021-06-24,1624489200.0
10074,32,4,2021-06-25,814,1,53216,60,2021-06-25,1624575600.0
10075,32,4,2021-06-26,584,3,53800,63,2021-06-26,1624662000.0
10076,32,4,2021-06-27,94,0,53894,63,2021-06-27,1624748400.0
10077,32,4,2021-06-28,366,0,54260,63,2021-06-28,1624834800.0
10078,32,4,2021-06-29,522,2,54782,65,2021-06-29,1624921200.0
10079,32,4,2021-06-30,592,1,55374,66,2021-06-30,1625007600.0
10080,32,4,2021-07-01,616,1,55990,67,2021-07-01,1625094000.0
10081,32,4,2021-07-02,800,2,56790,69,2021-07-02,1625180400.0
10082,32,4,2021-07-03,536,0,57326,69,2021-07-03,1625266800.0
10083,32,4,2021-07-04,74,2,57400,71,2021-07-04,1625353200.0
10084,32,4,2021-07-05,331,2,57731,73,2021-07-05,1625439600.0
10085,32,4,2021-07-06,580,0,58311,73,2021-07-06,1625526000.0
10086,32,4,2021-07-07,570,0,58881,73,2021-07-07,1625612400.0
10087,32,4,2021-07-08,791,3,59672,76,2021-07-08,1625698800.0
10088,44,1,2020-12-27,0,0,0,0,2020-12-27,1609023600.0
10089,44,1,2020-12-28,0,0,0,0,2020-12-28,1609110000.0
10090,44,1,2020-12-29,0,0,0,0,2020-12-29,1609196400.0
10091,44,1,2020-12-30,1,0,1,0,2020-12-30,1609282800.0
10092,44,1,2020-12-31,11,0,12,0,2020-12-31,1609369200.0
10093,44,1,2021-01-01,2,0,14,0,2021-01-01,1609455600.0
10094,44,1,2021-01-02,3,0,17,0,2021-01-02,1609542000.0
10095,44,1,2021-01-03,3,0,20,0,2021-01-03,1609628400.0
10096,44,1,2021-01-04,243,0,263,0,2021-01-04,1609714800.0
10097,44,1,2021-01-05,773,0,1036,0,2021-01-05,1609801200.0
10098,44,1,2021-01-06,1247,0,2283,0,2021-01-06,1609887600.0
10099,44,1,2021-01-07,2431,0,4714,0,2021-01-07,1609974000.0
10100,44,1,2021-01-08,3144,0,7858,0,2021-01-08,1610060400.0
10101,44,1,2021-01-09,945,0,8803,0,2021-01-09,1610146800.0
10102,44,1,2021-01-10,242,0,9045,0,2021-01-10,1610233200.0
10103,44,1,2021-01-11,2992,0,12037,0,2021-01-11,1610319600.0
10104,44,1,2021-01-12,5279,0,17316,0,2021-01-12,1610406000.0
10105,44,1,2021-01-13,7668,0,24984,0,2021-01-13,1610492400.0
10106,44,1,2021-01-14,9453,0,34437,0,2021-01-14,1610578800.0
10107,44,1,2021-01-15,6550,0,40987,0,2021-01-15,1610665200.0
10108,44,1,2021-01-16,1771,7,42758,7,2021-01-16,1610751600.0
10109,44,1,2021-01-17,901,1,43659,8,2021-01-17,1610838000.0
10110,44,1,2021-01-18,7777,4,51436,12,2021-01-18,1610924400.0
10111,44,1,2021-01-19,9401,2,60837,14,2021-01-19,1611010800.0
10112,44,1,2021-01-20,9612,8,70449,22,2021-01-20,1611097200.0
10113,44,1,2021-01-21,10229,2,80678,24,2021-01-21,1611183600.0
10114,44,1,2021-01-22,8080,6,88758,30,2021-01-22,1611270000.0
10115,44,1,2021-01-23,2866,15,91624,45,2021-01-23,1611356400.0
10116,44,1,2021-01-24,1515,1,93139,46,2021-01-24,1611442800.0
10117,44,1,2021-01-25,5169,286,98308,332,2021-01-25,1611529200.0
10118,44,1,2021-01-26,4345,415,102653,747,2021-01-26,1611615600.0
10119,44,1,2021-01-27,6005,575,108658,1322,2021-01-27,1611702000.0
10120,44,1,2021-01-28,7252,1221,115910,2543,2021-01-28,1611788400.0
10121,44,1,2021-01-29,5339,1780,121249,4323,2021-01-29,1611874800.0
10122,44,1,2021-01-30,2039,488,123288,4811,2021-01-30,1611961200.0
10123,44,1,2021-01-31,1252,53,124540,4864,2021-01-31,1612047600.0
10124,44,1,2021-02-01,5010,2362,129550,7226,2021-02-01,1612134000.0
10125,44,1,2021-02-02,4793,3789,134343,11015,2021-02-02,1612220400.0
10126,44,1,2021-02-03,4042,4527,138385,15542,2021-02-03,1612306800.0
10127,44,1,2021-02-04,5526,6928,143911,22470,2021-02-04,1612393200.0
10128,44,1,2021-02-05,5557,5208,149468,27678,2021-02-05,1612479600.0
10129,44,1,2021-02-06,1521,1204,150989,28882,2021-02-06,1612566000.0
10130,44,1,2021-02-07,406,591,151395,29473,2021-02-07,1612652400.0
10131,44,1,2021-02-08,3163,4435,154558,33908,2021-02-08,1612738800.0
10132,44,1,2021-02-09,4575,5769,159133,39677,2021-02-09,1612825200.0
10133,44,1,2021-02-10,4825,5955,163958,45632,2021-02-10,1612911600.0
10134,44,1,2021-02-11,5457,6405,169415,52037,2021-02-11,1612998000.0
10135,44,1,2021-02-12,5279,5285,174694,57322,2021-02-12,1613084400.0
10136,44,1,2021-02-13,2213,1108,176907,58430,2021-02-13,1613170800.0
10137,44,1,2021-02-14,1607,815,178514,59245,2021-02-14,1613257200.0
10138,44,1,2021-02-15,2680,6062,181194,65307,2021-02-15,1613343600.0
10139,44,1,2021-02-16,3098,6769,184292,72076,2021-02-16,1613430000.0
10140,44,1,2021-02-17,3237,7121,187529,79197,2021-02-17,1613516400.0
10141,44,1,2021-02-18,4263,7730,191792,86927,2021-02-18,1613602800.0
10142,44,1,2021-02-19,3820,6005,195612,92932,2021-02-19,1613689200.0
10143,44,1,2021-02-20,1881,2403,197493,95335,2021-02-20,1613775600.0
10144,44,1,2021-02-21,530,1301,198023,96636,2021-02-21,1613862000.0
10145,44,1,2021-02-22,3391,5444,201414,102080,2021-02-22,1613948400.0
10146,44,1,2021-02-23,4952,5759,206366,107839,2021-02-23,1614034800.0
10147,44,1,2021-02-24,4646,4438,211012,112277,2021-02-24,1614121200.0
10148,44,1,2021-02-25,5478,5752,216490,118029,2021-02-25,1614207600.0
10149,44,1,2021-02-26,4679,4717,221169,122746,2021-02-26,1614294000.0
10150,44,1,2021-02-27,3624,1581,224793,124327,2021-02-27,1614380400.0
10151,44,1,2021-02-28,1966,471,226759,124798,2021-02-28,1614466800.0
10152,44,1,2021-03-01,4345,3247,231104,128045,2021-03-01,1614553200.0
10153,44,1,2021-03-02,6430,4043,237534,132088,2021-03-02,1614639600.0
10154,44,1,2021-03-03,6544,3842,244078,135930,2021-03-03,1614726000.0
10155,44,1,2021-03-04,6656,4803,250734,140733,2021-03-04,1614812400.0
10156,44,1,2021-03-05,7231,4429,257965,145162,2021-03-05,1614898800.0
10157,44,1,2021-03-06,7914,1415,265879,146577,2021-03-06,1614985200.0
10158,44,1,2021-03-07,5355,544,271234,147121,2021-03-07,1615071600.0
10159,44,1,2021-03-08,5750,3709,276984,150830,2021-03-08,1615158000.0
10160,44,1,2021-03-09,8054,4428,285038,155258,2021-03-09,1615244400.0
10161,44,1,2021-03-10,8639,4690,293677,159948,2021-03-10,1615330800.0
10162,44,1,2021-03-11,10059,5154,303736,165102,2021-03-11,1615417200.0
10163,44,1,2021-03-12,9560,4791,313296,169893,2021-03-12,1615503600.0
10164,44,1,2021-03-13,5286,1931,318582,171824,2021-03-13,1615590000.0
10165,44,1,2021-03-14,2290,734,320872,172558,2021-03-14,1615676400.0
10166,44,1,2021-03-15,8416,3067,329288,175625,2021-03-15,1615762800.0
10167,44,1,2021-03-16,11183,3571,340471,179196,2021-03-16,1615849200.0
10168,44,1,2021-03-17,12665,3189,353136,182385,2021-03-17,1615935600.0
10169,44,1,2021-03-18,13234,3274,366370,185659,2021-03-18,1616022000.0
10170,44,1,2021-03-19,12517,3024,378887,188683,2021-03-19,1616108400.0
10171,44,1,2021-03-20,6222,1447,385109,190130,2021-03-20,1616194800.0
10172,44,1,2021-03-21,724,216,385833,190346,2021-03-21,1616281200.0
10173,44,1,2021-03-22,8712,3372,394545,193718,2021-03-22,1616367600.0
10174,44,1,2021-03-23,11731,4454,406276,198172,2021-03-23,1616454000.0
10175,44,1,2021-03-24,12221,4317,418497,202489,2021-03-24,1616540400.0
10176,44,1,2021-03-25,13177,4864,431674,207353,2021-03-25,1616626800.0
10177,44,1,2021-03-26,13626,4226,445300,211579,2021-03-26,1616713200.0
10178,44,1,2021-03-27,7120,4029,452420,215608,2021-03-27,1616799600.0
10179,44,1,2021-03-28,2900,1891,455320,217499,2021-03-28,1616886000.0
10180,44,1,2021-03-29,8919,5497,464239,222996,2021-03-29,1616972400.0
10181,44,1,2021-03-30,11784,6993,476023,229989,2021-03-30,1617058800.0
10182,44,1,2021-03-31,11984,7091,488007,237080,2021-03-31,1617145200.0
10183,44,1,2021-04-01,13726,8184,501733,245264,2021-04-01,1617231600.0
10184,44,1,2021-04-02,8724,5988,510457,251252,2021-04-02,1617318000.0
10185,44,1,2021-04-03,5725,5305,516182,256557,2021-04-03,1617404400.0
10186,44,1,2021-04-04,2548,1408,518730,257965,2021-04-04,1617490800.0
10187,44,1,2021-04-05,3535,1092,522265,259057,2021-04-05,1617577200.0
10188,44,1,2021-04-06,9766,9192,532031,268249,2021-04-06,1617663600.0
10189,44,1,2021-04-07,12301,10216,544332,278465,2021-04-07,1617750000.0
10190,44,1,2021-04-08,15865,9786,560197,288251,2021-04-08,1617836400.0
10191,44,1,2021-04-09,15705,10067,575902,298318,2021-04-09,1617922800.0
10192,44,1,2021-04-10,9295,5454,585197,303772,2021-04-10,1618009200.0
10193,44,1,2021-04-11,1937,2962,587134,306734,2021-04-11,1618095600.0
10194,44,1,2021-04-12,11842,9135,598976,315869,2021-04-12,1618185600.0
10195,44,1,2021-04-13,15084,11215,614060,327084,2021-04-13,1618272000.0
10196,44,1,2021-04-14,16593,11578,630653,338662,2021-04-14,1618358400.0
10197,44,1,2021-04-15,17953,11721,648606,350383,2021-04-15,1618444800.0
10198,44,1,2021-04-16,17120,11585,665726,361968,2021-04-16,1618531200.0
10199,44,1,2021-04-17,13653,5825,679379,367793,2021-04-17,1618617600.0
10200,44,1,2021-04-18,2235,1164,681614,368957,2021-04-18,1618704000.0
10201,44,1,2021-04-19,13967,9583,695581,378540,2021-04-19,1618790400.0
10202,44,1,2021-04-20,14649,11615,710230,390155,2021-04-20,1618876800.0
10203,44,1,2021-04-21,16846,12402,727076,402557,2021-04-21,1618963200.0
10204,44,1,2021-04-22,17611,13057,744687,415614,2021-04-22,1619049600.0
10205,44,1,2021-04-23,18740,13126,763427,428740,2021-04-23,1619136000.0
10206,44,1,2021-04-24,11463,7043,774890,435783,2021-04-24,1619222400.0
10207,44,1,2021-04-25,4121,2535,779011,438318,2021-04-25,1619308800.0
10208,44,1,2021-04-26,13483,9986,792494,448304,2021-04-26,1619395200.0
10209,44,1,2021-04-27,16412,11061,808906,459365,2021-04-27,1619481600.0
10210,44,1,2021-04-28,19087,10616,827993,469981,2021-04-28,1619568000.0
10211,44,1,2021-04-29,21133,10614,849126,480595,2021-04-29,1619654400.0
10212,44,1,2021-04-30,23810,9215,872936,489810,2021-04-30,1619740800.0
10213,44,1,2021-05-01,13195,3989,886131,493799,2021-05-01,1619827200.0
10214,44,1,2021-05-02,7477,2651,893608,496450,2021-05-02,1619913600.0
10215,44,1,2021-05-03,20667,9170,914275,505620,2021-05-03,1620000000.0
10216,44,1,2021-05-04,22560,12554,936835,518174,2021-05-04,1620086400.0
10217,44,1,2021-05-05,27117,13079,963952,531253,2021-05-05,1620172800.0
10218,44,1,2021-05-06,30102,12582,994054,543835,2021-05-06,1620259200.0
10219,44,1,2021-05-07,28419,15028,1022473,558863,2021-05-07,1620345600.0
10220,44,1,2021-05-08,17326,3301,1039799,562164,2021-05-08,1620432000.0
10221,44,1,2021-05-09,10556,1482,1050355,563646,2021-05-09,1620518400.0
10222,44,1,2021-05-10,20103,16617,1070458,580263,2021-05-10,1620604800.0
10223,44,1,2021-05-11,27199,16797,1097657,597060,2021-05-11,1620691200.0
10224,44,1,2021-05-12,30043,16836,1127700,613896,2021-05-12,1620777600.0
10225,44,1,2021-05-13,22027,3616,1149727,617512,2021-05-13,1620864000.0
10226,44,1,2021-05-14,32474,11155,1182201,628667,2021-05-14,1620950400.0
10227,44,1,2021-05-15,25537,7931,1207738,636598,2021-05-15,1621036800.0
10228,44,1,2021-05-16,12385,767,1220123,637365,2021-05-16,1621123200.0
10229,44,1,2021-05-17,22017,9927,1242140,647292,2021-05-17,1621206000.0
10230,44,1,2021-05-18,27828,9220,1269968,656512,2021-05-18,1621292400.0
10231,44,1,2021-05-19,30884,9294,1300852,665806,2021-05-19,1621378800.0
10232,44,1,2021-05-20,33582,7265,1334434,673071,2021-05-20,1621465200.0
10233,44,1,2021-05-21,34724,8950,1369158,682021,2021-05-21,1621551600.0
10234,44,1,2021-05-22,23401,4586,1392559,686607,2021-05-22,1621638000.0
10235,44,1,2021-05-23,7647,869,1400206,687476,2021-05-23,1621724400.0
10236,44,1,2021-05-24,17054,2628,1417260,690104,2021-05-24,1621810800.0
10237,44,1,2021-05-25,27439,10874,1444699,700978,2021-05-25,1621897200.0
10238,44,1,2021-05-26,30423,11022,1475122,712000,2021-05-26,1621983600.0
10239,44,1,2021-05-27,30803,9854,1505925,721854,2021-05-27,1622070000.0
10240,44,1,2021-05-28,30333,12173,1536258,734027,2021-05-28,1622156400.0
10241,44,1,2021-05-29,21156,8622,1557414,742649,2021-05-29,1622242800.0
10242,44,1,2021-05-30,5653,1764,1563067,744413,2021-05-30,1622329200.0
10243,44,1,2021-05-31,22018,11834,1585085,756247,2021-05-31,1622415600.0
10244,44,1,2021-06-01,25134,12691,1610219,768938,2021-06-01,1622502000.0
10245,44,1,2021-06-02,28656,12100,1638875,781038,2021-06-02,1622588400.0
10246,44,1,2021-06-03,27960,11856,1666835,792894,2021-06-03,1622674800.0
10247,44,1,2021-06-04,31744,15930,1698579,808824,2021-06-04,1622761200.0
10248,44,1,2021-06-05,17710,9232,1716289,818056,2021-06-05,1622847600.0
10249,44,1,2021-06-06,7688,3042,1723977,821098,2021-06-06,1622934000.0
10250,44,1,2021-06-07,25022,15322,1748999,836420,2021-06-07,1623020400.0
10251,44,1,2021-06-08,27928,16891,1776927,853311,2021-06-08,1623106800.0
10252,44,1,2021-06-09,31554,15545,1808481,868856,2021-06-09,1623193200.0
10253,44,1,2021-06-10,29462,14252,1837943,883108,2021-06-10,1623279600.0
10254,44,1,2021-06-11,25529,20378,1863472,903486,2021-06-11,1623366000.0
10255,44,1,2021-06-12,21167,13997,1884639,917483,2021-06-12,1623452400.0
10256,44,1,2021-06-13,6484,4908,1891123,922391,2021-06-13,1623538800.0
10257,44,1,2021-06-14,14709,22164,1905832,944555,2021-06-14,1623625200.0
10258,44,1,2021-06-15,19745,23607,1925577,968162,2021-06-15,1623711600.0
10259,44,1,2021-06-16,20935,26232,1946512,994394,2021-06-16,1623798000.0
10260,44,1,2021-06-17,19563,23510,1966075,1017904,2021-06-17,1623884400.0
10261,44,1,2021-06-18,20636,27266,1986711,1045170,2021-06-18,1623970800.0
10262,44,1,2021-06-19,17387,19776,2004098,1064946,2021-06-19,1624057200.0
10263,44,1,2021-06-20,3349,5248,2007447,1070194,2021-06-20,1624143600.0
10264,44,1,2021-06-21,12705,26333,2020152,1096527,2021-06-21,1624230000.0
10265,44,1,2021-06-22,12401,28005,2032553,1124532,2021-06-22,1624316400.0
10266,44,1,2021-06-23,17279,30027,2049832,1154559,2021-06-23,1624402800.0
10267,44,1,2021-06-24,13392,20097,2063224,1174656,2021-06-24,1624489200.0
10268,44,1,2021-06-25,14447,31671,2077671,1206327,2021-06-25,1624575600.0
10269,44,1,2021-06-26,11427,25637,2089098,1231964,2021-06-26,1624662000.0
10270,44,1,2021-06-27,3129,8315,2092227,1240279,2021-06-27,1624748400.0
10271,44,1,2021-06-28,9861,28812,2102088,1269091,2021-06-28,1624834800.0
10272,44,1,2021-06-29,9961,29957,2112049,1299048,2021-06-29,1624921200.0
10273,44,1,2021-06-30,12838,32929,2124887,1331977,2021-06-30,1625007600.0
10274,44,1,2021-07-01,13114,25806,2138001,1357783,2021-07-01,1625094000.0
10275,44,1,2021-07-02,13343,34450,2151344,1392233,2021-07-02,1625180400.0
10276,44,1,2021-07-03,11326,22305,2162670,1414538,2021-07-03,1625266800.0
10277,44,1,2021-07-04,2893,6946,2165563,1421484,2021-07-04,1625353200.0
10278,44,1,2021-07-05,9119,29921,2174682,1451405,2021-07-05,1625439600.0
10279,44,1,2021-07-06,11537,29742,2186219,1481147,2021-07-06,1625526000.0
10280,44,1,2021-07-07,13207,30274,2199426,1511421,2021-07-07,1625612400.0
10281,44,1,2021-07-08,13800,22574,2213226,1533995,2021-07-08,1625698800.0
10282,44,2,2020-12-27,0,0,0,0,2020-12-27,1609023600.0
10283,44,2,2020-12-28,0,0,0,0,2020-12-28,1609110000.0
10284,44,2,2020-12-29,0,0,0,0,2020-12-29,1609196400.0
10285,44,2,2020-12-30,0,0,0,0,2020-12-30,1609282800.0
10286,44,2,2020-12-31,0,0,0,0,2020-12-31,1609369200.0
10287,44,2,2021-01-01,0,0,0,0,2021-01-01,1609455600.0
10288,44,2,2021-01-02,0,0,0,0,2021-01-02,1609542000.0
10289,44,2,2021-01-03,0,0,0,0,2021-01-03,1609628400.0
10290,44,2,2021-01-04,0,0,0,0,2021-01-04,1609714800.0
10291,44,2,2021-01-05,0,0,0,0,2021-01-05,1609801200.0
10292,44,2,2021-01-06,0,0,0,0,2021-01-06,1609887600.0
10293,44,2,2021-01-07,0,0,0,0,2021-01-07,1609974000.0
10294,44,2,2021-01-08,0,0,0,0,2021-01-08,1610060400.0
10295,44,2,2021-01-09,0,0,0,0,2021-01-09,1610146800.0
10296,44,2,2021-01-10,0,0,0,0,2021-01-10,1610233200.0
10297,44,2,2021-01-11,0,0,0,0,2021-01-11,1610319600.0
10298,44,2,2021-01-12,0,0,0,0,2021-01-12,1610406000.0
10299,44,2,2021-01-13,0,0,0,0,2021-01-13,1610492400.0
10300,44,2,2021-01-14,103,0,103,0,2021-01-14,1610578800.0
10301,44,2,2021-01-15,164,0,267,0,2021-01-15,1610665200.0
10302,44,2,2021-01-16,147,0,414,0,2021-01-16,1610751600.0
10303,44,2,2021-01-17,1,0,415,0,2021-01-17,1610838000.0
10304,44,2,2021-01-18,950,0,1365,0,2021-01-18,1610924400.0
10305,44,2,2021-01-19,1269,0,2634,0,2021-01-19,1611010800.0
10306,44,2,2021-01-20,1415,0,4049,0,2021-01-20,1611097200.0
10307,44,2,2021-01-21,1507,0,5556,0,2021-01-21,1611183600.0
10308,44,2,2021-01-22,1558,0,7114,0,2021-01-22,1611270000.0
10309,44,2,2021-01-23,421,0,7535,0,2021-01-23,1611356400.0
10310,44,2,2021-01-24,54,0,7589,0,2021-01-24,1611442800.0
10311,44,2,2021-01-25,1515,0,9104,0,2021-01-25,1611529200.0
10312,44,2,2021-01-26,1299,0,10403,0,2021-01-26,1611615600.0
10313,44,2,2021-01-27,1376,0,11779,0,2021-01-27,1611702000.0
10314,44,2,2021-01-28,1585,0,13364,0,2021-01-28,1611788400.0
10315,44,2,2021-01-29,1422,0,14786,0,2021-01-29,1611874800.0
10316,44,2,2021-01-30,510,0,15296,0,2021-01-30,1611961200.0
10317,44,2,2021-01-31,0,0,15296,0,2021-01-31,1612047600.0
10318,44,2,2021-02-01,1375,0,16671,0,2021-02-01,1612134000.0
10319,44,2,2021-02-02,1423,0,18094,0,2021-02-02,1612220400.0
10320,44,2,2021-02-03,1561,0,19655,0,2021-02-03,1612306800.0
10321,44,2,2021-02-04,917,1,20572,1,2021-02-04,1612393200.0
10322,44,2,2021-02-05,833,0,21405,1,2021-02-05,1612479600.0
10323,44,2,2021-02-06,437,0,21842,1,2021-02-06,1612566000.0
10324,44,2,2021-02-07,0,0,21842,1,2021-02-07,1612652400.0
10325,44,2,2021-02-08,370,0,22212,1,2021-02-08,1612738800.0
10326,44,2,2021-02-09,218,0,22430,1,2021-02-09,1612825200.0
10327,44,2,2021-02-10,216,0,22646,1,2021-02-10,1612911600.0
10328,44,2,2021-02-11,140,46,22786,47,2021-02-11,1612998000.0
10329,44,2,2021-02-12,315,170,23101,217,2021-02-12,1613084400.0
10330,44,2,2021-02-13,62,131,23163,348,2021-02-13,1613170800.0
10331,44,2,2021-02-14,1,0,23164,348,2021-02-14,1613257200.0
10332,44,2,2021-02-15,131,1082,23295,1430,2021-02-15,1613343600.0
10333,44,2,2021-02-16,186,1136,23481,2566,2021-02-16,1613430000.0
10334,44,2,2021-02-17,169,1333,23650,3899,2021-02-17,1613516400.0
10335,44,2,2021-02-18,156,1431,23806,5330,2021-02-18,1613602800.0
10336,44,2,2021-02-19,384,1401,24190,6731,2021-02-19,1613689200.0
10337,44,2,2021-02-20,239,412,24429,7143,2021-02-20,1613775600.0
10338,44,2,2021-02-21,9,86,24438,7229,2021-02-21,1613862000.0
10339,44,2,2021-02-22,263,1523,24701,8752,2021-02-22,1613948400.0
10340,44,2,2021-02-23,121,1396,24822,10148,2021-02-23,1614034800.0
10341,44,2,2021-02-24,321,1361,25143,11509,2021-02-24,1614121200.0
10342,44,2,2021-02-25,199,1576,25342,13085,2021-02-25,1614207600.0
10343,44,2,2021-02-26,427,1376,25769,14461,2021-02-26,1614294000.0
10344,44,2,2021-02-27,181,479,25950,14940,2021-02-27,1614380400.0
10345,44,2,2021-02-28,0,27,25950,14967,2021-02-28,1614466800.0
10346,44,2,2021-03-01,178,1332,26128,16299,2021-03-01,1614553200.0
10347,44,2,2021-03-02,139,1496,26267,17795,2021-03-02,1614639600.0
10348,44,2,2021-03-03,199,1541,26466,19336,2021-03-03,1614726000.0
10349,44,2,2021-03-04,79,727,26545,20063,2021-03-04,1614812400.0
10350,44,2,2021-03-05,395,900,26940,20963,2021-03-05,1614898800.0
10351,44,2,2021-03-06,758,379,27698,21342,2021-03-06,1614985200.0
10352,44,2,2021-03-07,1143,3,28841,21345,2021-03-07,1615071600.0
10353,44,2,2021-03-08,362,361,29203,21706,2021-03-08,1615158000.0
10354,44,2,2021-03-09,948,236,30151,21942,2021-03-09,1615244400.0
10355,44,2,2021-03-10,1027,225,31178,22167,2021-03-10,1615330800.0
10356,44,2,2021-03-11,859,114,32037,22281,2021-03-11,1615417200.0
10357,44,2,2021-03-12,1064,214,33101,22495,2021-03-12,1615503600.0
10358,44,2,2021-03-13,4686,80,37787,22575,2021-03-13,1615590000.0
10359,44,2,2021-03-14,3019,7,40806,22582,2021-03-14,1615676400.0
10360,44,2,2021-03-15,981,138,41787,22720,2021-03-15,1615762800.0
10361,44,2,2021-03-16,1546,141,43333,22861,2021-03-16,1615849200.0
10362,44,2,2021-03-17,1482,135,44815,22996,2021-03-17,1615935600.0
10363,44,2,2021-03-18,2075,144,46890,23140,2021-03-18,1616022000.0
10364,44,2,2021-03-19,2691,347,49581,23487,2021-03-19,1616108400.0
10365,44,2,2021-03-20,2485,224,52066,23711,2021-03-20,1616194800.0
10366,44,2,2021-03-21,3411,2,55477,23713,2021-03-21,1616281200.0
10367,44,2,2021-03-22,1346,222,56823,23935,2021-03-22,1616367600.0
10368,44,2,2021-03-23,1764,162,58587,24097,2021-03-23,1616454000.0
10369,44,2,2021-03-24,1702,276,60289,24373,2021-03-24,1616540400.0
10370,44,2,2021-03-25,1683,176,61972,24549,2021-03-25,1616626800.0
10371,44,2,2021-03-26,2263,423,64235,24972,2021-03-26,1616713200.0
10372,44,2,2021-03-27,1318,210,65553,25182,2021-03-27,1616799600.0
10373,44,2,2021-03-28,822,1,66375,25183,2021-03-28,1616886000.0
10374,44,2,2021-03-29,1181,138,67556,25321,2021-03-29,1616972400.0
10375,44,2,2021-03-30,1733,118,69289,25439,2021-03-30,1617058800.0
10376,44,2,2021-03-31,2267,198,71556,25637,2021-03-31,1617145200.0
10377,44,2,2021-04-01,3009,206,74565,25843,2021-04-01,1617231600.0
10378,44,2,2021-04-02,2699,287,77264,26130,2021-04-02,1617318000.0
10379,44,2,2021-04-03,1847,196,79111,26326,2021-04-03,1617404400.0
10380,44,2,2021-04-04,501,180,79612,26506,2021-04-04,1617490800.0
10381,44,2,2021-04-05,632,212,80244,26718,2021-04-05,1617577200.0
10382,44,2,2021-04-06,1707,838,81951,27556,2021-04-06,1617663600.0
10383,44,2,2021-04-07,2565,1104,84516,28660,2021-04-07,1617750000.0
10384,44,2,2021-04-08,2940,1237,87456,29897,2021-04-08,1617836400.0
10385,44,2,2021-04-09,2242,1339,89698,31236,2021-04-09,1617922800.0
10386,44,2,2021-04-10,1591,3927,91289,35163,2021-04-10,1618009200.0
10387,44,2,2021-04-11,599,2842,91888,38005,2021-04-11,1618095600.0
10388,44,2,2021-04-12,1217,1421,93105,39426,2021-04-12,1618185600.0
10389,44,2,2021-04-13,925,1642,94030,41068,2021-04-13,1618272000.0
10390,44,2,2021-04-14,1298,1301,95328,42369,2021-04-14,1618358400.0
10391,44,2,2021-04-15,1536,2317,96864,44686,2021-04-15,1618444800.0
10392,44,2,2021-04-16,1765,2361,98629,47047,2021-04-16,1618531200.0
10393,44,2,2021-04-17,957,2488,99586,49535,2021-04-17,1618617600.0
10394,44,2,2021-04-18,1445,3261,101031,52796,2021-04-18,1618704000.0
10395,44,2,2021-04-19,1168,1323,102199,54119,2021-04-19,1618790400.0
10396,44,2,2021-04-20,1162,1699,103361,55818,2021-04-20,1618876800.0
10397,44,2,2021-04-21,1350,1462,104711,57280,2021-04-21,1618963200.0
10398,44,2,2021-04-22,1400,1586,106111,58866,2021-04-22,1619049600.0
10399,44,2,2021-04-23,2397,1835,108508,60701,2021-04-23,1619136000.0
10400,44,2,2021-04-24,2108,1264,110616,61965,2021-04-24,1619222400.0
10401,44,2,2021-04-25,224,801,110840,62766,2021-04-25,1619308800.0
10402,44,2,2021-04-26,1575,1138,112415,63904,2021-04-26,1619395200.0
10403,44,2,2021-04-27,2172,1918,114587,65822,2021-04-27,1619481600.0
10404,44,2,2021-04-28,1683,1966,116270,67788,2021-04-28,1619568000.0
10405,44,2,2021-04-29,2121,2707,118391,70495,2021-04-29,1619654400.0
10406,44,2,2021-04-30,2510,2243,120901,72738,2021-04-30,1619740800.0
10407,44,2,2021-05-01,828,1688,121729,74426,2021-05-01,1619827200.0
10408,44,2,2021-05-02,211,798,121940,75224,2021-05-02,1619913600.0
10409,44,2,2021-05-03,1850,1035,123790,76259,2021-05-03,1620000000.0
10410,44,2,2021-05-04,2140,1842,125930,78101,2021-05-04,1620086400.0
10411,44,2,2021-05-05,1653,2767,127583,80868,2021-05-05,1620172800.0
10412,44,2,2021-05-06,4015,3092,131598,83960,2021-05-06,1620259200.0
10413,44,2,2021-05-07,2304,2505,133902,86465,2021-05-07,1620345600.0
10414,44,2,2021-05-08,1162,1087,135064,87552,2021-05-08,1620432000.0
10415,44,2,2021-05-09,529,517,135593,88069,2021-05-09,1620518400.0
10416,44,2,2021-05-10,2643,1094,138236,89163,2021-05-10,1620604800.0
10417,44,2,2021-05-11,4435,1132,142671,90295,2021-05-11,1620691200.0
10418,44,2,2021-05-12,4616,968,147287,91263,2021-05-12,1620777600.0
10419,44,2,2021-05-13,5499,475,152786,91738,2021-05-13,1620864000.0
10420,44,2,2021-05-14,9505,796,162291,92534,2021-05-14,1620950400.0
10421,44,2,2021-05-15,7190,769,169481,93303,2021-05-15,1621036800.0
10422,44,2,2021-05-16,3116,1364,172597,94667,2021-05-16,1621123200.0
10423,44,2,2021-05-17,4185,1102,176782,95769,2021-05-17,1621206000.0
10424,44,2,2021-05-18,5906,986,182688,96755,2021-05-18,1621292400.0
10425,44,2,2021-05-19,4836,1375,187524,98130,2021-05-19,1621378800.0
10426,44,2,2021-05-20,5670,1197,193194,99327,2021-05-20,1621465200.0
10427,44,2,2021-05-21,5851,1364,199045,100691,2021-05-21,1621551600.0
10428,44,2,2021-05-22,3278,596,202323,101287,2021-05-22,1621638000.0
10429,44,2,2021-05-23,930,24,203253,101311,2021-05-23,1621724400.0
10430,44,2,2021-05-24,847,372,204100,101683,2021-05-24,1621810800.0
10431,44,2,2021-05-25,2050,1256,206150,102939,2021-05-25,1621897200.0
10432,44,2,2021-05-26,1330,945,207480,103884,2021-05-26,1621983600.0
10433,44,2,2021-05-27,1986,699,209466,104583,2021-05-27,1622070000.0
10434,44,2,2021-05-28,4020,1737,213486,106320,2021-05-28,1622156400.0
10435,44,2,2021-05-29,3848,756,217334,107076,2021-05-29,1622242800.0
10436,44,2,2021-05-30,337,58,217671,107134,2021-05-30,1622329200.0
10437,44,2,2021-05-31,3734,1896,221405,109030,2021-05-31,1622415600.0
10438,44,2,2021-06-01,4614,1302,226019,110332,2021-06-01,1622502000.0
10439,44,2,2021-06-02,3542,1425,229561,111757,2021-06-02,1622588400.0
10440,44,2,2021-06-03,4833,1750,234394,113507,2021-06-03,1622674800.0
10441,44,2,2021-06-04,6074,2056,240468,115563,2021-06-04,1622761200.0
10442,44,2,2021-06-05,4070,1888,244538,117451,2021-06-05,1622847600.0
10443,44,2,2021-06-06,530,142,245068,117593,2021-06-06,1622934000.0
10444,44,2,2021-06-07,2439,1740,247507,119333,2021-06-07,1623020400.0
10445,44,2,2021-06-08,3974,2423,251481,121756,2021-06-08,1623106800.0
10446,44,2,2021-06-09,3051,2210,254532,123966,2021-06-09,1623193200.0
10447,44,2,2021-06-10,3866,1790,258398,125756,2021-06-10,1623279600.0
10448,44,2,2021-06-11,5280,2643,263678,128399,2021-06-11,1623366000.0
10449,44,2,2021-06-12,3555,1568,267233,129967,2021-06-12,1623452400.0
10450,44,2,2021-06-13,234,171,267467,130138,2021-06-13,1623538800.0
10451,44,2,2021-06-14,2278,2044,269745,132182,2021-06-14,1623625200.0
10452,44,2,2021-06-15,2988,2427,272733,134609,2021-06-15,1623711600.0
10453,44,2,2021-06-16,2656,1557,275389,136166,2021-06-16,1623798000.0
10454,44,2,2021-06-17,3346,4071,278735,140237,2021-06-17,1623884400.0
10455,44,2,2021-06-18,4625,2260,283360,142497,2021-06-18,1623970800.0
10456,44,2,2021-06-19,2985,1515,286345,144012,2021-06-19,1624057200.0
10457,44,2,2021-06-20,221,556,286566,144568,2021-06-20,1624143600.0
10458,44,2,2021-06-21,1626,2681,288192,147249,2021-06-21,1624230000.0
10459,44,2,2021-06-22,2390,6220,290582,153469,2021-06-22,1624316400.0
10460,44,2,2021-06-23,2155,4194,292737,157663,2021-06-23,1624402800.0
10461,44,2,2021-06-24,2541,5621,295278,163284,2021-06-24,1624489200.0
10462,44,2,2021-06-25,3542,7766,298820,171050,2021-06-25,1624575600.0
10463,44,2,2021-06-26,2095,6408,300915,177458,2021-06-26,1624662000.0
10464,44,2,2021-06-27,258,2525,301173,179983,2021-06-27,1624748400.0
10465,44,2,2021-06-28,1139,4671,302312,184654,2021-06-28,1624834800.0
10466,44,2,2021-06-29,1496,5915,303808,190569,2021-06-29,1624921200.0
10467,44,2,2021-06-30,1381,4750,305189,195319,2021-06-30,1625007600.0
10468,44,2,2021-07-01,1637,5824,306826,201143,2021-07-01,1625094000.0
10469,44,2,2021-07-02,2121,6458,308947,207601,2021-07-02,1625180400.0
10470,44,2,2021-07-03,1277,3528,310224,211129,2021-07-03,1625266800.0
10471,44,2,2021-07-04,111,743,310335,211872,2021-07-04,1625353200.0
10472,44,2,2021-07-05,743,1945,311078,213817,2021-07-05,1625439600.0
10473,44,2,2021-07-06,1116,3381,312194,217198,2021-07-06,1625526000.0
10474,44,2,2021-07-07,1288,2857,313482,220055,2021-07-07,1625612400.0
10475,44,2,2021-07-08,1430,3809,314912,223864,2021-07-08,1625698800.0
10476,44,3,2020-12-27,0,0,0,0,2020-12-27,1609023600.0
10477,44,3,2020-12-28,0,0,0,0,2020-12-28,1609110000.0
10478,44,3,2020-12-29,0,0,0,0,2020-12-29,1609196400.0
10479,44,3,2020-12-30,0,0,0,0,2020-12-30,1609282800.0
10480,44,3,2020-12-31,0,0,0,0,2020-12-31,1609369200.0
10481,44,3,2021-01-01,0,0,0,0,2021-01-01,1609455600.0
10482,44,3,2021-01-02,0,0,0,0,2021-01-02,1609542000.0
10483,44,3,2021-01-03,0,0,0,0,2021-01-03,1609628400.0
10484,44,3,2021-01-04,0,0,0,0,2021-01-04,1609714800.0
10485,44,3,2021-01-05,0,0,0,0,2021-01-05,1609801200.0
10486,44,3,2021-01-06,0,0,0,0,2021-01-06,1609887600.0
10487,44,3,2021-01-07,0,0,0,0,2021-01-07,1609974000.0
10488,44,3,2021-01-08,0,0,0,0,2021-01-08,1610060400.0
10489,44,3,2021-01-09,0,0,0,0,2021-01-09,1610146800.0
10490,44,3,2021-01-10,0,0,0,0,2021-01-10,1610233200.0
10491,44,3,2021-01-11,0,0,0,0,2021-01-11,1610319600.0
10492,44,3,2021-01-12,0,0,0,0,2021-01-12,1610406000.0
10493,44,3,2021-01-13,0,0,0,0,2021-01-13,1610492400.0
10494,44,3,2021-01-14,0,0,0,0,2021-01-14,1610578800.0
10495,44,3,2021-01-15,0,0,0,0,2021-01-15,1610665200.0
10496,44,3,2021-01-16,0,0,0,0,2021-01-16,1610751600.0
10497,44,3,2021-01-17,0,0,0,0,2021-01-17,1610838000.0
10498,44,3,2021-01-18,0,0,0,0,2021-01-18,1610924400.0
10499,44,3,2021-01-19,0,0,0,0,2021-01-19,1611010800.0
10500,44,3,2021-01-20,0,0,0,0,2021-01-20,1611097200.0
10501,44,3,2021-01-21,0,0,0,0,2021-01-21,1611183600.0
10502,44,3,2021-01-22,0,0,0,0,2021-01-22,1611270000.0
10503,44,3,2021-01-23,0,0,0,0,2021-01-23,1611356400.0
10504,44,3,2021-01-24,0,0,0,0,2021-01-24,1611442800.0
10505,44,3,2021-01-25,0,0,0,0,2021-01-25,1611529200.0
10506,44,3,2021-01-26,0,0,0,0,2021-01-26,1611615600.0
10507,44,3,2021-01-27,0,0,0,0,2021-01-27,1611702000.0
10508,44,3,2021-01-28,0,0,0,0,2021-01-28,1611788400.0
10509,44,3,2021-01-29,0,0,0,0,2021-01-29,1611874800.0
10510,44,3,2021-01-30,0,0,0,0,2021-01-30,1611961200.0
10511,44,3,2021-01-31,0,0,0,0,2021-01-31,1612047600.0
10512,44,3,2021-02-01,0,0,0,0,2021-02-01,1612134000.0
10513,44,3,2021-02-02,0,0,0,0,2021-02-02,1612220400.0
10514,44,3,2021-02-03,0,0,0,0,2021-02-03,1612306800.0
10515,44,3,2021-02-04,0,0,0,0,2021-02-04,1612393200.0
10516,44,3,2021-02-05,0,0,0,0,2021-02-05,1612479600.0
10517,44,3,2021-02-06,13,0,13,0,2021-02-06,1612566000.0
10518,44,3,2021-02-07,0,0,13,0,2021-02-07,1612652400.0
10519,44,3,2021-02-08,300,0,313,0,2021-02-08,1612738800.0
10520,44,3,2021-02-09,928,0,1241,0,2021-02-09,1612825200.0
10521,44,3,2021-02-10,1211,0,2452,0,2021-02-10,1612911600.0
10522,44,3,2021-02-11,1471,0,3923,0,2021-02-11,1612998000.0
10523,44,3,2021-02-12,1684,0,5607,0,2021-02-12,1613084400.0
10524,44,3,2021-02-13,269,0,5876,0,2021-02-13,1613170800.0
10525,44,3,2021-02-14,4,0,5880,0,2021-02-14,1613257200.0
10526,44,3,2021-02-15,1194,0,7074,0,2021-02-15,1613343600.0
10527,44,3,2021-02-16,1280,0,8354,0,2021-02-16,1613430000.0
10528,44,3,2021-02-17,1306,0,9660,0,2021-02-17,1613516400.0
10529,44,3,2021-02-18,1652,0,11312,0,2021-02-18,1613602800.0
10530,44,3,2021-02-19,1345,0,12657,0,2021-02-19,1613689200.0
10531,44,3,2021-02-20,219,0,12876,0,2021-02-20,1613775600.0
10532,44,3,2021-02-21,3,0,12879,0,2021-02-21,1613862000.0
10533,44,3,2021-02-22,833,0,13712,0,2021-02-22,1613948400.0
10534,44,3,2021-02-23,958,0,14670,0,2021-02-23,1614034800.0
10535,44,3,2021-02-24,1636,0,16306,0,2021-02-24,1614121200.0
10536,44,3,2021-02-25,4868,0,21174,0,2021-02-25,1614207600.0
10537,44,3,2021-02-26,7275,0,28449,0,2021-02-26,1614294000.0
10538,44,3,2021-02-27,4087,1,32536,1,2021-02-27,1614380400.0
10539,44,3,2021-02-28,152,0,32688,1,2021-02-28,1614466800.0
10540,44,3,2021-03-01,1558,0,34246,1,2021-03-01,1614553200.0
10541,44,3,2021-03-02,2826,0,37072,1,2021-03-02,1614639600.0
10542,44,3,2021-03-03,4533,1,41605,2,2021-03-03,1614726000.0
10543,44,3,2021-03-04,6538,0,48143,2,2021-03-04,1614812400.0
10544,44,3,2021-03-05,10275,6,58418,8,2021-03-05,1614898800.0
10545,44,3,2021-03-06,12700,1,71118,9,2021-03-06,1614985200.0
10546,44,3,2021-03-07,5708,5,76826,14,2021-03-07,1615071600.0
10547,44,3,2021-03-08,3312,1,80138,15,2021-03-08,1615158000.0
10548,44,3,2021-03-09,6200,4,86338,19,2021-03-09,1615244400.0
10549,44,3,2021-03-10,6937,2,93275,21,2021-03-10,1615330800.0
10550,44,3,2021-03-11,9439,3,102714,24,2021-03-11,1615417200.0
10551,44,3,2021-03-12,16196,7,118910,31,2021-03-12,1615503600.0
10552,44,3,2021-03-13,14249,7,133159,38,2021-03-13,1615590000.0
10553,44,3,2021-03-14,1456,0,134615,38,2021-03-14,1615676400.0
10554,44,3,2021-03-15,3562,3,138177,41,2021-03-15,1615762800.0
10555,44,3,2021-03-16,110,1,138287,42,2021-03-16,1615849200.0
10556,44,3,2021-03-17,48,1,138335,43,2021-03-17,1615935600.0
10557,44,3,2021-03-18,102,0,138437,43,2021-03-18,1616022000.0
10558,44,3,2021-03-19,6208,2,144645,45,2021-03-19,1616108400.0
10559,44,3,2021-03-20,6861,3,151506,48,2021-03-20,1616194800.0
10560,44,3,2021-03-21,485,0,151991,48,2021-03-21,1616281200.0
10561,44,3,2021-03-22,2466,1,154457,49,2021-03-22,1616367600.0
10562,44,3,2021-03-23,5953,1,160410,50,2021-03-23,1616454000.0
10563,44,3,2021-03-24,8124,17,168534,67,2021-03-24,1616540400.0
10564,44,3,2021-03-25,13351,10,181885,77,2021-03-25,1616626800.0
10565,44,3,2021-03-26,14666,5,196551,82,2021-03-26,1616713200.0
10566,44,3,2021-03-27,7794,17,204345,99,2021-03-27,1616799600.0
10567,44,3,2021-03-28,357,0,204702,99,2021-03-28,1616886000.0
10568,44,3,2021-03-29,4209,7,208911,106,2021-03-29,1616972400.0
10569,44,3,2021-03-30,7897,4,216808,110,2021-03-30,1617058800.0
10570,44,3,2021-03-31,5877,4,222685,114,2021-03-31,1617145200.0
10571,44,3,2021-04-01,6836,2,229521,116,2021-04-01,1617231600.0
10572,44,3,2021-04-02,4812,7,234333,123,2021-04-02,1617318000.0
10573,44,3,2021-04-03,2618,13,236951,136,2021-04-03,1617404400.0
10574,44,3,2021-04-04,84,0,237035,136,2021-04-04,1617490800.0
10575,44,3,2021-04-05,258,0,237293,136,2021-04-05,1617577200.0
10576,44,3,2021-04-06,1951,4,239244,140,2021-04-06,1617663600.0
10577,44,3,2021-04-07,2807,11,242051,151,2021-04-07,1617750000.0
10578,44,3,2021-04-08,7265,33,249316,184,2021-04-08,1617836400.0
10579,44,3,2021-04-09,14331,24,263647,208,2021-04-09,1617922800.0
10580,44,3,2021-04-10,7393,17,271040,225,2021-04-10,1618009200.0
10581,44,3,2021-04-11,494,6,271534,231,2021-04-11,1618095600.0
10582,44,3,2021-04-12,3896,17,275430,248,2021-04-12,1618185600.0
10583,44,3,2021-04-13,5980,16,281410,264,2021-04-13,1618272000.0
10584,44,3,2021-04-14,5248,33,286658,297,2021-04-14,1618358400.0
10585,44,3,2021-04-15,6815,33,293473,330,2021-04-15,1618444800.0
10586,44,3,2021-04-16,9239,55,302712,385,2021-04-16,1618531200.0
10587,44,3,2021-04-17,5225,30,307937,415,2021-04-17,1618617600.0
10588,44,3,2021-04-18,1375,5,309312,420,2021-04-18,1618704000.0
10589,44,3,2021-04-19,1793,27,311105,447,2021-04-19,1618790400.0
10590,44,3,2021-04-20,3296,38,314401,485,2021-04-20,1618876800.0
10591,44,3,2021-04-21,2962,66,317363,551,2021-04-21,1618963200.0
10592,44,3,2021-04-22,4697,59,322060,610,2021-04-22,1619049600.0
10593,44,3,2021-04-23,6645,95,328705,705,2021-04-23,1619136000.0
10594,44,3,2021-04-24,3405,124,332110,829,2021-04-24,1619222400.0
10595,44,3,2021-04-25,482,1,332592,830,2021-04-25,1619308800.0
10596,44,3,2021-04-26,1604,60,334196,890,2021-04-26,1619395200.0
10597,44,3,2021-04-27,2002,99,336198,989,2021-04-27,1619481600.0
10598,44,3,2021-04-28,2244,223,338442,1212,2021-04-28,1619568000.0
10599,44,3,2021-04-29,3521,736,341963,1948,2021-04-29,1619654400.0
10600,44,3,2021-04-30,4845,869,346808,2817,2021-04-30,1619740800.0
10601,44,3,2021-05-01,600,263,347408,3080,2021-05-01,1619827200.0
10602,44,3,2021-05-02,151,28,347559,3108,2021-05-02,1619913600.0
10603,44,3,2021-05-03,945,348,348504,3456,2021-05-03,1620000000.0
10604,44,3,2021-05-04,1545,667,350049,4123,2021-05-04,1620086400.0
10605,44,3,2021-05-05,1486,1036,351535,5159,2021-05-05,1620172800.0
10606,44,3,2021-05-06,2750,2033,354285,7192,2021-05-06,1620259200.0
10607,44,3,2021-05-07,3534,3254,357819,10446,2021-05-07,1620345600.0
10608,44,3,2021-05-08,809,1035,358628,11481,2021-05-08,1620432000.0
10609,44,3,2021-05-09,182,223,358810,11704,2021-05-09,1620518400.0
10610,44,3,2021-05-10,1103,1053,359913,12757,2021-05-10,1620604800.0
10611,44,3,2021-05-11,1847,2057,361760,14814,2021-05-11,1620691200.0
10612,44,3,2021-05-12,1491,3006,363251,17820,2021-05-12,1620777600.0
10613,44,3,2021-05-13,198,472,363449,18292,2021-05-13,1620864000.0
10614,44,3,2021-05-14,1473,3570,364922,21862,2021-05-14,1620950400.0
10615,44,3,2021-05-15,813,2936,365735,24798,2021-05-15,1621036800.0
10616,44,3,2021-05-16,62,390,365797,25188,2021-05-16,1621123200.0
10617,44,3,2021-05-17,637,1511,366434,26699,2021-05-17,1621206000.0
10618,44,3,2021-05-18,920,2260,367354,28959,2021-05-18,1621292400.0
10619,44,3,2021-05-19,702,2718,368056,31677,2021-05-19,1621378800.0
10620,44,3,2021-05-20,804,4486,368860,36163,2021-05-20,1621465200.0
10621,44,3,2021-05-21,1131,6607,369991,42770,2021-05-21,1621551600.0
10622,44,3,2021-05-22,532,4152,370523,46922,2021-05-22,1621638000.0
10623,44,3,2021-05-23,57,190,370580,47112,2021-05-23,1621724400.0
10624,44,3,2021-05-24,19,393,370599,47505,2021-05-24,1621810800.0
10625,44,3,2021-05-25,347,2806,370946,50311,2021-05-25,1621897200.0
10626,44,3,2021-05-26,385,4594,371331,54905,2021-05-26,1621983600.0
10627,44,3,2021-05-27,420,6400,371751,61305,2021-05-27,1622070000.0
10628,44,3,2021-05-28,666,8680,372417,69985,2021-05-28,1622156400.0
10629,44,3,2021-05-29,329,7442,372746,77427,2021-05-29,1622242800.0
10630,44,3,2021-05-30,37,1793,372783,79220,2021-05-30,1622329200.0
10631,44,3,2021-05-31,188,2888,372971,82108,2021-05-31,1622415600.0
10632,44,3,2021-06-01,214,5064,373185,87172,2021-06-01,1622502000.0
10633,44,3,2021-06-02,157,5608,373342,92780,2021-06-02,1622588400.0
10634,44,3,2021-06-03,231,7462,373573,100242,2021-06-03,1622674800.0
10635,44,3,2021-06-04,360,9345,373933,109587,2021-06-04,1622761200.0
10636,44,3,2021-06-05,213,6127,374146,115714,2021-06-05,1622847600.0
10637,44,3,2021-06-06,17,458,374163,116172,2021-06-06,1622934000.0
10638,44,3,2021-06-07,86,2109,374249,118281,2021-06-07,1623020400.0
10639,44,3,2021-06-08,97,3491,374346,121772,2021-06-08,1623106800.0
10640,44,3,2021-06-09,89,3188,374435,124960,2021-06-09,1623193200.0
10641,44,3,2021-06-10,151,5473,374586,130433,2021-06-10,1623279600.0
10642,44,3,2021-06-11,197,8184,374783,138617,2021-06-11,1623366000.0
10643,44,3,2021-06-12,127,4815,374910,143432,2021-06-12,1623452400.0
10644,44,3,2021-06-13,5,224,374915,143656,2021-06-13,1623538800.0
10645,44,3,2021-06-14,58,3145,374973,146801,2021-06-14,1623625200.0
10646,44,3,2021-06-15,78,6036,375051,152837,2021-06-15,1623711600.0
10647,44,3,2021-06-16,71,5849,375122,158686,2021-06-16,1623798000.0
10648,44,3,2021-06-17,98,8541,375220,167227,2021-06-17,1623884400.0
10649,44,3,2021-06-18,148,9921,375368,177148,2021-06-18,1623970800.0
10650,44,3,2021-06-19,36,4439,375404,181587,2021-06-19,1624057200.0
10651,44,3,2021-06-20,1,266,375405,181853,2021-06-20,1624143600.0
10652,44,3,2021-06-21,34,3169,375439,185022,2021-06-21,1624230000.0
10653,44,3,2021-06-22,50,5078,375489,190100,2021-06-22,1624316400.0
10654,44,3,2021-06-23,50,4325,375539,194425,2021-06-23,1624402800.0
10655,44,3,2021-06-24,85,6064,375624,200489,2021-06-24,1624489200.0
10656,44,3,2021-06-25,87,7030,375711,207519,2021-06-25,1624575600.0
10657,44,3,2021-06-26,66,3229,375777,210748,2021-06-26,1624662000.0
10658,44,3,2021-06-27,2,258,375779,211006,2021-06-27,1624748400.0
10659,44,3,2021-06-28,41,2148,375820,213154,2021-06-28,1624834800.0
10660,44,3,2021-06-29,44,4082,375864,217236,2021-06-29,1624921200.0
10661,44,3,2021-06-30,67,3444,375931,220680,2021-06-30,1625007600.0
10662,44,3,2021-07-01,75,5038,376006,225718,2021-07-01,1625094000.0
10663,44,3,2021-07-02,110,7486,376116,233204,2021-07-02,1625180400.0
10664,44,3,2021-07-03,49,3146,376165,236350,2021-07-03,1625266800.0
10665,44,3,2021-07-04,15,529,376180,236879,2021-07-04,1625353200.0
10666,44,3,2021-07-05,37,2822,376217,239701,2021-07-05,1625439600.0
10667,44,3,2021-07-06,49,3747,376266,243448,2021-07-06,1625526000.0
10668,44,3,2021-07-07,47,3695,376313,247143,2021-07-07,1625612400.0
10669,44,3,2021-07-08,72,4797,376385,251940,2021-07-08,1625698800.0
10670,44,4,2020-12-27,0,0,0,0,2020-12-27,1609023600.0
10671,44,4,2020-12-28,0,0,0,0,2020-12-28,1609110000.0
10672,44,4,2020-12-29,0,0,0,0,2020-12-29,1609196400.0
10673,44,4,2020-12-30,0,0,0,0,2020-12-30,1609282800.0
10674,44,4,2020-12-31,0,0,0,0,2020-12-31,1609369200.0
10675,44,4,2021-01-01,0,0,0,0,2021-01-01,1609455600.0
10676,44,4,2021-01-02,0,0,0,0,2021-01-02,1609542000.0
10677,44,4,2021-01-03,0,0,0,0,2021-01-03,1609628400.0
10678,44,4,2021-01-04,0,0,0,0,2021-01-04,1609714800.0
10679,44,4,2021-01-05,0,0,0,0,2021-01-05,1609801200.0
10680,44,4,2021-01-06,0,0,0,0,2021-01-06,1609887600.0
10681,44,4,2021-01-07,0,0,0,0,2021-01-07,1609974000.0
10682,44,4,2021-01-08,0,0,0,0,2021-01-08,1610060400.0
10683,44,4,2021-01-09,0,0,0,0,2021-01-09,1610146800.0
10684,44,4,2021-01-10,0,0,0,0,2021-01-10,1610233200.0
10685,44,4,2021-01-11,0,0,0,0,2021-01-11,1610319600.0
10686,44,4,2021-01-12,0,0,0,0,2021-01-12,1610406000.0
10687,44,4,2021-01-13,0,0,0,0,2021-01-13,1610492400.0
10688,44,4,2021-01-14,0,0,0,0,2021-01-14,1610578800.0
10689,44,4,2021-01-15,0,0,0,0,2021-01-15,1610665200.0
10690,44,4,2021-01-16,0,0,0,0,2021-01-16,1610751600.0
10691,44,4,2021-01-17,0,0,0,0,2021-01-17,1610838000.0
10692,44,4,2021-01-18,0,0,0,0,2021-01-18,1610924400.0
10693,44,4,2021-01-19,0,0,0,0,2021-01-19,1611010800.0
10694,44,4,2021-01-20,0,0,0,0,2021-01-20,1611097200.0
10695,44,4,2021-01-21,0,0,0,0,2021-01-21,1611183600.0
10696,44,4,2021-01-22,0,0,0,0,2021-01-22,1611270000.0
10697,44,4,2021-01-23,0,0,0,0,2021-01-23,1611356400.0
10698,44,4,2021-01-24,0,0,0,0,2021-01-24,1611442800.0
10699,44,4,2021-01-25,0,0,0,0,2021-01-25,1611529200.0
10700,44,4,2021-01-26,0,0,0,0,2021-01-26,1611615600.0
10701,44,4,2021-01-27,0,0,0,0,2021-01-27,1611702000.0
10702,44,4,2021-01-28,0,0,0,0,2021-01-28,1611788400.0
10703,44,4,2021-01-29,0,0,0,0,2021-01-29,1611874800.0
10704,44,4,2021-01-30,0,0,0,0,2021-01-30,1611961200.0
10705,44,4,2021-01-31,0,0,0,0,2021-01-31,1612047600.0
10706,44,4,2021-02-01,0,0,0,0,2021-02-01,1612134000.0
10707,44,4,2021-02-02,0,0,0,0,2021-02-02,1612220400.0
10708,44,4,2021-02-03,0,0,0,0,2021-02-03,1612306800.0
10709,44,4,2021-02-04,0,0,0,0,2021-02-04,1612393200.0
10710,44,4,2021-02-05,0,0,0,0,2021-02-05,1612479600.0
10711,44,4,2021-02-06,0,0,0,0,2021-02-06,1612566000.0
10712,44,4,2021-02-07,0,0,0,0,2021-02-07,1612652400.0
10713,44,4,2021-02-08,0,0,0,0,2021-02-08,1612738800.0
10714,44,4,2021-02-09,0,0,0,0,2021-02-09,1612825200.0
10715,44,4,2021-02-10,0,0,0,0,2021-02-10,1612911600.0
10716,44,4,2021-02-11,0,0,0,0,2021-02-11,1612998000.0
10717,44,4,2021-02-12,0,0,0,0,2021-02-12,1613084400.0
10718,44,4,2021-02-13,0,0,0,0,2021-02-13,1613170800.0
10719,44,4,2021-02-14,0,0,0,0,2021-02-14,1613257200.0
10720,44,4,2021-02-15,0,0,0,0,2021-02-15,1613343600.0
10721,44,4,2021-02-16,0,0,0,0,2021-02-16,1613430000.0
10722,44,4,2021-02-17,0,0,0,0,2021-02-17,1613516400.0
10723,44,4,2021-02-18,0,0,0,0,2021-02-18,1613602800.0
10724,44,4,2021-02-19,0,0,0,0,2021-02-19,1613689200.0
10725,44,4,2021-02-20,0,0,0,0,2021-02-20,1613775600.0
10726,44,4,2021-02-21,0,0,0,0,2021-02-21,1613862000.0
10727,44,4,2021-02-22,0,0,0,0,2021-02-22,1613948400.0
10728,44,4,2021-02-23,0,0,0,0,2021-02-23,1614034800.0
10729,44,4,2021-02-24,0,0,0,0,2021-02-24,1614121200.0
10730,44,4,2021-02-25,0,0,0,0,2021-02-25,1614207600.0
10731,44,4,2021-02-26,0,0,0,0,2021-02-26,1614294000.0
10732,44,4,2021-02-27,0,0,0,0,2021-02-27,1614380400.0
10733,44,4,2021-02-28,0,0,0,0,2021-02-28,1614466800.0
10734,44,4,2021-03-01,0,0,0,0,2021-03-01,1614553200.0
10735,44,4,2021-03-02,0,0,0,0,2021-03-02,1614639600.0
10736,44,4,2021-03-03,0,0,0,0,2021-03-03,1614726000.0
10737,44,4,2021-03-04,0,0,0,0,2021-03-04,1614812400.0
10738,44,4,2021-03-05,0,0,0,0,2021-03-05,1614898800.0
10739,44,4,2021-03-06,0,0,0,0,2021-03-06,1614985200.0
10740,44,4,2021-03-07,0,0,0,0,2021-03-07,1615071600.0
10741,44,4,2021-03-08,0,0,0,0,2021-03-08,1615158000.0
10742,44,4,2021-03-09,0,0,0,0,2021-03-09,1615244400.0
10743,44,4,2021-03-10,0,0,0,0,2021-03-10,1615330800.0
10744,44,4,2021-03-11,0,0,0,0,2021-03-11,1615417200.0
10745,44,4,2021-03-12,0,0,0,0,2021-03-12,1615503600.0
10746,44,4,2021-03-13,0,0,0,0,2021-03-13,1615590000.0
10747,44,4,2021-03-14,0,0,0,0,2021-03-14,1615676400.0
10748,44,4,2021-03-15,0,0,0,0,2021-03-15,1615762800.0
10749,44,4,2021-03-16,0,0,0,0,2021-03-16,1615849200.0
10750,44,4,2021-03-17,0,0,0,0,2021-03-17,1615935600.0
10751,44,4,2021-03-18,0,0,0,0,2021-03-18,1616022000.0
10752,44,4,2021-03-19,0,0,0,0,2021-03-19,1616108400.0
10753,44,4,2021-03-20,0,0,0,0,2021-03-20,1616194800.0
10754,44,4,2021-03-21,0,0,0,0,2021-03-21,1616281200.0
10755,44,4,2021-03-22,0,0,0,0,2021-03-22,1616367600.0
10756,44,4,2021-03-23,0,0,0,0,2021-03-23,1616454000.0
10757,44,4,2021-03-24,0,0,0,0,2021-03-24,1616540400.0
10758,44,4,2021-03-25,0,0,0,0,2021-03-25,1616626800.0
10759,44,4,2021-03-26,0,0,0,0,2021-03-26,1616713200.0
10760,44,4,2021-03-27,0,0,0,0,2021-03-27,1616799600.0
10761,44,4,2021-03-28,0,0,0,0,2021-03-28,1616886000.0
10762,44,4,2021-03-29,0,0,0,0,2021-03-29,1616972400.0
10763,44,4,2021-03-30,0,0,0,0,2021-03-30,1617058800.0
10764,44,4,2021-03-31,0,0,0,0,2021-03-31,1617145200.0
10765,44,4,2021-04-01,0,0,0,0,2021-04-01,1617231600.0
10766,44,4,2021-04-02,0,0,0,0,2021-04-02,1617318000.0
10767,44,4,2021-04-03,0,0,0,0,2021-04-03,1617404400.0
10768,44,4,2021-04-04,0,0,0,0,2021-04-04,1617490800.0
10769,44,4,2021-04-05,0,0,0,0,2021-04-05,1617577200.0
10770,44,4,2021-04-06,0,0,0,0,2021-04-06,1617663600.0
10771,44,4,2021-04-07,0,0,0,0,2021-04-07,1617750000.0
10772,44,4,2021-04-08,0,0,0,0,2021-04-08,1617836400.0
10773,44,4,2021-04-09,0,1,0,1,2021-04-09,1617922800.0
10774,44,4,2021-04-10,0,0,0,1,2021-04-10,1618009200.0
10775,44,4,2021-04-11,0,0,0,1,2021-04-11,1618095600.0
10776,44,4,2021-04-12,0,0,0,1,2021-04-12,1618185600.0
10777,44,4,2021-04-13,0,0,0,1,2021-04-13,1618272000.0
10778,44,4,2021-04-14,0,0,0,1,2021-04-14,1618358400.0
10779,44,4,2021-04-15,0,0,0,1,2021-04-15,1618444800.0
10780,44,4,2021-04-16,0,0,0,1,2021-04-16,1618531200.0
10781,44,4,2021-04-17,0,0,0,1,2021-04-17,1618617600.0
10782,44,4,2021-04-18,0,0,0,1,2021-04-18,1618704000.0
10783,44,4,2021-04-19,0,0,0,1,2021-04-19,1618790400.0
10784,44,4,2021-04-20,0,0,0,1,2021-04-20,1618876800.0
10785,44,4,2021-04-21,0,0,0,1,2021-04-21,1618963200.0
10786,44,4,2021-04-22,0,0,0,1,2021-04-22,1619049600.0
10787,44,4,2021-04-23,34,0,34,1,2021-04-23,1619136000.0
10788,44,4,2021-04-24,5,0,39,1,2021-04-24,1619222400.0
10789,44,4,2021-04-25,0,0,39,1,2021-04-25,1619308800.0
10790,44,4,2021-04-26,49,0,88,1,2021-04-26,1619395200.0
10791,44,4,2021-04-27,577,1,665,2,2021-04-27,1619481600.0
10792,44,4,2021-04-28,804,0,1469,2,2021-04-28,1619568000.0
10793,44,4,2021-04-29,1400,0,2869,2,2021-04-29,1619654400.0
10794,44,4,2021-04-30,1954,1,4823,3,2021-04-30,1619740800.0
10795,44,4,2021-05-01,229,1,5052,4,2021-05-01,1619827200.0
10796,44,4,2021-05-02,64,0,5116,4,2021-05-02,1619913600.0
10797,44,4,2021-05-03,549,0,5665,4,2021-05-03,1620000000.0
10798,44,4,2021-05-04,725,1,6390,5,2021-05-04,1620086400.0
10799,44,4,2021-05-05,562,1,6952,6,2021-05-05,1620172800.0
10800,44,4,2021-05-06,1125,1,8077,7,2021-05-06,1620259200.0
10801,44,4,2021-05-07,1884,1,9961,8,2021-05-07,1620345600.0
10802,44,4,2021-05-08,272,1,10233,9,2021-05-08,1620432000.0
10803,44,4,2021-05-09,38,0,10271,9,2021-05-09,1620518400.0
10804,44,4,2021-05-10,651,0,10922,9,2021-05-10,1620604800.0
10805,44,4,2021-05-11,944,0,11866,9,2021-05-11,1620691200.0
10806,44,4,2021-05-12,963,2,12829,11,2021-05-12,1620777600.0
10807,44,4,2021-05-13,165,0,12994,11,2021-05-13,1620864000.0
10808,44,4,2021-05-14,754,0,13748,11,2021-05-14,1620950400.0
10809,44,4,2021-05-15,488,2,14236,13,2021-05-15,1621036800.0
10810,44,4,2021-05-16,41,0,14277,13,2021-05-16,1621123200.0
10811,44,4,2021-05-17,366,0,14643,13,2021-05-17,1621206000.0
10812,44,4,2021-05-18,631,2,15274,15,2021-05-18,1621292400.0
10813,44,4,2021-05-19,507,0,15781,15,2021-05-19,1621378800.0
10814,44,4,2021-05-20,889,0,16670,15,2021-05-20,1621465200.0
10815,44,4,2021-05-21,1211,4,17881,19,2021-05-21,1621551600.0
10816,44,4,2021-05-22,560,2,18441,21,2021-05-22,1621638000.0
10817,44,4,2021-05-23,60,0,18501,21,2021-05-23,1621724400.0
10818,44,4,2021-05-24,44,0,18545,21,2021-05-24,1621810800.0
10819,44,4,2021-05-25,641,4,19186,25,2021-05-25,1621897200.0
10820,44,4,2021-05-26,630,2,19816,27,2021-05-26,1621983600.0
10821,44,4,2021-05-27,1436,3,21252,30,2021-05-27,1622070000.0
10822,44,4,2021-05-28,2552,5,23804,35,2021-05-28,1622156400.0
10823,44,4,2021-05-29,1471,1,25275,36,2021-05-29,1622242800.0
10824,44,4,2021-05-30,105,0,25380,36,2021-05-30,1622329200.0
10825,44,4,2021-05-31,1100,1,26480,37,2021-05-31,1622415600.0
10826,44,4,2021-06-01,1600,4,28080,41,2021-06-01,1622502000.0
10827,44,4,2021-06-02,1266,2,29346,43,2021-06-02,1622588400.0
10828,44,4,2021-06-03,1577,2,30923,45,2021-06-03,1622674800.0
10829,44,4,2021-06-04,1824,1,32747,46,2021-06-04,1622761200.0
10830,44,4,2021-06-05,1075,8,33822,54,2021-06-05,1622847600.0
10831,44,4,2021-06-06,95,0,33917,54,2021-06-06,1622934000.0
10832,44,4,2021-06-07,589,0,34506,54,2021-06-07,1623020400.0
10833,44,4,2021-06-08,1091,2,35597,56,2021-06-08,1623106800.0
10834,44,4,2021-06-09,956,0,36553,56,2021-06-09,1623193200.0
10835,44,4,2021-06-10,1137,1,37690,57,2021-06-10,1623279600.0
10836,44,4,2021-06-11,1342,1,39032,58,2021-06-11,1623366000.0
10837,44,4,2021-06-12,856,8,39888,66,2021-06-12,1623452400.0
10838,44,4,2021-06-13,50,1,39938,67,2021-06-13,1623538800.0
10839,44,4,2021-06-14,571,0,40509,67,2021-06-14,1623625200.0
10840,44,4,2021-06-15,795,2,41304,69,2021-06-15,1623711600.0
10841,44,4,2021-06-16,647,2,41951,71,2021-06-16,1623798000.0
10842,44,4,2021-06-17,765,2,42716,73,2021-06-17,1623884400.0
10843,44,4,2021-06-18,1030,2,43746,75,2021-06-18,1623970800.0
10844,44,4,2021-06-19,613,2,44359,77,2021-06-19,1624057200.0
10845,44,4,2021-06-20,101,0,44460,77,2021-06-20,1624143600.0
10846,44,4,2021-06-21,418,1,44878,78,2021-06-21,1624230000.0
10847,44,4,2021-06-22,592,0,45470,78,2021-06-22,1624316400.0
10848,44,4,2021-06-23,589,1,46059,79,2021-06-23,1624402800.0
10849,44,4,2021-06-24,518,2,46577,81,2021-06-24,1624489200.0
10850,44,4,2021-06-25,819,6,47396,87,2021-06-25,1624575600.0
10851,44,4,2021-06-26,558,2,47954,89,2021-06-26,1624662000.0
10852,44,4,2021-06-27,29,0,47983,89,2021-06-27,1624748400.0
10853,44,4,2021-06-28,338,2,48321,91,2021-06-28,1624834800.0
10854,44,4,2021-06-29,388,0,48709,91,2021-06-29,1624921200.0
10855,44,4,2021-06-30,388,0,49097,91,2021-06-30,1625007600.0
10856,44,4,2021-07-01,554,3,49651,94,2021-07-01,1625094000.0
10857,44,4,2021-07-02,756,1,50407,95,2021-07-02,1625180400.0
10858,44,4,2021-07-03,505,0,50912,95,2021-07-03,1625266800.0
10859,44,4,2021-07-04,69,0,50981,95,2021-07-04,1625353200.0
10860,44,4,2021-07-05,358,0,51339,95,2021-07-05,1625439600.0
10861,44,4,2021-07-06,561,0,51900,95,2021-07-06,1625526000.0
10862,44,4,2021-07-07,462,7,52362,102,2021-07-07,1625612400.0
10863,44,4,2021-07-08,600,1,52962,103,2021-07-08,1625698800.0
10864,52,1,2020-12-27,0,0,0,0,2020-12-27,1609023600.0
10865,52,1,2020-12-28,2,0,2,0,2020-12-28,1609110000.0
10866,52,1,2020-12-29,0,0,2,0,2020-12-29,1609196400.0
10867,52,1,2020-12-30,0,0,2,0,2020-12-30,1609282800.0
10868,52,1,2020-12-31,0,0,2,0,2020-12-31,1609369200.0
10869,52,1,2021-01-01,5,0,7,0,2021-01-01,1609455600.0
10870,52,1,2021-01-02,1,0,8,0,2021-01-02,1609542000.0
10871,52,1,2021-01-03,1,0,9,0,2021-01-03,1609628400.0
10872,52,1,2021-01-04,34,0,43,0,2021-01-04,1609714800.0
10873,52,1,2021-01-05,168,0,211,0,2021-01-05,1609801200.0
10874,52,1,2021-01-06,384,0,595,0,2021-01-06,1609887600.0
10875,52,1,2021-01-07,964,0,1559,0,2021-01-07,1609974000.0
10876,52,1,2021-01-08,1664,0,3223,0,2021-01-08,1610060400.0
10877,52,1,2021-01-09,1049,0,4272,0,2021-01-09,1610146800.0
10878,52,1,2021-01-10,643,0,4915,0,2021-01-10,1610233200.0
10879,52,1,2021-01-11,2197,0,7112,0,2021-01-11,1610319600.0
10880,52,1,2021-01-12,3170,0,10282,0,2021-01-12,1610406000.0
10881,52,1,2021-01-13,2983,0,13265,0,2021-01-13,1610492400.0
10882,52,1,2021-01-14,3304,0,16569,0,2021-01-14,1610578800.0
10883,52,1,2021-01-15,3016,0,19585,0,2021-01-15,1610665200.0
10884,52,1,2021-01-16,896,3,20481,3,2021-01-16,1610751600.0
10885,52,1,2021-01-17,499,3,20980,6,2021-01-17,1610838000.0
10886,52,1,2021-01-18,3197,5,24177,11,2021-01-18,1610924400.0
10887,52,1,2021-01-19,6555,4,30732,15,2021-01-19,1611010800.0
10888,52,1,2021-01-20,8342,6,39074,21,2021-01-20,1611097200.0
10889,52,1,2021-01-21,12173,3,51247,24,2021-01-21,1611183600.0
10890,52,1,2021-01-22,7273,21,58520,45,2021-01-22,1611270000.0
10891,52,1,2021-01-23,1678,3,60198,48,2021-01-23,1611356400.0
10892,52,1,2021-01-24,174,0,60372,48,2021-01-24,1611442800.0
10893,52,1,2021-01-25,3006,9,63378,57,2021-01-25,1611529200.0
10894,52,1,2021-01-26,6738,148,70116,205,2021-01-26,1611615600.0
10895,52,1,2021-01-27,7283,143,77399,348,2021-01-27,1611702000.0
10896,52,1,2021-01-28,9728,456,87127,804,2021-01-28,1611788400.0
10897,52,1,2021-01-29,5956,903,93083,1707,2021-01-29,1611874800.0
10898,52,1,2021-01-30,1259,271,94342,1978,2021-01-30,1611961200.0
10899,52,1,2021-01-31,79,314,94421,2292,2021-01-31,1612047600.0
10900,52,1,2021-02-01,2523,1189,96944,3481,2021-02-01,1612134000.0
10901,52,1,2021-02-02,2967,1857,99911,5338,2021-02-02,1612220400.0
10902,52,1,2021-02-03,2680,2159,102591,7497,2021-02-03,1612306800.0
10903,52,1,2021-02-04,2963,2110,105554,9607,2021-02-04,1612393200.0
10904,52,1,2021-02-05,2964,2203,108518,11810,2021-02-05,1612479600.0
10905,52,1,2021-02-06,1071,661,109589,12471,2021-02-06,1612566000.0
10906,52,1,2021-02-07,10,294,109599,12765,2021-02-07,1612652400.0
10907,52,1,2021-02-08,1756,2106,111355,14871,2021-02-08,1612738800.0
10908,52,1,2021-02-09,2788,3698,114143,18569,2021-02-09,1612825200.0
10909,52,1,2021-02-10,2905,4746,117048,23315,2021-02-10,1612911600.0
10910,52,1,2021-02-11,5059,9257,122107,32572,2021-02-11,1612998000.0
10911,52,1,2021-02-12,4051,5121,126158,37693,2021-02-12,1613084400.0
10912,52,1,2021-02-13,762,1238,126920,38931,2021-02-13,1613170800.0
10913,52,1,2021-02-14,22,541,126942,39472,2021-02-14,1613257200.0
10914,52,1,2021-02-15,1356,3514,128298,42986,2021-02-15,1613343600.0
10915,52,1,2021-02-16,2108,6703,130406,49689,2021-02-16,1613430000.0
10916,52,1,2021-02-17,2547,6916,132953,56605,2021-02-17,1613516400.0
10917,52,1,2021-02-18,4277,9228,137230,65833,2021-02-18,1613602800.0
10918,52,1,2021-02-19,3231,5767,140461,71600,2021-02-19,1613689200.0
10919,52,1,2021-02-20,592,1468,141053,73068,2021-02-20,1613775600.0
10920,52,1,2021-02-21,7,274,141060,73342,2021-02-21,1613862000.0
10921,52,1,2021-02-22,1758,3463,142818,76805,2021-02-22,1613948400.0
10922,52,1,2021-02-23,2016,3679,144834,80484,2021-02-23,1614034800.0
10923,52,1,2021-02-24,1708,3018,146542,83502,2021-02-24,1614121200.0
10924,52,1,2021-02-25,1729,3162,148271,86664,2021-02-25,1614207600.0
10925,52,1,2021-02-26,1664,2873,149935,89537,2021-02-26,1614294000.0
10926,52,1,2021-02-27,504,1037,150439,90574,2021-02-27,1614380400.0
10927,52,1,2021-02-28,39,87,150478,90661,2021-02-28,1614466800.0
10928,52,1,2021-03-01,1927,2307,152405,92968,2021-03-01,1614553200.0
10929,52,1,2021-03-02,2546,3401,154951,96369,2021-03-02,1614639600.0
10930,52,1,2021-03-03,2374,3368,157325,99737,2021-03-03,1614726000.0
10931,52,1,2021-03-04,3028,4687,160353,104424,2021-03-04,1614812400.0
10932,52,1,2021-03-05,2981,3820,163334,108244,2021-03-05,1614898800.0
10933,52,1,2021-03-06,981,1094,164315,109338,2021-03-06,1614985200.0
10934,52,1,2021-03-07,3,104,164318,109442,2021-03-07,1615071600.0
10935,52,1,2021-03-08,2811,2366,167129,111808,2021-03-08,1615158000.0
10936,52,1,2021-03-09,3880,3226,171009,115034,2021-03-09,1615244400.0
10937,52,1,2021-03-10,3678,3251,174687,118285,2021-03-10,1615330800.0
10938,52,1,2021-03-11,5049,4838,179736,123123,2021-03-11,1615417200.0
10939,52,1,2021-03-12,4518,3496,184254,126619,2021-03-12,1615503600.0
10940,52,1,2021-03-13,2011,690,186265,127309,2021-03-13,1615590000.0
10941,52,1,2021-03-14,422,72,186687,127381,2021-03-14,1615676400.0
10942,52,1,2021-03-15,5540,1775,192227,129156,2021-03-15,1615762800.0
10943,52,1,2021-03-16,6616,1729,198843,130885,2021-03-16,1615849200.0
10944,52,1,2021-03-17,5780,1810,204623,132695,2021-03-17,1615935600.0
10945,52,1,2021-03-18,6895,1881,211518,134576,2021-03-18,1616022000.0
10946,52,1,2021-03-19,6388,1610,217906,136186,2021-03-19,1616108400.0
10947,52,1,2021-03-20,2397,527,220303,136713,2021-03-20,1616194800.0
10948,52,1,2021-03-21,911,26,221214,136739,2021-03-21,1616281200.0
10949,52,1,2021-03-22,6188,1786,227402,138525,2021-03-22,1616367600.0
10950,52,1,2021-03-23,7567,2017,234969,140542,2021-03-23,1616454000.0
10951,52,1,2021-03-24,6527,1717,241496,142259,2021-03-24,1616540400.0
10952,52,1,2021-03-25,7551,1803,249047,144062,2021-03-25,1616626800.0
10953,52,1,2021-03-26,7114,1819,256161,145881,2021-03-26,1616713200.0
10954,52,1,2021-03-27,3413,547,259574,146428,2021-03-27,1616799600.0
10955,52,1,2021-03-28,1888,36,261462,146464,2021-03-28,1616886000.0
10956,52,1,2021-03-29,6747,2505,268209,148969,2021-03-29,1616972400.0
10957,52,1,2021-03-30,8973,3149,277182,152118,2021-03-30,1617058800.0
10958,52,1,2021-03-31,9280,2741,286462,154859,2021-03-31,1617145200.0
10959,52,1,2021-04-01,11824,3001,298286,157860,2021-04-01,1617231600.0
10960,52,1,2021-04-02,10021,2892,308307,160752,2021-04-02,1617318000.0
10961,52,1,2021-04-03,3131,1155,311438,161907,2021-04-03,1617404400.0
10962,52,1,2021-04-04,1279,31,312717,161938,2021-04-04,1617490800.0
10963,52,1,2021-04-05,1745,507,314462,162445,2021-04-05,1617577200.0
10964,52,1,2021-04-06,9208,4559,323670,167004,2021-04-06,1617663600.0
10965,52,1,2021-04-07,11942,4666,335612,171670,2021-04-07,1617750000.0
10966,52,1,2021-04-08,13358,4879,348970,176549,2021-04-08,1617836400.0
10967,52,1,2021-04-09,14089,4304,363059,180853,2021-04-09,1617922800.0
10968,52,1,2021-04-10,5354,2130,368413,182983,2021-04-10,1618009200.0
10969,52,1,2021-04-11,2251,386,370664,183369,2021-04-11,1618095600.0
10970,52,1,2021-04-12,11443,6090,382107,189459,2021-04-12,1618185600.0
10971,52,1,2021-04-13,12599,6778,394706,196237,2021-04-13,1618272000.0
10972,52,1,2021-04-14,11477,5741,406183,201978,2021-04-14,1618358400.0
10973,52,1,2021-04-15,11974,6393,418157,208371,2021-04-15,1618444800.0
10974,52,1,2021-04-16,12637,5929,430794,214300,2021-04-16,1618531200.0
10975,52,1,2021-04-17,5453,2090,436247,216390,2021-04-17,1618617600.0
10976,52,1,2021-04-18,1587,866,437834,217256,2021-04-18,1618704000.0
10977,52,1,2021-04-19,11579,6584,449413,223840,2021-04-19,1618790400.0
10978,52,1,2021-04-20,13156,7976,462569,231816,2021-04-20,1618876800.0
10979,52,1,2021-04-21,12109,7505,474678,239321,2021-04-21,1618963200.0
10980,52,1,2021-04-22,13645,8503,488323,247824,2021-04-22,1619049600.0
10981,52,1,2021-04-23,13113,7942,501436,255766,2021-04-23,1619136000.0
10982,52,1,2021-04-24,6817,3935,508253,259701,2021-04-24,1619222400.0
10983,52,1,2021-04-25,3430,1633,511683,261334,2021-04-25,1619308800.0
10984,52,1,2021-04-26,13488,8202,525171,269536,2021-04-26,1619395200.0
10985,52,1,2021-04-27,15943,10289,541114,279825,2021-04-27,1619481600.0
10986,52,1,2021-04-28,18379,8281,559493,288106,2021-04-28,1619568000.0
10987,52,1,2021-04-29,18190,9283,577683,297389,2021-04-29,1619654400.0
10988,52,1,2021-04-30,17437,8919,595120,306308,2021-04-30,1619740800.0
10989,52,1,2021-05-01,7307,1495,602427,307803,2021-05-01,1619827200.0
10990,52,1,2021-05-02,3933,1062,606360,308865,2021-05-02,1619913600.0
10991,52,1,2021-05-03,16408,9140,622768,318005,2021-05-03,1620000000.0
10992,52,1,2021-05-04,16346,12035,639114,330040,2021-05-04,1620086400.0
10993,52,1,2021-05-05,17884,10251,656998,340291,2021-05-05,1620172800.0
10994,52,1,2021-05-06,16841,10193,673839,350484,2021-05-06,1620259200.0
10995,52,1,2021-05-07,13535,13290,687374,363774,2021-05-07,1620345600.0
10996,52,1,2021-05-08,8600,1303,695974,365077,2021-05-08,1620432000.0
10997,52,1,2021-05-09,4687,1742,700661,366819,2021-05-09,1620518400.0
10998,52,1,2021-05-10,15374,13613,716035,380432,2021-05-10,1620604800.0
10999,52,1,2021-05-11,17609,14343,733644,394775,2021-05-11,1620691200.0
11000,52,1,2021-05-12,18542,12064,752186,406839,2021-05-12,1620777600.0
11001,52,1,2021-05-13,15110,1633,767296,408472,2021-05-13,1620864000.0
11002,52,1,2021-05-14,17535,9578,784831,418050,2021-05-14,1620950400.0
11003,52,1,2021-05-15,11242,3644,796073,421694,2021-05-15,1621036800.0
11004,52,1,2021-05-16,4734,767,800807,422461,2021-05-16,1621123200.0
11005,52,1,2021-05-17,18772,11035,819579,433496,2021-05-17,1621206000.0
11006,52,1,2021-05-18,22016,10340,841595,443836,2021-05-18,1621292400.0
11007,52,1,2021-05-19,24379,7588,865974,451424,2021-05-19,1621378800.0
11008,52,1,2021-05-20,26495,6321,892469,457745,2021-05-20,1621465200.0
11009,52,1,2021-05-21,24098,7281,916567,465026,2021-05-21,1621551600.0
11010,52,1,2021-05-22,14277,2423,930844,467449,2021-05-22,1621638000.0
11011,52,1,2021-05-23,4108,872,934952,468321,2021-05-23,1621724400.0
11012,52,1,2021-05-24,15927,1866,950879,470187,2021-05-24,1621810800.0
11013,52,1,2021-05-25,22758,10108,973637,480295,2021-05-25,1621897200.0
11014,52,1,2021-05-26,23785,7387,997422,487682,2021-05-26,1621983600.0
11015,52,1,2021-05-27,26976,6760,1024398,494442,2021-05-27,1622070000.0
11016,52,1,2021-05-28,23868,8354,1048266,502796,2021-05-28,1622156400.0
11017,52,1,2021-05-29,16168,3728,1064434,506524,2021-05-29,1622242800.0
11018,52,1,2021-05-30,4099,1459,1068533,507983,2021-05-30,1622329200.0
11019,52,1,2021-05-31,21488,10715,1090021,518698,2021-05-31,1622415600.0
11020,52,1,2021-06-01,24319,10065,1114340,528763,2021-06-01,1622502000.0
11021,52,1,2021-06-02,24246,8771,1138586,537534,2021-06-02,1622588400.0
11022,52,1,2021-06-03,28006,7315,1166592,544849,2021-06-03,1622674800.0
11023,52,1,2021-06-04,24013,10195,1190605,555044,2021-06-04,1622761200.0
11024,52,1,2021-06-05,12521,6883,1203126,561927,2021-06-05,1622847600.0
11025,52,1,2021-06-06,4692,2411,1207818,564338,2021-06-06,1622934000.0
11026,52,1,2021-06-07,19256,15534,1227074,579872,2021-06-07,1623020400.0
11027,52,1,2021-06-08,22379,15240,1249453,595112,2021-06-08,1623106800.0
11028,52,1,2021-06-09,22977,12573,1272430,607685,2021-06-09,1623193200.0
11029,52,1,2021-06-10,25510,9885,1297940,617570,2021-06-10,1623279600.0
11030,52,1,2021-06-11,21962,13706,1319902,631276,2021-06-11,1623366000.0
11031,52,1,2021-06-12,11920,7876,1331822,639152,2021-06-12,1623452400.0
11032,52,1,2021-06-13,4346,3026,1336168,642178,2021-06-13,1623538800.0
11033,52,1,2021-06-14,15493,19394,1351661,661572,2021-06-14,1623625200.0
11034,52,1,2021-06-15,20351,16060,1372012,677632,2021-06-15,1623711600.0
11035,52,1,2021-06-16,20563,14820,1392575,692452,2021-06-16,1623798000.0
11036,52,1,2021-06-17,22997,12428,1415572,704880,2021-06-17,1623884400.0
11037,52,1,2021-06-18,19510,16300,1435082,721180,2021-06-18,1623970800.0
11038,52,1,2021-06-19,10606,8876,1445688,730056,2021-06-19,1624057200.0
11039,52,1,2021-06-20,2931,2930,1448619,732986,2021-06-20,1624143600.0
11040,52,1,2021-06-21,13398,21417,1462017,754403,2021-06-21,1624230000.0
11041,52,1,2021-06-22,15152,21021,1477169,775424,2021-06-22,1624316400.0
11042,52,1,2021-06-23,16705,18085,1493874,793509,2021-06-23,1624402800.0
11043,52,1,2021-06-24,18885,13048,1512759,806557,2021-06-24,1624489200.0
11044,52,1,2021-06-25,13846,19906,1526605,826463,2021-06-25,1624575600.0
11045,52,1,2021-06-26,7386,11775,1533991,838238,2021-06-26,1624662000.0
11046,52,1,2021-06-27,1258,3701,1535249,841939,2021-06-27,1624748400.0
11047,52,1,2021-06-28,9538,25998,1544787,867937,2021-06-28,1624834800.0
11048,52,1,2021-06-29,11437,26723,1556224,894660,2021-06-29,1624921200.0
11049,52,1,2021-06-30,12368,22911,1568592,917571,2021-06-30,1625007600.0
11050,52,1,2021-07-01,14444,20668,1583036,938239,2021-07-01,1625094000.0
11051,52,1,2021-07-02,12549,23225,1595585,961464,2021-07-02,1625180400.0
11052,52,1,2021-07-03,6473,15514,1602058,976978,2021-07-03,1625266800.0
11053,52,1,2021-07-04,1626,4906,1603684,981884,2021-07-04,1625353200.0
11054,52,1,2021-07-05,8740,26336,1612424,1008220,2021-07-05,1625439600.0
11055,52,1,2021-07-06,10409,27001,1622833,1035221,2021-07-06,1625526000.0
11056,52,1,2021-07-07,11390,24303,1634223,1059524,2021-07-07,1625612400.0
11057,52,1,2021-07-08,13092,21907,1647315,1081431,2021-07-08,1625698800.0
11058,52,2,2020-12-27,0,0,0,0,2020-12-27,1609023600.0
11059,52,2,2020-12-28,0,0,0,0,2020-12-28,1609110000.0
11060,52,2,2020-12-29,0,0,0,0,2020-12-29,1609196400.0
11061,52,2,2020-12-30,0,0,0,0,2020-12-30,1609282800.0
11062,52,2,2020-12-31,0,0,0,0,2020-12-31,1609369200.0
11063,52,2,2021-01-01,0,0,0,0,2021-01-01,1609455600.0
11064,52,2,2021-01-02,0,0,0,0,2021-01-02,1609542000.0
11065,52,2,2021-01-03,0,0,0,0,2021-01-03,1609628400.0
11066,52,2,2021-01-04,0,0,0,0,2021-01-04,1609714800.0
11067,52,2,2021-01-05,0,0,0,0,2021-01-05,1609801200.0
11068,52,2,2021-01-06,0,0,0,0,2021-01-06,1609887600.0
11069,52,2,2021-01-07,0,0,0,0,2021-01-07,1609974000.0
11070,52,2,2021-01-08,0,0,0,0,2021-01-08,1610060400.0
11071,52,2,2021-01-09,0,0,0,0,2021-01-09,1610146800.0
11072,52,2,2021-01-10,0,0,0,0,2021-01-10,1610233200.0
11073,52,2,2021-01-11,0,0,0,0,2021-01-11,1610319600.0
11074,52,2,2021-01-12,0,0,0,0,2021-01-12,1610406000.0
11075,52,2,2021-01-13,0,0,0,0,2021-01-13,1610492400.0
11076,52,2,2021-01-14,0,0,0,0,2021-01-14,1610578800.0
11077,52,2,2021-01-15,0,0,0,0,2021-01-15,1610665200.0
11078,52,2,2021-01-16,0,0,0,0,2021-01-16,1610751600.0
11079,52,2,2021-01-17,0,0,0,0,2021-01-17,1610838000.0
11080,52,2,2021-01-18,2,0,2,0,2021-01-18,1610924400.0
11081,52,2,2021-01-19,1,0,3,0,2021-01-19,1611010800.0
11082,52,2,2021-01-20,1,0,4,0,2021-01-20,1611097200.0
11083,52,2,2021-01-21,1,0,5,0,2021-01-21,1611183600.0
11084,52,2,2021-01-22,0,0,5,0,2021-01-22,1611270000.0
11085,52,2,2021-01-23,0,0,5,0,2021-01-23,1611356400.0
11086,52,2,2021-01-24,0,0,5,0,2021-01-24,1611442800.0
11087,52,2,2021-01-25,0,0,5,0,2021-01-25,1611529200.0
11088,52,2,2021-01-26,0,0,5,0,2021-01-26,1611615600.0
11089,52,2,2021-01-27,2,0,7,0,2021-01-27,1611702000.0
11090,52,2,2021-01-28,0,0,7,0,2021-01-28,1611788400.0
11091,52,2,2021-01-29,0,0,7,0,2021-01-29,1611874800.0
11092,52,2,2021-01-30,0,0,7,0,2021-01-30,1611961200.0
11093,52,2,2021-01-31,0,0,7,0,2021-01-31,1612047600.0
11094,52,2,2021-02-01,0,0,7,0,2021-02-01,1612134000.0
11095,52,2,2021-02-02,3,0,10,0,2021-02-02,1612220400.0
11096,52,2,2021-02-03,7,0,17,0,2021-02-03,1612306800.0
11097,52,2,2021-02-04,0,0,17,0,2021-02-04,1612393200.0
11098,52,2,2021-02-05,0,0,17,0,2021-02-05,1612479600.0
11099,52,2,2021-02-06,0,0,17,0,2021-02-06,1612566000.0
11100,52,2,2021-02-07,0,0,17,0,2021-02-07,1612652400.0
11101,52,2,2021-02-08,0,2,17,2,2021-02-08,1612738800.0
11102,52,2,2021-02-09,1,0,18,2,2021-02-09,1612825200.0
11103,52,2,2021-02-10,71,0,89,2,2021-02-10,1612911600.0
11104,52,2,2021-02-11,136,1,225,3,2021-02-11,1612998000.0
11105,52,2,2021-02-12,169,0,394,3,2021-02-12,1613084400.0
11106,52,2,2021-02-13,24,0,418,3,2021-02-13,1613170800.0
11107,52,2,2021-02-14,0,0,418,3,2021-02-14,1613257200.0
11108,52,2,2021-02-15,53,0,471,3,2021-02-15,1613343600.0
11109,52,2,2021-02-16,754,0,1225,3,2021-02-16,1613430000.0
11110,52,2,2021-02-17,580,2,1805,5,2021-02-17,1613516400.0
11111,52,2,2021-02-18,625,1,2430,6,2021-02-18,1613602800.0
11112,52,2,2021-02-19,686,0,3116,6,2021-02-19,1613689200.0
11113,52,2,2021-02-20,152,0,3268,6,2021-02-20,1613775600.0
11114,52,2,2021-02-21,0,0,3268,6,2021-02-21,1613862000.0
11115,52,2,2021-02-22,259,1,3527,7,2021-02-22,1613948400.0
11116,52,2,2021-02-23,517,0,4044,7,2021-02-23,1614034800.0
11117,52,2,2021-02-24,428,0,4472,7,2021-02-24,1614121200.0
11118,52,2,2021-02-25,816,0,5288,7,2021-02-25,1614207600.0
11119,52,2,2021-02-26,318,1,5606,8,2021-02-26,1614294000.0
11120,52,2,2021-02-27,2,0,5608,8,2021-02-27,1614380400.0
11121,52,2,2021-02-28,0,0,5608,8,2021-02-28,1614466800.0
11122,52,2,2021-03-01,130,0,5738,8,2021-03-01,1614553200.0
11123,52,2,2021-03-02,135,1,5873,9,2021-03-02,1614639600.0
11124,52,2,2021-03-03,244,0,6117,9,2021-03-03,1614726000.0
11125,52,2,2021-03-04,395,0,6512,9,2021-03-04,1614812400.0
11126,52,2,2021-03-05,270,0,6782,9,2021-03-05,1614898800.0
11127,52,2,2021-03-06,1,0,6783,9,2021-03-06,1614985200.0
11128,52,2,2021-03-07,0,0,6783,9,2021-03-07,1615071600.0
11129,52,2,2021-03-08,255,0,7038,9,2021-03-08,1615158000.0
11130,52,2,2021-03-09,944,0,7982,9,2021-03-09,1615244400.0
11131,52,2,2021-03-10,556,61,8538,70,2021-03-10,1615330800.0
11132,52,2,2021-03-11,1045,64,9583,134,2021-03-11,1615417200.0
11133,52,2,2021-03-12,396,110,9979,244,2021-03-12,1615503600.0
11134,52,2,2021-03-13,13,8,9992,252,2021-03-13,1615590000.0
11135,52,2,2021-03-14,0,0,9992,252,2021-03-14,1615676400.0
11136,52,2,2021-03-15,334,52,10326,304,2021-03-15,1615762800.0
11137,52,2,2021-03-16,925,814,11251,1118,2021-03-16,1615849200.0
11138,52,2,2021-03-17,658,526,11909,1644,2021-03-17,1615935600.0
11139,52,2,2021-03-18,1353,521,13262,2165,2021-03-18,1616022000.0
11140,52,2,2021-03-19,1391,395,14653,2560,2021-03-19,1616108400.0
11141,52,2,2021-03-20,849,169,15502,2729,2021-03-20,1616194800.0
11142,52,2,2021-03-21,537,0,16039,2729,2021-03-21,1616281200.0
11143,52,2,2021-03-22,877,145,16916,2874,2021-03-22,1616367600.0
11144,52,2,2021-03-23,1147,409,18063,3283,2021-03-23,1616454000.0
11145,52,2,2021-03-24,1299,200,19362,3483,2021-03-24,1616540400.0
11146,52,2,2021-03-25,1643,805,21005,4288,2021-03-25,1616626800.0
11147,52,2,2021-03-26,1694,342,22699,4630,2021-03-26,1616713200.0
11148,52,2,2021-03-27,633,31,23332,4661,2021-03-27,1616799600.0
11149,52,2,2021-03-28,152,17,23484,4678,2021-03-28,1616886000.0
11150,52,2,2021-03-29,1122,115,24606,4793,2021-03-29,1616972400.0
11151,52,2,2021-03-30,1128,246,25734,5039,2021-03-30,1617058800.0
11152,52,2,2021-03-31,1190,289,26924,5328,2021-03-31,1617145200.0
11153,52,2,2021-04-01,1516,365,28440,5693,2021-04-01,1617231600.0
11154,52,2,2021-04-02,1402,330,29842,6023,2021-04-02,1617318000.0
11155,52,2,2021-04-03,515,1,30357,6024,2021-04-03,1617404400.0
11156,52,2,2021-04-04,1,12,30358,6036,2021-04-04,1617490800.0
11157,52,2,2021-04-05,2,1,30360,6037,2021-04-05,1617577200.0
11158,52,2,2021-04-06,991,511,31351,6548,2021-04-06,1617663600.0
11159,52,2,2021-04-07,1059,736,32410,7284,2021-04-07,1617750000.0
11160,52,2,2021-04-08,1507,1109,33917,8393,2021-04-08,1617836400.0
11161,52,2,2021-04-09,1326,506,35243,8899,2021-04-09,1617922800.0
11162,52,2,2021-04-10,406,86,35649,8985,2021-04-10,1618009200.0
11163,52,2,2021-04-11,183,20,35832,9005,2021-04-11,1618095600.0
11164,52,2,2021-04-12,1216,201,37048,9206,2021-04-12,1618185600.0
11165,52,2,2021-04-13,1815,1010,38863,10216,2021-04-13,1618272000.0
11166,52,2,2021-04-14,1510,791,40373,11007,2021-04-14,1618358400.0
11167,52,2,2021-04-15,1856,1214,42229,12221,2021-04-15,1618444800.0
11168,52,2,2021-04-16,1649,1072,43878,13293,2021-04-16,1618531200.0
11169,52,2,2021-04-17,729,785,44607,14078,2021-04-17,1618617600.0
11170,52,2,2021-04-18,19,381,44626,14459,2021-04-18,1618704000.0
11171,52,2,2021-04-19,885,972,45511,15431,2021-04-19,1618790400.0
11172,52,2,2021-04-20,1238,1072,46749,16503,2021-04-20,1618876800.0
11173,52,2,2021-04-21,996,1240,47745,17743,2021-04-21,1618963200.0
11174,52,2,2021-04-22,1200,1205,48945,18948,2021-04-22,1619049600.0
11175,52,2,2021-04-23,1697,1502,50642,20450,2021-04-23,1619136000.0
11176,52,2,2021-04-24,568,703,51210,21153,2021-04-24,1619222400.0
11177,52,2,2021-04-25,264,206,51474,21359,2021-04-25,1619308800.0
11178,52,2,2021-04-26,1687,1037,53161,22396,2021-04-26,1619395200.0
11179,52,2,2021-04-27,1613,972,54774,23368,2021-04-27,1619481600.0
11180,52,2,2021-04-28,1391,1158,56165,24526,2021-04-28,1619568000.0
11181,52,2,2021-04-29,1904,1282,58069,25808,2021-04-29,1619654400.0
11182,52,2,2021-04-30,2607,1349,60676,27157,2021-04-30,1619740800.0
11183,52,2,2021-05-01,778,611,61454,27768,2021-05-01,1619827200.0
11184,52,2,2021-05-02,338,64,61792,27832,2021-05-02,1619913600.0
11185,52,2,2021-05-03,1187,631,62979,28463,2021-05-03,1620000000.0
11186,52,2,2021-05-04,1106,1026,64085,29489,2021-05-04,1620086400.0
11187,52,2,2021-05-05,1171,1013,65256,30502,2021-05-05,1620172800.0
11188,52,2,2021-05-06,1751,1241,67007,31743,2021-05-06,1620259200.0
11189,52,2,2021-05-07,2452,1497,69459,33240,2021-05-07,1620345600.0
11190,52,2,2021-05-08,2197,293,71656,33533,2021-05-08,1620432000.0
11191,52,2,2021-05-09,670,310,72326,33843,2021-05-09,1620518400.0
11192,52,2,2021-05-10,3619,2148,75945,35991,2021-05-10,1620604800.0
11193,52,2,2021-05-11,3899,2171,79844,38162,2021-05-11,1620691200.0
11194,52,2,2021-05-12,4282,2265,84126,40427,2021-05-12,1620777600.0
11195,52,2,2021-05-13,3336,344,87462,40771,2021-05-13,1620864000.0
11196,52,2,2021-05-14,3914,788,91376,41559,2021-05-14,1620950400.0
11197,52,2,2021-05-15,3906,272,95282,41831,2021-05-15,1621036800.0
11198,52,2,2021-05-16,5511,51,100793,41882,2021-05-16,1621123200.0
11199,52,2,2021-05-17,1419,1070,102212,42952,2021-05-17,1621206000.0
11200,52,2,2021-05-18,982,1029,103194,43981,2021-05-18,1621292400.0
11201,52,2,2021-05-19,1243,527,104437,44508,2021-05-19,1621378800.0
11202,52,2,2021-05-20,1262,638,105699,45146,2021-05-20,1621465200.0
11203,52,2,2021-05-21,1433,1203,107132,46349,2021-05-21,1621551600.0
11204,52,2,2021-05-22,690,125,107822,46474,2021-05-22,1621638000.0
11205,52,2,2021-05-23,328,20,108150,46494,2021-05-23,1621724400.0
11206,52,2,2021-05-24,60,107,108210,46601,2021-05-24,1621810800.0
11207,52,2,2021-05-25,829,843,109039,47444,2021-05-25,1621897200.0
11208,52,2,2021-05-26,763,756,109802,48200,2021-05-26,1621983600.0
11209,52,2,2021-05-27,753,1414,110555,49614,2021-05-27,1622070000.0
11210,52,2,2021-05-28,1652,1457,112207,51071,2021-05-28,1622156400.0
11211,52,2,2021-05-29,1384,353,113591,51424,2021-05-29,1622242800.0
11212,52,2,2021-05-30,113,14,113704,51438,2021-05-30,1622329200.0
11213,52,2,2021-05-31,1990,1091,115694,52529,2021-05-31,1622415600.0
11214,52,2,2021-06-01,3161,1539,118855,54068,2021-06-01,1622502000.0
11215,52,2,2021-06-02,2211,1245,121066,55313,2021-06-02,1622588400.0
11216,52,2,2021-06-03,2307,1218,123373,56531,2021-06-03,1622674800.0
11217,52,2,2021-06-04,3546,1594,126919,58125,2021-06-04,1622761200.0
11218,52,2,2021-06-05,1558,1015,128477,59140,2021-06-05,1622847600.0
11219,52,2,2021-06-06,60,523,128537,59663,2021-06-06,1622934000.0
11220,52,2,2021-06-07,1844,1674,130381,61337,2021-06-07,1623020400.0
11221,52,2,2021-06-08,3031,1688,133412,63025,2021-06-08,1623106800.0
11222,52,2,2021-06-09,1733,1281,135145,64306,2021-06-09,1623193200.0
11223,52,2,2021-06-10,2193,1243,137338,65549,2021-06-10,1623279600.0
11224,52,2,2021-06-11,3764,2233,141102,67782,2021-06-11,1623366000.0
11225,52,2,2021-06-12,2223,910,143325,68692,2021-06-12,1623452400.0
11226,52,2,2021-06-13,42,1163,143367,69855,2021-06-13,1623538800.0
11227,52,2,2021-06-14,1657,1802,145024,71657,2021-06-14,1623625200.0
11228,52,2,2021-06-15,2594,1622,147618,73279,2021-06-15,1623711600.0
11229,52,2,2021-06-16,2025,1444,149643,74723,2021-06-16,1623798000.0
11230,52,2,2021-06-17,2124,1551,151767,76274,2021-06-17,1623884400.0
11231,52,2,2021-06-18,2933,2537,154700,78811,2021-06-18,1623970800.0
11232,52,2,2021-06-19,1516,2526,156216,81337,2021-06-19,1624057200.0
11233,52,2,2021-06-20,72,1268,156288,82605,2021-06-20,1624143600.0
11234,52,2,2021-06-21,1110,3418,157398,86023,2021-06-21,1624230000.0
11235,52,2,2021-06-22,1738,3892,159136,89915,2021-06-22,1624316400.0
11236,52,2,2021-06-23,1275,3801,160411,93716,2021-06-23,1624402800.0
11237,52,2,2021-06-24,1566,3231,161977,96947,2021-06-24,1624489200.0
11238,52,2,2021-06-25,2248,2863,164225,99810,2021-06-25,1624575600.0
11239,52,2,2021-06-26,793,3697,165018,103507,2021-06-26,1624662000.0
11240,52,2,2021-06-27,56,3519,165074,107026,2021-06-27,1624748400.0
11241,52,2,2021-06-28,797,1803,165871,108829,2021-06-28,1624834800.0
11242,52,2,2021-06-29,1523,1899,167394,110728,2021-06-29,1624921200.0
11243,52,2,2021-06-30,855,1319,168249,112047,2021-06-30,1625007600.0
11244,52,2,2021-07-01,1068,1463,169317,113510,2021-07-01,1625094000.0
11245,52,2,2021-07-02,1538,1818,170855,115328,2021-07-02,1625180400.0
11246,52,2,2021-07-03,579,911,171434,116239,2021-07-03,1625266800.0
11247,52,2,2021-07-04,60,112,171494,116351,2021-07-04,1625353200.0
11248,52,2,2021-07-05,516,1039,172010,117390,2021-07-05,1625439600.0
11249,52,2,2021-07-06,693,1526,172703,118916,2021-07-06,1625526000.0
11250,52,2,2021-07-07,743,1317,173446,120233,2021-07-07,1625612400.0
11251,52,2,2021-07-08,1087,1617,174533,121850,2021-07-08,1625698800.0
11252,52,3,2020-12-27,0,0,0,0,2020-12-27,1609023600.0
11253,52,3,2020-12-28,0,0,0,0,2020-12-28,1609110000.0
11254,52,3,2020-12-29,0,0,0,0,2020-12-29,1609196400.0
11255,52,3,2020-12-30,0,0,0,0,2020-12-30,1609282800.0
11256,52,3,2020-12-31,0,0,0,0,2020-12-31,1609369200.0
11257,52,3,2021-01-01,0,0,0,0,2021-01-01,1609455600.0
11258,52,3,2021-01-02,0,0,0,0,2021-01-02,1609542000.0
11259,52,3,2021-01-03,0,0,0,0,2021-01-03,1609628400.0
11260,52,3,2021-01-04,0,0,0,0,2021-01-04,1609714800.0
11261,52,3,2021-01-05,0,0,0,0,2021-01-05,1609801200.0
11262,52,3,2021-01-06,0,0,0,0,2021-01-06,1609887600.0
11263,52,3,2021-01-07,0,0,0,0,2021-01-07,1609974000.0
11264,52,3,2021-01-08,0,0,0,0,2021-01-08,1610060400.0
11265,52,3,2021-01-09,0,0,0,0,2021-01-09,1610146800.0
11266,52,3,2021-01-10,0,0,0,0,2021-01-10,1610233200.0
11267,52,3,2021-01-11,0,0,0,0,2021-01-11,1610319600.0
11268,52,3,2021-01-12,0,0,0,0,2021-01-12,1610406000.0
11269,52,3,2021-01-13,0,0,0,0,2021-01-13,1610492400.0
11270,52,3,2021-01-14,0,0,0,0,2021-01-14,1610578800.0
11271,52,3,2021-01-15,0,0,0,0,2021-01-15,1610665200.0
11272,52,3,2021-01-16,0,0,0,0,2021-01-16,1610751600.0
11273,52,3,2021-01-17,0,0,0,0,2021-01-17,1610838000.0
11274,52,3,2021-01-18,0,0,0,0,2021-01-18,1610924400.0
11275,52,3,2021-01-19,0,0,0,0,2021-01-19,1611010800.0
11276,52,3,2021-01-20,0,0,0,0,2021-01-20,1611097200.0
11277,52,3,2021-01-21,0,0,0,0,2021-01-21,1611183600.0
11278,52,3,2021-01-22,0,0,0,0,2021-01-22,1611270000.0
11279,52,3,2021-01-23,0,0,0,0,2021-01-23,1611356400.0
11280,52,3,2021-01-24,0,0,0,0,2021-01-24,1611442800.0
11281,52,3,2021-01-25,0,0,0,0,2021-01-25,1611529200.0
11282,52,3,2021-01-26,0,0,0,0,2021-01-26,1611615600.0
11283,52,3,2021-01-27,0,0,0,0,2021-01-27,1611702000.0
11284,52,3,2021-01-28,0,0,0,0,2021-01-28,1611788400.0
11285,52,3,2021-01-29,0,0,0,0,2021-01-29,1611874800.0
11286,52,3,2021-01-30,0,0,0,0,2021-01-30,1611961200.0
11287,52,3,2021-01-31,0,0,0,0,2021-01-31,1612047600.0
11288,52,3,2021-02-01,0,0,0,0,2021-02-01,1612134000.0
11289,52,3,2021-02-02,0,0,0,0,2021-02-02,1612220400.0
11290,52,3,2021-02-03,0,0,0,0,2021-02-03,1612306800.0
11291,52,3,2021-02-04,0,0,0,0,2021-02-04,1612393200.0
11292,52,3,2021-02-05,0,0,0,0,2021-02-05,1612479600.0
11293,52,3,2021-02-06,5,0,5,0,2021-02-06,1612566000.0
11294,52,3,2021-02-07,141,0,146,0,2021-02-07,1612652400.0
11295,52,3,2021-02-08,173,0,319,0,2021-02-08,1612738800.0
11296,52,3,2021-02-09,385,0,704,0,2021-02-09,1612825200.0
11297,52,3,2021-02-10,348,0,1052,0,2021-02-10,1612911600.0
11298,52,3,2021-02-11,905,0,1957,0,2021-02-11,1612998000.0
11299,52,3,2021-02-12,485,0,2442,0,2021-02-12,1613084400.0
11300,52,3,2021-02-13,363,0,2805,0,2021-02-13,1613170800.0
11301,52,3,2021-02-14,0,0,2805,0,2021-02-14,1613257200.0
11302,52,3,2021-02-15,619,0,3424,0,2021-02-15,1613343600.0
11303,52,3,2021-02-16,1265,0,4689,0,2021-02-16,1613430000.0
11304,52,3,2021-02-17,749,0,5438,0,2021-02-17,1613516400.0
11305,52,3,2021-02-18,1238,0,6676,0,2021-02-18,1613602800.0
11306,52,3,2021-02-19,1416,0,8092,0,2021-02-19,1613689200.0
11307,52,3,2021-02-20,284,0,8376,0,2021-02-20,1613775600.0
11308,52,3,2021-02-21,0,0,8376,0,2021-02-21,1613862000.0
11309,52,3,2021-02-22,630,0,9006,0,2021-02-22,1613948400.0
11310,52,3,2021-02-23,892,0,9898,0,2021-02-23,1614034800.0
11311,52,3,2021-02-24,1171,0,11069,0,2021-02-24,1614121200.0
11312,52,3,2021-02-25,3800,0,14869,0,2021-02-25,1614207600.0
11313,52,3,2021-02-26,4232,0,19101,0,2021-02-26,1614294000.0
11314,52,3,2021-02-27,1710,0,20811,0,2021-02-27,1614380400.0
11315,52,3,2021-02-28,37,0,20848,0,2021-02-28,1614466800.0
11316,52,3,2021-03-01,1057,0,21905,0,2021-03-01,1614553200.0
11317,52,3,2021-03-02,2042,2,23947,2,2021-03-02,1614639600.0
11318,52,3,2021-03-03,2666,1,26613,3,2021-03-03,1614726000.0
11319,52,3,2021-03-04,4372,3,30985,6,2021-03-04,1614812400.0
11320,52,3,2021-03-05,5757,1,36742,7,2021-03-05,1614898800.0
11321,52,3,2021-03-06,4655,1,41397,8,2021-03-06,1614985200.0
11322,52,3,2021-03-07,2658,1,44055,9,2021-03-07,1615071600.0
11323,52,3,2021-03-08,2780,0,46835,9,2021-03-08,1615158000.0
11324,52,3,2021-03-09,4722,1,51557,10,2021-03-09,1615244400.0
11325,52,3,2021-03-10,5154,1,56711,11,2021-03-10,1615330800.0
11326,52,3,2021-03-11,7481,3,64192,14,2021-03-11,1615417200.0
11327,52,3,2021-03-12,10418,6,74610,20,2021-03-12,1615503600.0
11328,52,3,2021-03-13,6264,1,80874,21,2021-03-13,1615590000.0
11329,52,3,2021-03-14,202,0,81076,21,2021-03-14,1615676400.0
11330,52,3,2021-03-15,2958,0,84034,21,2021-03-15,1615762800.0
11331,52,3,2021-03-16,35,1,84069,22,2021-03-16,1615849200.0
11332,52,3,2021-03-17,19,1,84088,23,2021-03-17,1615935600.0
11333,52,3,2021-03-18,56,1,84144,24,2021-03-18,1616022000.0
11334,52,3,2021-03-19,4112,2,88256,26,2021-03-19,1616108400.0
11335,52,3,2021-03-20,3841,0,92097,26,2021-03-20,1616194800.0
11336,52,3,2021-03-21,240,0,92337,26,2021-03-21,1616281200.0
11337,52,3,2021-03-22,1948,2,94285,28,2021-03-22,1616367600.0
11338,52,3,2021-03-23,4466,0,98751,28,2021-03-23,1616454000.0
11339,52,3,2021-03-24,5432,1,104183,29,2021-03-24,1616540400.0
11340,52,3,2021-03-25,9008,4,113191,33,2021-03-25,1616626800.0
11341,52,3,2021-03-26,10133,2,123324,35,2021-03-26,1616713200.0
11342,52,3,2021-03-27,3507,5,126831,40,2021-03-27,1616799600.0
11343,52,3,2021-03-28,155,0,126986,40,2021-03-28,1616886000.0
11344,52,3,2021-03-29,3102,0,130088,40,2021-03-29,1616972400.0
11345,52,3,2021-03-30,5579,1,135667,41,2021-03-30,1617058800.0
11346,52,3,2021-03-31,3223,1,138890,42,2021-03-31,1617145200.0
11347,52,3,2021-04-01,5533,5,144423,47,2021-04-01,1617231600.0
11348,52,3,2021-04-02,5665,5,150088,52,2021-04-02,1617318000.0
11349,52,3,2021-04-03,1870,5,151958,57,2021-04-03,1617404400.0
11350,52,3,2021-04-04,44,0,152002,57,2021-04-04,1617490800.0
11351,52,3,2021-04-05,40,0,152042,57,2021-04-05,1617577200.0
11352,52,3,2021-04-06,1588,3,153630,60,2021-04-06,1617663600.0
11353,52,3,2021-04-07,2187,1,155817,61,2021-04-07,1617750000.0
11354,52,3,2021-04-08,6374,6,162191,67,2021-04-08,1617836400.0
11355,52,3,2021-04-09,11248,19,173439,86,2021-04-09,1617922800.0
11356,52,3,2021-04-10,4365,5,177804,91,2021-04-10,1618009200.0
11357,52,3,2021-04-11,136,0,177940,91,2021-04-11,1618095600.0
11358,52,3,2021-04-12,3681,10,181621,101,2021-04-12,1618185600.0
11359,52,3,2021-04-13,6326,6,187947,107,2021-04-13,1618272000.0
11360,52,3,2021-04-14,4669,7,192616,114,2021-04-14,1618358400.0
11361,52,3,2021-04-15,7331,5,199947,119,2021-04-15,1618444800.0
11362,52,3,2021-04-16,8305,21,208252,140,2021-04-16,1618531200.0
11363,52,3,2021-04-17,3800,9,212052,149,2021-04-17,1618617600.0
11364,52,3,2021-04-18,1431,0,213483,149,2021-04-18,1618704000.0
11365,52,3,2021-04-19,1711,4,215194,153,2021-04-19,1618790400.0
11366,52,3,2021-04-20,3871,9,219065,162,2021-04-20,1618876800.0
11367,52,3,2021-04-21,2881,11,221946,173,2021-04-21,1618963200.0
11368,52,3,2021-04-22,4586,20,226532,193,2021-04-22,1619049600.0
11369,52,3,2021-04-23,5667,38,232199,231,2021-04-23,1619136000.0
11370,52,3,2021-04-24,2508,20,234707,251,2021-04-24,1619222400.0
11371,52,3,2021-04-25,275,2,234982,253,2021-04-25,1619308800.0
11372,52,3,2021-04-26,1393,31,236375,284,2021-04-26,1619395200.0
11373,52,3,2021-04-27,2765,89,239140,373,2021-04-27,1619481600.0
11374,52,3,2021-04-28,2390,69,241530,442,2021-04-28,1619568000.0
11375,52,3,2021-04-29,3840,347,245370,789,2021-04-29,1619654400.0
11376,52,3,2021-04-30,4555,465,249925,1254,2021-04-30,1619740800.0
11377,52,3,2021-05-01,422,49,250347,1303,2021-05-01,1619827200.0
11378,52,3,2021-05-02,27,8,250374,1311,2021-05-02,1619913600.0
11379,52,3,2021-05-03,1213,123,251587,1434,2021-05-03,1620000000.0
11380,52,3,2021-05-04,2111,305,253698,1739,2021-05-04,1620086400.0
11381,52,3,2021-05-05,1370,458,255068,2197,2021-05-05,1620172800.0
11382,52,3,2021-05-06,3077,1007,258145,3204,2021-05-06,1620259200.0
11383,52,3,2021-05-07,3549,1466,261694,4670,2021-05-07,1620345600.0
11384,52,3,2021-05-08,374,116,262068,4786,2021-05-08,1620432000.0
11385,52,3,2021-05-09,44,15,262112,4801,2021-05-09,1620518400.0
11386,52,3,2021-05-10,1351,494,263463,5295,2021-05-10,1620604800.0
11387,52,3,2021-05-11,2471,1373,265934,6668,2021-05-11,1620691200.0
11388,52,3,2021-05-12,1419,1390,267353,8058,2021-05-12,1620777600.0
11389,52,3,2021-05-13,109,167,267462,8225,2021-05-13,1620864000.0
11390,52,3,2021-05-14,1069,1066,268531,9291,2021-05-14,1620950400.0
11391,52,3,2021-05-15,337,631,268868,9922,2021-05-15,1621036800.0
11392,52,3,2021-05-16,33,13,268901,9935,2021-05-16,1621123200.0
11393,52,3,2021-05-17,675,1503,269576,11438,2021-05-17,1621206000.0
11394,52,3,2021-05-18,1246,2173,270822,13611,2021-05-18,1621292400.0
11395,52,3,2021-05-19,777,1923,271599,15534,2021-05-19,1621378800.0
11396,52,3,2021-05-20,1016,3344,272615,18878,2021-05-20,1621465200.0
11397,52,3,2021-05-21,978,3464,273593,22342,2021-05-21,1621551600.0
11398,52,3,2021-05-22,228,1407,273821,23749,2021-05-22,1621638000.0
11399,52,3,2021-05-23,19,84,273840,23833,2021-05-23,1621724400.0
11400,52,3,2021-05-24,3,133,273843,23966,2021-05-24,1621810800.0
11401,52,3,2021-05-25,370,2082,274213,26048,2021-05-25,1621897200.0
11402,52,3,2021-05-26,349,3113,274562,29161,2021-05-26,1621983600.0
11403,52,3,2021-05-27,413,4436,274975,33597,2021-05-27,1622070000.0
11404,52,3,2021-05-28,538,5043,275513,38640,2021-05-28,1622156400.0
11405,52,3,2021-05-29,142,2388,275655,41028,2021-05-29,1622242800.0
11406,52,3,2021-05-30,5,61,275660,41089,2021-05-30,1622329200.0
11407,52,3,2021-05-31,78,2164,275738,43253,2021-05-31,1622415600.0
11408,52,3,2021-06-01,137,3732,275875,46985,2021-06-01,1622502000.0
11409,52,3,2021-06-02,135,3118,276010,50103,2021-06-02,1622588400.0
11410,52,3,2021-06-03,203,5174,276213,55277,2021-06-03,1622674800.0
11411,52,3,2021-06-04,191,6150,276404,61427,2021-06-04,1622761200.0
11412,52,3,2021-06-05,63,2896,276467,64323,2021-06-05,1622847600.0
11413,52,3,2021-06-06,9,346,276476,64669,2021-06-06,1622934000.0
11414,52,3,2021-06-07,71,2065,276547,66734,2021-06-07,1623020400.0
11415,52,3,2021-06-08,112,2961,276659,69695,2021-06-08,1623106800.0
11416,52,3,2021-06-09,91,2688,276750,72383,2021-06-09,1623193200.0
11417,52,3,2021-06-10,98,4091,276848,76474,2021-06-10,1623279600.0
11418,52,3,2021-06-11,134,5937,276982,82411,2021-06-11,1623366000.0
11419,52,3,2021-06-12,40,1942,277022,84353,2021-06-12,1623452400.0
11420,52,3,2021-06-13,0,111,277022,84464,2021-06-13,1623538800.0
11421,52,3,2021-06-14,37,2742,277059,87206,2021-06-14,1623625200.0
11422,52,3,2021-06-15,57,5574,277116,92780,2021-06-15,1623711600.0
11423,52,3,2021-06-16,50,4285,277166,97065,2021-06-16,1623798000.0
11424,52,3,2021-06-17,95,7001,277261,104066,2021-06-17,1623884400.0
11425,52,3,2021-06-18,111,7806,277372,111872,2021-06-18,1623970800.0
11426,52,3,2021-06-19,38,1898,277410,113770,2021-06-19,1624057200.0
11427,52,3,2021-06-20,0,64,277410,113834,2021-06-20,1624143600.0
11428,52,3,2021-06-21,19,2778,277429,116612,2021-06-21,1624230000.0
11429,52,3,2021-06-22,48,5310,277477,121922,2021-06-22,1624316400.0
11430,52,3,2021-06-23,41,3410,277518,125332,2021-06-23,1624402800.0
11431,52,3,2021-06-24,61,5771,277579,131103,2021-06-24,1624489200.0
11432,52,3,2021-06-25,45,6720,277624,137823,2021-06-25,1624575600.0
11433,52,3,2021-06-26,30,1752,277654,139575,2021-06-26,1624662000.0
11434,52,3,2021-06-27,1,58,277655,139633,2021-06-27,1624748400.0
11435,52,3,2021-06-28,24,2197,277679,141830,2021-06-28,1624834800.0
11436,52,3,2021-06-29,38,4306,277717,146136,2021-06-29,1624921200.0
11437,52,3,2021-06-30,31,3263,277748,149399,2021-06-30,1625007600.0
11438,52,3,2021-07-01,51,5641,277799,155040,2021-07-01,1625094000.0
11439,52,3,2021-07-02,72,7180,277871,162220,2021-07-02,1625180400.0
11440,52,3,2021-07-03,21,1981,277892,164201,2021-07-03,1625266800.0
11441,52,3,2021-07-04,0,134,277892,164335,2021-07-04,1625353200.0
11442,52,3,2021-07-05,22,3045,277914,167380,2021-07-05,1625439600.0
11443,52,3,2021-07-06,44,5159,277958,172539,2021-07-06,1625526000.0
11444,52,3,2021-07-07,40,3497,277998,176036,2021-07-07,1625612400.0
11445,52,3,2021-07-08,72,5620,278070,181656,2021-07-08,1625698800.0
11446,52,4,2020-12-27,0,0,0,0,2020-12-27,1609023600.0
11447,52,4,2020-12-28,0,0,0,0,2020-12-28,1609110000.0
11448,52,4,2020-12-29,0,0,0,0,2020-12-29,1609196400.0
11449,52,4,2020-12-30,0,0,0,0,2020-12-30,1609282800.0
11450,52,4,2020-12-31,0,0,0,0,2020-12-31,1609369200.0
11451,52,4,2021-01-01,0,0,0,0,2021-01-01,1609455600.0
11452,52,4,2021-01-02,0,0,0,0,2021-01-02,1609542000.0
11453,52,4,2021-01-03,0,0,0,0,2021-01-03,1609628400.0
11454,52,4,2021-01-04,0,0,0,0,2021-01-04,1609714800.0
11455,52,4,2021-01-05,0,0,0,0,2021-01-05,1609801200.0
11456,52,4,2021-01-06,0,0,0,0,2021-01-06,1609887600.0
11457,52,4,2021-01-07,0,0,0,0,2021-01-07,1609974000.0
11458,52,4,2021-01-08,0,0,0,0,2021-01-08,1610060400.0
11459,52,4,2021-01-09,0,0,0,0,2021-01-09,1610146800.0
11460,52,4,2021-01-10,0,0,0,0,2021-01-10,1610233200.0
11461,52,4,2021-01-11,0,0,0,0,2021-01-11,1610319600.0
11462,52,4,2021-01-12,0,0,0,0,2021-01-12,1610406000.0
11463,52,4,2021-01-13,0,0,0,0,2021-01-13,1610492400.0
11464,52,4,2021-01-14,0,0,0,0,2021-01-14,1610578800.0
11465,52,4,2021-01-15,0,0,0,0,2021-01-15,1610665200.0
11466,52,4,2021-01-16,0,0,0,0,2021-01-16,1610751600.0
11467,52,4,2021-01-17,0,0,0,0,2021-01-17,1610838000.0
11468,52,4,2021-01-18,0,0,0,0,2021-01-18,1610924400.0
11469,52,4,2021-01-19,0,0,0,0,2021-01-19,1611010800.0
11470,52,4,2021-01-20,0,0,0,0,2021-01-20,1611097200.0
11471,52,4,2021-01-21,0,0,0,0,2021-01-21,1611183600.0
11472,52,4,2021-01-22,0,0,0,0,2021-01-22,1611270000.0
11473,52,4,2021-01-23,0,0,0,0,2021-01-23,1611356400.0
11474,52,4,2021-01-24,0,0,0,0,2021-01-24,1611442800.0
11475,52,4,2021-01-25,0,0,0,0,2021-01-25,1611529200.0
11476,52,4,2021-01-26,0,0,0,0,2021-01-26,1611615600.0
11477,52,4,2021-01-27,0,0,0,0,2021-01-27,1611702000.0
11478,52,4,2021-01-28,0,0,0,0,2021-01-28,1611788400.0
11479,52,4,2021-01-29,0,0,0,0,2021-01-29,1611874800.0
11480,52,4,2021-01-30,0,0,0,0,2021-01-30,1611961200.0
11481,52,4,2021-01-31,0,0,0,0,2021-01-31,1612047600.0
11482,52,4,2021-02-01,0,0,0,0,2021-02-01,1612134000.0
11483,52,4,2021-02-02,0,0,0,0,2021-02-02,1612220400.0
11484,52,4,2021-02-03,0,0,0,0,2021-02-03,1612306800.0
11485,52,4,2021-02-04,0,0,0,0,2021-02-04,1612393200.0
11486,52,4,2021-02-05,0,0,0,0,2021-02-05,1612479600.0
11487,52,4,2021-02-06,0,0,0,0,2021-02-06,1612566000.0
11488,52,4,2021-02-07,0,0,0,0,2021-02-07,1612652400.0
11489,52,4,2021-02-08,0,0,0,0,2021-02-08,1612738800.0
11490,52,4,2021-02-09,0,0,0,0,2021-02-09,1612825200.0
11491,52,4,2021-02-10,0,0,0,0,2021-02-10,1612911600.0
11492,52,4,2021-02-11,0,0,0,0,2021-02-11,1612998000.0
11493,52,4,2021-02-12,0,0,0,0,2021-02-12,1613084400.0
11494,52,4,2021-02-13,0,0,0,0,2021-02-13,1613170800.0
11495,52,4,2021-02-14,0,0,0,0,2021-02-14,1613257200.0
11496,52,4,2021-02-15,0,0,0,0,2021-02-15,1613343600.0
11497,52,4,2021-02-16,0,0,0,0,2021-02-16,1613430000.0
11498,52,4,2021-02-17,0,0,0,0,2021-02-17,1613516400.0
11499,52,4,2021-02-18,0,0,0,0,2021-02-18,1613602800.0
11500,52,4,2021-02-19,0,0,0,0,2021-02-19,1613689200.0
11501,52,4,2021-02-20,0,0,0,0,2021-02-20,1613775600.0
11502,52,4,2021-02-21,0,0,0,0,2021-02-21,1613862000.0
11503,52,4,2021-02-22,0,0,0,0,2021-02-22,1613948400.0
11504,52,4,2021-02-23,0,0,0,0,2021-02-23,1614034800.0
11505,52,4,2021-02-24,0,0,0,0,2021-02-24,1614121200.0
11506,52,4,2021-02-25,0,0,0,0,2021-02-25,1614207600.0
11507,52,4,2021-02-26,0,0,0,0,2021-02-26,1614294000.0
11508,52,4,2021-02-27,0,0,0,0,2021-02-27,1614380400.0
11509,52,4,2021-02-28,0,0,0,0,2021-02-28,1614466800.0
11510,52,4,2021-03-01,0,0,0,0,2021-03-01,1614553200.0
11511,52,4,2021-03-02,0,0,0,0,2021-03-02,1614639600.0
11512,52,4,2021-03-03,0,0,0,0,2021-03-03,1614726000.0
11513,52,4,2021-03-04,0,0,0,0,2021-03-04,1614812400.0
11514,52,4,2021-03-05,0,0,0,0,2021-03-05,1614898800.0
11515,52,4,2021-03-06,0,0,0,0,2021-03-06,1614985200.0
11516,52,4,2021-03-07,0,0,0,0,2021-03-07,1615071600.0
11517,52,4,2021-03-08,0,0,0,0,2021-03-08,1615158000.0
11518,52,4,2021-03-09,0,0,0,0,2021-03-09,1615244400.0
11519,52,4,2021-03-10,0,0,0,0,2021-03-10,1615330800.0
11520,52,4,2021-03-11,0,0,0,0,2021-03-11,1615417200.0
11521,52,4,2021-03-12,0,0,0,0,2021-03-12,1615503600.0
11522,52,4,2021-03-13,0,0,0,0,2021-03-13,1615590000.0
11523,52,4,2021-03-14,0,0,0,0,2021-03-14,1615676400.0
11524,52,4,2021-03-15,0,0,0,0,2021-03-15,1615762800.0
11525,52,4,2021-03-16,0,0,0,0,2021-03-16,1615849200.0
11526,52,4,2021-03-17,0,0,0,0,2021-03-17,1615935600.0
11527,52,4,2021-03-18,0,0,0,0,2021-03-18,1616022000.0
11528,52,4,2021-03-19,0,0,0,0,2021-03-19,1616108400.0
11529,52,4,2021-03-20,0,0,0,0,2021-03-20,1616194800.0
11530,52,4,2021-03-21,0,0,0,0,2021-03-21,1616281200.0
11531,52,4,2021-03-22,0,0,0,0,2021-03-22,1616367600.0
11532,52,4,2021-03-23,0,0,0,0,2021-03-23,1616454000.0
11533,52,4,2021-03-24,0,0,0,0,2021-03-24,1616540400.0
11534,52,4,2021-03-25,0,0,0,0,2021-03-25,1616626800.0
11535,52,4,2021-03-26,0,0,0,0,2021-03-26,1616713200.0
11536,52,4,2021-03-27,0,0,0,0,2021-03-27,1616799600.0
11537,52,4,2021-03-28,0,0,0,0,2021-03-28,1616886000.0
11538,52,4,2021-03-29,0,0,0,0,2021-03-29,1616972400.0
11539,52,4,2021-03-30,0,0,0,0,2021-03-30,1617058800.0
11540,52,4,2021-03-31,0,0,0,0,2021-03-31,1617145200.0
11541,52,4,2021-04-01,0,0,0,0,2021-04-01,1617231600.0
11542,52,4,2021-04-02,0,0,0,0,2021-04-02,1617318000.0
11543,52,4,2021-04-03,0,0,0,0,2021-04-03,1617404400.0
11544,52,4,2021-04-04,0,0,0,0,2021-04-04,1617490800.0
11545,52,4,2021-04-05,0,0,0,0,2021-04-05,1617577200.0
11546,52,4,2021-04-06,0,0,0,0,2021-04-06,1617663600.0
11547,52,4,2021-04-07,0,0,0,0,2021-04-07,1617750000.0
11548,52,4,2021-04-08,0,0,0,0,2021-04-08,1617836400.0
11549,52,4,2021-04-09,0,0,0,0,2021-04-09,1617922800.0
11550,52,4,2021-04-10,0,0,0,0,2021-04-10,1618009200.0
11551,52,4,2021-04-11,0,0,0,0,2021-04-11,1618095600.0
11552,52,4,2021-04-12,0,0,0,0,2021-04-12,1618185600.0
11553,52,4,2021-04-13,0,0,0,0,2021-04-13,1618272000.0
11554,52,4,2021-04-14,0,0,0,0,2021-04-14,1618358400.0
11555,52,4,2021-04-15,0,0,0,0,2021-04-15,1618444800.0
11556,52,4,2021-04-16,0,0,0,0,2021-04-16,1618531200.0
11557,52,4,2021-04-17,0,0,0,0,2021-04-17,1618617600.0
11558,52,4,2021-04-18,0,0,0,0,2021-04-18,1618704000.0
11559,52,4,2021-04-19,0,0,0,0,2021-04-19,1618790400.0
11560,52,4,2021-04-20,0,0,0,0,2021-04-20,1618876800.0
11561,52,4,2021-04-21,0,0,0,0,2021-04-21,1618963200.0
11562,52,4,2021-04-22,0,0,0,0,2021-04-22,1619049600.0
11563,52,4,2021-04-23,47,0,47,0,2021-04-23,1619136000.0
11564,52,4,2021-04-24,129,0,176,0,2021-04-24,1619222400.0
11565,52,4,2021-04-25,10,0,186,0,2021-04-25,1619308800.0
11566,52,4,2021-04-26,261,0,447,0,2021-04-26,1619395200.0
11567,52,4,2021-04-27,742,0,1189,0,2021-04-27,1619481600.0
11568,52,4,2021-04-28,599,0,1788,0,2021-04-28,1619568000.0
11569,52,4,2021-04-29,1067,0,2855,0,2021-04-29,1619654400.0
11570,52,4,2021-04-30,1043,0,3898,0,2021-04-30,1619740800.0
11571,52,4,2021-05-01,111,0,4009,0,2021-05-01,1619827200.0
11572,52,4,2021-05-02,2,0,4011,0,2021-05-02,1619913600.0
11573,52,4,2021-05-03,258,0,4269,0,2021-05-03,1620000000.0
11574,52,4,2021-05-04,515,0,4784,0,2021-05-04,1620086400.0
11575,52,4,2021-05-05,426,0,5210,0,2021-05-05,1620172800.0
11576,52,4,2021-05-06,801,2,6011,2,2021-05-06,1620259200.0
11577,52,4,2021-05-07,1152,0,7163,2,2021-05-07,1620345600.0
11578,52,4,2021-05-08,57,1,7220,3,2021-05-08,1620432000.0
11579,52,4,2021-05-09,5,0,7225,3,2021-05-09,1620518400.0
11580,52,4,2021-05-10,442,0,7667,3,2021-05-10,1620604800.0
11581,52,4,2021-05-11,903,0,8570,3,2021-05-11,1620691200.0
11582,52,4,2021-05-12,573,0,9143,3,2021-05-12,1620777600.0
11583,52,4,2021-05-13,24,0,9167,3,2021-05-13,1620864000.0
11584,52,4,2021-05-14,258,1,9425,4,2021-05-14,1620950400.0
11585,52,4,2021-05-15,166,0,9591,4,2021-05-15,1621036800.0
11586,52,4,2021-05-16,12,1,9603,5,2021-05-16,1621123200.0
11587,52,4,2021-05-17,261,0,9864,5,2021-05-17,1621206000.0
11588,52,4,2021-05-18,596,1,10460,6,2021-05-18,1621292400.0
11589,52,4,2021-05-19,424,0,10884,6,2021-05-19,1621378800.0
11590,52,4,2021-05-20,579,0,11463,6,2021-05-20,1621465200.0
11591,52,4,2021-05-21,856,1,12319,7,2021-05-21,1621551600.0
11592,52,4,2021-05-22,232,0,12551,7,2021-05-22,1621638000.0
11593,52,4,2021-05-23,25,0,12576,7,2021-05-23,1621724400.0
11594,52,4,2021-05-24,38,0,12614,7,2021-05-24,1621810800.0
11595,52,4,2021-05-25,510,1,13124,8,2021-05-25,1621897200.0
11596,52,4,2021-05-26,412,0,13536,8,2021-05-26,1621983600.0
11597,52,4,2021-05-27,973,1,14509,9,2021-05-27,1622070000.0
11598,52,4,2021-05-28,1887,0,16396,9,2021-05-28,1622156400.0
11599,52,4,2021-05-29,659,0,17055,9,2021-05-29,1622242800.0
11600,52,4,2021-05-30,15,0,17070,9,2021-05-30,1622329200.0
11601,52,4,2021-05-31,863,2,17933,11,2021-05-31,1622415600.0
11602,52,4,2021-06-01,1210,1,19143,12,2021-06-01,1622502000.0
11603,52,4,2021-06-02,901,0,20044,12,2021-06-02,1622588400.0
11604,52,4,2021-06-03,1223,0,21267,12,2021-06-03,1622674800.0
11605,52,4,2021-06-04,1479,2,22746,14,2021-06-04,1622761200.0
11606,52,4,2021-06-05,398,1,23144,15,2021-06-05,1622847600.0
11607,52,4,2021-06-06,21,0,23165,15,2021-06-06,1622934000.0
11608,52,4,2021-06-07,555,0,23720,15,2021-06-07,1623020400.0
11609,52,4,2021-06-08,948,2,24668,17,2021-06-08,1623106800.0
11610,52,4,2021-06-09,872,0,25540,17,2021-06-09,1623193200.0
11611,52,4,2021-06-10,938,3,26478,20,2021-06-10,1623279600.0
11612,52,4,2021-06-11,1111,1,27589,21,2021-06-11,1623366000.0
11613,52,4,2021-06-12,417,1,28006,22,2021-06-12,1623452400.0
11614,52,4,2021-06-13,3,0,28009,22,2021-06-13,1623538800.0
11615,52,4,2021-06-14,424,3,28433,25,2021-06-14,1623625200.0
11616,52,4,2021-06-15,704,3,29137,28,2021-06-15,1623711600.0
11617,52,4,2021-06-16,640,2,29777,30,2021-06-16,1623798000.0
11618,52,4,2021-06-17,696,0,30473,30,2021-06-17,1623884400.0
11619,52,4,2021-06-18,690,0,31163,30,2021-06-18,1623970800.0
11620,52,4,2021-06-19,277,2,31440,32,2021-06-19,1624057200.0
11621,52,4,2021-06-20,12,0,31452,32,2021-06-20,1624143600.0
11622,52,4,2021-06-21,290,1,31742,33,2021-06-21,1624230000.0
11623,52,4,2021-06-22,449,1,32191,34,2021-06-22,1624316400.0
11624,52,4,2021-06-23,388,0,32579,34,2021-06-23,1624402800.0
11625,52,4,2021-06-24,473,6,33052,40,2021-06-24,1624489200.0
11626,52,4,2021-06-25,499,1,33551,41,2021-06-25,1624575600.0
11627,52,4,2021-06-26,230,0,33781,41,2021-06-26,1624662000.0
11628,52,4,2021-06-27,21,0,33802,41,2021-06-27,1624748400.0
11629,52,4,2021-06-28,259,0,34061,41,2021-06-28,1624834800.0
11630,52,4,2021-06-29,440,0,34501,41,2021-06-29,1624921200.0
11631,52,4,2021-06-30,415,2,34916,43,2021-06-30,1625007600.0
11632,52,4,2021-07-01,453,2,35369,45,2021-07-01,1625094000.0
11633,52,4,2021-07-02,610,2,35979,47,2021-07-02,1625180400.0
11634,52,4,2021-07-03,195,2,36174,49,2021-07-03,1625266800.0
11635,52,4,2021-07-04,12,0,36186,49,2021-07-04,1625353200.0
11636,52,4,2021-07-05,281,1,36467,50,2021-07-05,1625439600.0
11637,52,4,2021-07-06,417,3,36884,53,2021-07-06,1625526000.0
11638,52,4,2021-07-07,402,0,37286,53,2021-07-07,1625612400.0
11639,52,4,2021-07-08,462,0,37748,53,2021-07-08,1625698800.0
11640,53,1,2020-12-27,0,0,0,0,2020-12-27,1609023600.0
11641,53,1,2020-12-28,1,0,1,0,2020-12-28,1609110000.0
11642,53,1,2020-12-29,0,0,1,0,2020-12-29,1609196400.0
11643,53,1,2020-12-30,0,0,1,0,2020-12-30,1609282800.0
11644,53,1,2020-12-31,0,0,1,0,2020-12-31,1609369200.0
11645,53,1,2021-01-01,2,0,3,0,2021-01-01,1609455600.0
11646,53,1,2021-01-02,4,0,7,0,2021-01-02,1609542000.0
11647,53,1,2021-01-03,1,0,8,0,2021-01-03,1609628400.0
11648,53,1,2021-01-04,43,0,51,0,2021-01-04,1609714800.0
11649,53,1,2021-01-05,200,0,251,0,2021-01-05,1609801200.0
11650,53,1,2021-01-06,331,0,582,0,2021-01-06,1609887600.0
11651,53,1,2021-01-07,835,0,1417,0,2021-01-07,1609974000.0
11652,53,1,2021-01-08,1214,0,2631,0,2021-01-08,1610060400.0
11653,53,1,2021-01-09,34,0,2665,0,2021-01-09,1610146800.0
11654,53,1,2021-01-10,4,0,2669,0,2021-01-10,1610233200.0
11655,53,1,2021-01-11,1663,0,4332,0,2021-01-11,1610319600.0
11656,53,1,2021-01-12,3381,0,7713,0,2021-01-12,1610406000.0
11657,53,1,2021-01-13,3355,0,11068,0,2021-01-13,1610492400.0
11658,53,1,2021-01-14,3812,0,14880,0,2021-01-14,1610578800.0
11659,53,1,2021-01-15,3299,0,18179,0,2021-01-15,1610665200.0
11660,53,1,2021-01-16,684,3,18863,3,2021-01-16,1610751600.0
11661,53,1,2021-01-17,180,1,19043,4,2021-01-17,1610838000.0
11662,53,1,2021-01-18,3363,4,22406,8,2021-01-18,1610924400.0
11663,53,1,2021-01-19,8175,3,30581,11,2021-01-19,1611010800.0
11664,53,1,2021-01-20,7057,2,37638,13,2021-01-20,1611097200.0
11665,53,1,2021-01-21,11492,2,49130,15,2021-01-21,1611183600.0
11666,53,1,2021-01-22,7823,0,56953,15,2021-01-22,1611270000.0
11667,53,1,2021-01-23,1493,2,58446,17,2021-01-23,1611356400.0
11668,53,1,2021-01-24,255,1,58701,18,2021-01-24,1611442800.0
11669,53,1,2021-01-25,3056,34,61757,52,2021-01-25,1611529200.0
11670,53,1,2021-01-26,4116,231,65873,283,2021-01-26,1611615600.0
11671,53,1,2021-01-27,7240,319,73113,602,2021-01-27,1611702000.0
11672,53,1,2021-01-28,7138,634,80251,1236,2021-01-28,1611788400.0
11673,53,1,2021-01-29,4231,727,84482,1963,2021-01-29,1611874800.0
11674,53,1,2021-01-30,844,42,85326,2005,2021-01-30,1611961200.0
11675,53,1,2021-01-31,80,3,85406,2008,2021-01-31,1612047600.0
11676,53,1,2021-02-01,2211,1026,87617,3034,2021-02-01,1612134000.0
11677,53,1,2021-02-02,3436,2006,91053,5040,2021-02-02,1612220400.0
11678,53,1,2021-02-03,3174,2168,94227,7208,2021-02-03,1612306800.0
11679,53,1,2021-02-04,7098,2259,101325,9467,2021-02-04,1612393200.0
11680,53,1,2021-02-05,5588,2131,106913,11598,2021-02-05,1612479600.0
11681,53,1,2021-02-06,1197,275,108110,11873,2021-02-06,1612566000.0
11682,53,1,2021-02-07,214,132,108324,12005,2021-02-07,1612652400.0
11683,53,1,2021-02-08,1534,1527,109858,13532,2021-02-08,1612738800.0
11684,53,1,2021-02-09,3695,5238,113553,18770,2021-02-09,1612825200.0
11685,53,1,2021-02-10,3462,4625,117015,23395,2021-02-10,1612911600.0
11686,53,1,2021-02-11,5181,8764,122196,32159,2021-02-11,1612998000.0
11687,53,1,2021-02-12,5127,5228,127323,37387,2021-02-12,1613084400.0
11688,53,1,2021-02-13,1228,847,128551,38234,2021-02-13,1613170800.0
11689,53,1,2021-02-14,25,348,128576,38582,2021-02-14,1613257200.0
11690,53,1,2021-02-15,1428,3575,130004,42157,2021-02-15,1613343600.0
11691,53,1,2021-02-16,2659,3531,132663,45688,2021-02-16,1613430000.0
11692,53,1,2021-02-17,2803,5361,135466,51049,2021-02-17,1613516400.0
11693,53,1,2021-02-18,4404,5716,139870,56765,2021-02-18,1613602800.0
11694,53,1,2021-02-19,3359,4825,143229,61590,2021-02-19,1613689200.0
11695,53,1,2021-02-20,845,884,144074,62474,2021-02-20,1613775600.0
11696,53,1,2021-02-21,121,218,144195,62692,2021-02-21,1613862000.0
11697,53,1,2021-02-22,1382,2816,145577,65508,2021-02-22,1613948400.0
11698,53,1,2021-02-23,2585,3659,148162,69167,2021-02-23,1614034800.0
11699,53,1,2021-02-24,2604,3759,150766,72926,2021-02-24,1614121200.0
11700,53,1,2021-02-25,3947,7101,154713,80027,2021-02-25,1614207600.0
11701,53,1,2021-02-26,3606,4364,158319,84391,2021-02-26,1614294000.0
11702,53,1,2021-02-27,1037,1093,159356,85484,2021-02-27,1614380400.0
11703,53,1,2021-02-28,157,194,159513,85678,2021-02-28,1614466800.0
11704,53,1,2021-03-01,2275,2256,161788,87934,2021-03-01,1614553200.0
11705,53,1,2021-03-02,3520,4442,165308,92376,2021-03-02,1614639600.0
11706,53,1,2021-03-03,3810,3761,169118,96137,2021-03-03,1614726000.0
11707,53,1,2021-03-04,4468,4875,173586,101012,2021-03-04,1614812400.0
11708,53,1,2021-03-05,4750,5134,178336,106146,2021-03-05,1614898800.0
11709,53,1,2021-03-06,1357,986,179693,107132,2021-03-06,1614985200.0
11710,53,1,2021-03-07,132,138,179825,107270,2021-03-07,1615071600.0
11711,53,1,2021-03-08,2714,2176,182539,109446,2021-03-08,1615158000.0
11712,53,1,2021-03-09,4492,2870,187031,112316,2021-03-09,1615244400.0
11713,53,1,2021-03-10,4351,3258,191382,115574,2021-03-10,1615330800.0
11714,53,1,2021-03-11,5734,3899,197116,119473,2021-03-11,1615417200.0
11715,53,1,2021-03-12,5116,3006,202232,122479,2021-03-12,1615503600.0
11716,53,1,2021-03-13,1503,900,203735,123379,2021-03-13,1615590000.0
11717,53,1,2021-03-14,365,50,204100,123429,2021-03-14,1615676400.0
11718,53,1,2021-03-15,4036,1684,208136,125113,2021-03-15,1615762800.0
11719,53,1,2021-03-16,5825,2893,213961,128006,2021-03-16,1615849200.0
11720,53,1,2021-03-17,5999,2468,219960,130474,2021-03-17,1615935600.0
11721,53,1,2021-03-18,6517,4312,226477,134786,2021-03-18,1616022000.0
11722,53,1,2021-03-19,5689,3245,232166,138031,2021-03-19,1616108400.0
11723,53,1,2021-03-20,3389,769,235555,138800,2021-03-20,1616194800.0
11724,53,1,2021-03-21,273,30,235828,138830,2021-03-21,1616281200.0
11725,53,1,2021-03-22,5115,1947,240943,140777,2021-03-22,1616367600.0
11726,53,1,2021-03-23,7260,2936,248203,143713,2021-03-23,1616454000.0
11727,53,1,2021-03-24,7620,2583,255823,146296,2021-03-24,1616540400.0
11728,53,1,2021-03-25,8025,2880,263848,149176,2021-03-25,1616626800.0
11729,53,1,2021-03-26,7858,2769,271706,151945,2021-03-26,1616713200.0
11730,53,1,2021-03-27,3616,961,275322,152906,2021-03-27,1616799600.0
11731,53,1,2021-03-28,330,34,275652,152940,2021-03-28,1616886000.0
11732,53,1,2021-03-29,6190,2962,281842,155902,2021-03-29,1616972400.0
11733,53,1,2021-03-30,8853,4341,290695,160243,2021-03-30,1617058800.0
11734,53,1,2021-03-31,8991,3956,299686,164199,2021-03-31,1617145200.0
11735,53,1,2021-04-01,11288,4027,310974,168226,2021-04-01,1617231600.0
11736,53,1,2021-04-02,10352,4002,321326,172228,2021-04-02,1617318000.0
11737,53,1,2021-04-03,4566,1384,325892,173612,2021-04-03,1617404400.0
11738,53,1,2021-04-04,375,31,326267,173643,2021-04-04,1617490800.0
11739,53,1,2021-04-05,1171,325,327438,173968,2021-04-05,1617577200.0
11740,53,1,2021-04-06,9751,5322,337189,179290,2021-04-06,1617663600.0
11741,53,1,2021-04-07,11538,4956,348727,184246,2021-04-07,1617750000.0
11742,53,1,2021-04-08,12556,5671,361283,189917,2021-04-08,1617836400.0
11743,53,1,2021-04-09,12985,4840,374268,194757,2021-04-09,1617922800.0
11744,53,1,2021-04-10,5214,1588,379482,196345,2021-04-10,1618009200.0
11745,53,1,2021-04-11,292,183,379774,196528,2021-04-11,1618095600.0
11746,53,1,2021-04-12,11016,4342,390790,200870,2021-04-12,1618185600.0
11747,53,1,2021-04-13,15000,6077,405790,206947,2021-04-13,1618272000.0
11748,53,1,2021-04-14,13373,5677,419163,212624,2021-04-14,1618358400.0
11749,53,1,2021-04-15,16164,5792,435327,218416,2021-04-15,1618444800.0
11750,53,1,2021-04-16,14787,5206,450114,223622,2021-04-16,1618531200.0
11751,53,1,2021-04-17,5706,3271,455820,226893,2021-04-17,1618617600.0
11752,53,1,2021-04-18,963,139,456783,227032,2021-04-18,1618704000.0
11753,53,1,2021-04-19,12034,5896,468817,232928,2021-04-19,1618790400.0
11754,53,1,2021-04-20,12256,8349,481073,241277,2021-04-20,1618876800.0
11755,53,1,2021-04-21,12270,8289,493343,249566,2021-04-21,1618963200.0
11756,53,1,2021-04-22,14259,8638,507602,258204,2021-04-22,1619049600.0
11757,53,1,2021-04-23,12735,8161,520337,266365,2021-04-23,1619136000.0
11758,53,1,2021-04-24,5766,3833,526103,270198,2021-04-24,1619222400.0
11759,53,1,2021-04-25,885,319,526988,270517,2021-04-25,1619308800.0
11760,53,1,2021-04-26,14610,7327,541598,277844,2021-04-26,1619395200.0
11761,53,1,2021-04-27,15149,9685,556747,287529,2021-04-27,1619481600.0
11762,53,1,2021-04-28,15927,8584,572674,296113,2021-04-28,1619568000.0
11763,53,1,2021-04-29,15330,8717,588004,304830,2021-04-29,1619654400.0
11764,53,1,2021-04-30,14943,9217,602947,314047,2021-04-30,1619740800.0
11765,53,1,2021-05-01,3988,1374,606935,315421,2021-05-01,1619827200.0
11766,53,1,2021-05-02,413,349,607348,315770,2021-05-02,1619913600.0
11767,53,1,2021-05-03,12869,7979,620217,323749,2021-05-03,1620000000.0
11768,53,1,2021-05-04,12233,13516,632450,337265,2021-05-04,1620086400.0
11769,53,1,2021-05-05,12247,12421,644697,349686,2021-05-05,1620172800.0
11770,53,1,2021-05-06,14223,13393,658920,363079,2021-05-06,1620259200.0
11771,53,1,2021-05-07,11988,13128,670908,376207,2021-05-07,1620345600.0
11772,53,1,2021-05-08,3066,735,673974,376942,2021-05-08,1620432000.0
11773,53,1,2021-05-09,2053,370,676027,377312,2021-05-09,1620518400.0
11774,53,1,2021-05-10,12037,12457,688064,389769,2021-05-10,1620604800.0
11775,53,1,2021-05-11,13228,14433,701292,404202,2021-05-11,1620691200.0
11776,53,1,2021-05-12,16236,11473,717528,415675,2021-05-12,1620777600.0
11777,53,1,2021-05-13,7048,3343,724576,419018,2021-05-13,1620864000.0
11778,53,1,2021-05-14,17172,9740,741748,428758,2021-05-14,1620950400.0
11779,53,1,2021-05-15,8981,3260,750729,432018,2021-05-15,1621036800.0
11780,53,1,2021-05-16,3194,566,753923,432584,2021-05-16,1621123200.0
11781,53,1,2021-05-17,14103,8210,768026,440794,2021-05-17,1621206000.0
11782,53,1,2021-05-18,15960,8126,783986,448920,2021-05-18,1621292400.0
11783,53,1,2021-05-19,17176,6883,801162,455803,2021-05-19,1621378800.0
11784,53,1,2021-05-20,18067,7955,819229,463758,2021-05-20,1621465200.0
11785,53,1,2021-05-21,18619,7888,837848,471646,2021-05-21,1621551600.0
11786,53,1,2021-05-22,9760,2782,847608,474428,2021-05-22,1621638000.0
11787,53,1,2021-05-23,2040,229,849648,474657,2021-05-23,1621724400.0
11788,53,1,2021-05-24,13852,1932,863500,476589,2021-05-24,1621810800.0
11789,53,1,2021-05-25,18893,8410,882393,484999,2021-05-25,1621897200.0
11790,53,1,2021-05-26,18395,8854,900788,493853,2021-05-26,1621983600.0
11791,53,1,2021-05-27,19987,9507,920775,503360,2021-05-27,1622070000.0
11792,53,1,2021-05-28,17803,10466,938578,513826,2021-05-28,1622156400.0
11793,53,1,2021-05-29,8807,3705,947385,517531,2021-05-29,1622242800.0
11794,53,1,2021-05-30,2258,341,949643,517872,2021-05-30,1622329200.0
11795,53,1,2021-05-31,17927,9315,967570,527187,2021-05-31,1622415600.0
11796,53,1,2021-06-01,19134,9338,986704,536525,2021-06-01,1622502000.0
11797,53,1,2021-06-02,19335,7870,1006039,544395,2021-06-02,1622588400.0
11798,53,1,2021-06-03,21604,7454,1027643,551849,2021-06-03,1622674800.0
11799,53,1,2021-06-04,18254,10011,1045897,561860,2021-06-04,1622761200.0
11800,53,1,2021-06-05,14740,4273,1060637,566133,2021-06-05,1622847600.0
11801,53,1,2021-06-06,4874,978,1065511,567111,2021-06-06,1622934000.0
11802,53,1,2021-06-07,16539,12949,1082050,580060,2021-06-07,1623020400.0
11803,53,1,2021-06-08,20010,11972,1102060,592032,2021-06-08,1623106800.0
11804,53,1,2021-06-09,21199,10426,1123259,602458,2021-06-09,1623193200.0
11805,53,1,2021-06-10,23660,8328,1146919,610786,2021-06-10,1623279600.0
11806,53,1,2021-06-11,21503,10628,1168422,621414,2021-06-11,1623366000.0
11807,53,1,2021-06-12,16178,3878,1184600,625292,2021-06-12,1623452400.0
11808,53,1,2021-06-13,7667,569,1192267,625861,2021-06-13,1623538800.0
11809,53,1,2021-06-14,13901,14579,1206168,640440,2021-06-14,1623625200.0
11810,53,1,2021-06-15,16466,13356,1222634,653796,2021-06-15,1623711600.0
11811,53,1,2021-06-16,18716,11500,1241350,665296,2021-06-16,1623798000.0
11812,53,1,2021-06-17,19024,10553,1260374,675849,2021-06-17,1623884400.0
11813,53,1,2021-06-18,17903,13122,1278277,688971,2021-06-18,1623970800.0
11814,53,1,2021-06-19,11094,4056,1289371,693027,2021-06-19,1624057200.0
11815,53,1,2021-06-20,5375,1659,1294746,694686,2021-06-20,1624143600.0
11816,53,1,2021-06-21,12998,15483,1307744,710169,2021-06-21,1624230000.0
11817,53,1,2021-06-22,14101,16031,1321845,726200,2021-06-22,1624316400.0
11818,53,1,2021-06-23,14988,15788,1336833,741988,2021-06-23,1624402800.0
11819,53,1,2021-06-24,16749,11711,1353582,753699,2021-06-24,1624489200.0
11820,53,1,2021-06-25,12500,16790,1366082,770489,2021-06-25,1624575600.0
11821,53,1,2021-06-26,5801,8402,1371883,778891,2021-06-26,1624662000.0
11822,53,1,2021-06-27,3834,2921,1375717,781812,2021-06-27,1624748400.0
11823,53,1,2021-06-28,8589,18389,1384306,800201,2021-06-28,1624834800.0
11824,53,1,2021-06-29,9679,18750,1393985,818951,2021-06-29,1624921200.0
11825,53,1,2021-06-30,10820,18412,1404805,837363,2021-06-30,1625007600.0
11826,53,1,2021-07-01,12460,16124,1417265,853487,2021-07-01,1625094000.0
11827,53,1,2021-07-02,11028,19299,1428293,872786,2021-07-02,1625180400.0
11828,53,1,2021-07-03,5390,9797,1433683,882583,2021-07-03,1625266800.0
11829,53,1,2021-07-04,3786,3510,1437469,886093,2021-07-04,1625353200.0
11830,53,1,2021-07-05,8130,21964,1445599,908057,2021-07-05,1625439600.0
11831,53,1,2021-07-06,9240,21777,1454839,929834,2021-07-06,1625526000.0
11832,53,1,2021-07-07,10705,19344,1465544,949178,2021-07-07,1625612400.0
11833,53,1,2021-07-08,11150,19132,1476694,968310,2021-07-08,1625698800.0
11834,53,2,2020-12-27,0,0,0,0,2020-12-27,1609023600.0
11835,53,2,2020-12-28,0,0,0,0,2020-12-28,1609110000.0
11836,53,2,2020-12-29,0,0,0,0,2020-12-29,1609196400.0
11837,53,2,2020-12-30,0,0,0,0,2020-12-30,1609282800.0
11838,53,2,2020-12-31,0,0,0,0,2020-12-31,1609369200.0
11839,53,2,2021-01-01,0,0,0,0,2021-01-01,1609455600.0
11840,53,2,2021-01-02,0,0,0,0,2021-01-02,1609542000.0
11841,53,2,2021-01-03,0,0,0,0,2021-01-03,1609628400.0
11842,53,2,2021-01-04,0,0,0,0,2021-01-04,1609714800.0
11843,53,2,2021-01-05,0,0,0,0,2021-01-05,1609801200.0
11844,53,2,2021-01-06,0,0,0,0,2021-01-06,1609887600.0
11845,53,2,2021-01-07,0,0,0,0,2021-01-07,1609974000.0
11846,53,2,2021-01-08,0,0,0,0,2021-01-08,1610060400.0
11847,53,2,2021-01-09,0,0,0,0,2021-01-09,1610146800.0
11848,53,2,2021-01-10,0,0,0,0,2021-01-10,1610233200.0
11849,53,2,2021-01-11,0,0,0,0,2021-01-11,1610319600.0
11850,53,2,2021-01-12,0,0,0,0,2021-01-12,1610406000.0
11851,53,2,2021-01-13,0,0,0,0,2021-01-13,1610492400.0
11852,53,2,2021-01-14,1,0,1,0,2021-01-14,1610578800.0
11853,53,2,2021-01-15,0,0,1,0,2021-01-15,1610665200.0
11854,53,2,2021-01-16,0,0,1,0,2021-01-16,1610751600.0
11855,53,2,2021-01-17,0,0,1,0,2021-01-17,1610838000.0
11856,53,2,2021-01-18,0,0,1,0,2021-01-18,1610924400.0
11857,53,2,2021-01-19,2,0,3,0,2021-01-19,1611010800.0
11858,53,2,2021-01-20,3,0,6,0,2021-01-20,1611097200.0
11859,53,2,2021-01-21,1,0,7,0,2021-01-21,1611183600.0
11860,53,2,2021-01-22,1,0,8,0,2021-01-22,1611270000.0
11861,53,2,2021-01-23,0,0,8,0,2021-01-23,1611356400.0
11862,53,2,2021-01-24,0,0,8,0,2021-01-24,1611442800.0
11863,53,2,2021-01-25,0,0,8,0,2021-01-25,1611529200.0
11864,53,2,2021-01-26,0,0,8,0,2021-01-26,1611615600.0
11865,53,2,2021-01-27,0,0,8,0,2021-01-27,1611702000.0
11866,53,2,2021-01-28,0,0,8,0,2021-01-28,1611788400.0
11867,53,2,2021-01-29,1,0,9,0,2021-01-29,1611874800.0
11868,53,2,2021-01-30,0,0,9,0,2021-01-30,1611961200.0
11869,53,2,2021-01-31,0,0,9,0,2021-01-31,1612047600.0
11870,53,2,2021-02-01,0,0,9,0,2021-02-01,1612134000.0
11871,53,2,2021-02-02,0,0,9,0,2021-02-02,1612220400.0
11872,53,2,2021-02-03,0,0,9,0,2021-02-03,1612306800.0
11873,53,2,2021-02-04,0,0,9,0,2021-02-04,1612393200.0
11874,53,2,2021-02-05,0,0,9,0,2021-02-05,1612479600.0
11875,53,2,2021-02-06,0,0,9,0,2021-02-06,1612566000.0
11876,53,2,2021-02-07,0,0,9,0,2021-02-07,1612652400.0
11877,53,2,2021-02-08,0,0,9,0,2021-02-08,1612738800.0
11878,53,2,2021-02-09,0,1,9,1,2021-02-09,1612825200.0
11879,53,2,2021-02-10,0,1,9,2,2021-02-10,1612911600.0
11880,53,2,2021-02-11,107,1,116,3,2021-02-11,1612998000.0
11881,53,2,2021-02-12,94,1,210,4,2021-02-12,1613084400.0
11882,53,2,2021-02-13,0,0,210,4,2021-02-13,1613170800.0
11883,53,2,2021-02-14,0,0,210,4,2021-02-14,1613257200.0
11884,53,2,2021-02-15,407,0,617,4,2021-02-15,1613343600.0
11885,53,2,2021-02-16,564,2,1181,6,2021-02-16,1613430000.0
11886,53,2,2021-02-17,312,0,1493,6,2021-02-17,1613516400.0
11887,53,2,2021-02-18,259,2,1752,8,2021-02-18,1613602800.0
11888,53,2,2021-02-19,339,0,2091,8,2021-02-19,1613689200.0
11889,53,2,2021-02-20,1,0,2092,8,2021-02-20,1613775600.0
11890,53,2,2021-02-21,0,0,2092,8,2021-02-21,1613862000.0
11891,53,2,2021-02-22,137,0,2229,8,2021-02-22,1613948400.0
11892,53,2,2021-02-23,723,0,2952,8,2021-02-23,1614034800.0
11893,53,2,2021-02-24,637,1,3589,9,2021-02-24,1614121200.0
11894,53,2,2021-02-25,344,1,3933,10,2021-02-25,1614207600.0
11895,53,2,2021-02-26,229,0,4162,10,2021-02-26,1614294000.0
11896,53,2,2021-02-27,4,0,4166,10,2021-02-27,1614380400.0
11897,53,2,2021-02-28,0,0,4166,10,2021-02-28,1614466800.0
11898,53,2,2021-03-01,121,0,4287,10,2021-03-01,1614553200.0
11899,53,2,2021-03-02,141,0,4428,10,2021-03-02,1614639600.0
11900,53,2,2021-03-03,121,1,4549,11,2021-03-03,1614726000.0
11901,53,2,2021-03-04,68,0,4617,11,2021-03-04,1614812400.0
11902,53,2,2021-03-05,256,0,4873,11,2021-03-05,1614898800.0
11903,53,2,2021-03-06,0,0,4873,11,2021-03-06,1614985200.0
11904,53,2,2021-03-07,0,0,4873,11,2021-03-07,1615071600.0
11905,53,2,2021-03-08,159,0,5032,11,2021-03-08,1615158000.0
11906,53,2,2021-03-09,414,0,5446,11,2021-03-09,1615244400.0
11907,53,2,2021-03-10,352,51,5798,62,2021-03-10,1615330800.0
11908,53,2,2021-03-11,223,57,6021,119,2021-03-11,1615417200.0
11909,53,2,2021-03-12,497,83,6518,202,2021-03-12,1615503600.0
11910,53,2,2021-03-13,79,3,6597,205,2021-03-13,1615590000.0
11911,53,2,2021-03-14,12,0,6609,205,2021-03-14,1615676400.0
11912,53,2,2021-03-15,247,310,6856,515,2021-03-15,1615762800.0
11913,53,2,2021-03-16,1082,455,7938,970,2021-03-16,1615849200.0
11914,53,2,2021-03-17,2127,287,10065,1257,2021-03-17,1615935600.0
11915,53,2,2021-03-18,2154,263,12219,1520,2021-03-18,1616022000.0
11916,53,2,2021-03-19,2214,320,14433,1840,2021-03-19,1616108400.0
11917,53,2,2021-03-20,218,0,14651,1840,2021-03-20,1616194800.0
11918,53,2,2021-03-21,0,0,14651,1840,2021-03-21,1616281200.0
11919,53,2,2021-03-22,312,164,14963,2004,2021-03-22,1616367600.0
11920,53,2,2021-03-23,972,648,15935,2652,2021-03-23,1616454000.0
11921,53,2,2021-03-24,1079,578,17014,3230,2021-03-24,1616540400.0
11922,53,2,2021-03-25,1441,345,18455,3575,2021-03-25,1616626800.0
11923,53,2,2021-03-26,1444,273,19899,3848,2021-03-26,1616713200.0
11924,53,2,2021-03-27,102,22,20001,3870,2021-03-27,1616799600.0
11925,53,2,2021-03-28,72,50,20073,3920,2021-03-28,1616886000.0
11926,53,2,2021-03-29,544,138,20617,4058,2021-03-29,1616972400.0
11927,53,2,2021-03-30,1463,147,22080,4205,2021-03-30,1617058800.0
11928,53,2,2021-03-31,1340,184,23420,4389,2021-03-31,1617145200.0
11929,53,2,2021-04-01,1852,61,25272,4450,2021-04-01,1617231600.0
11930,53,2,2021-04-02,1421,177,26693,4627,2021-04-02,1617318000.0
11931,53,2,2021-04-03,1,0,26694,4627,2021-04-03,1617404400.0
11932,53,2,2021-04-04,0,0,26694,4627,2021-04-04,1617490800.0
11933,53,2,2021-04-05,4,0,26698,4627,2021-04-05,1617577200.0
11934,53,2,2021-04-06,1274,239,27972,4866,2021-04-06,1617663600.0
11935,53,2,2021-04-07,1269,252,29241,5118,2021-04-07,1617750000.0
11936,53,2,2021-04-08,2102,231,31343,5349,2021-04-08,1617836400.0
11937,53,2,2021-04-09,1498,441,32841,5790,2021-04-09,1617922800.0
11938,53,2,2021-04-10,649,43,33490,5833,2021-04-10,1618009200.0
11939,53,2,2021-04-11,421,23,33911,5856,2021-04-11,1618095600.0
11940,53,2,2021-04-12,1337,431,35248,6287,2021-04-12,1618185600.0
11941,53,2,2021-04-13,1629,864,36877,7151,2021-04-13,1618272000.0
11942,53,2,2021-04-14,1138,2028,38015,9179,2021-04-14,1618358400.0
11943,53,2,2021-04-15,2278,1995,40293,11174,2021-04-15,1618444800.0
11944,53,2,2021-04-16,1857,2021,42150,13195,2021-04-16,1618531200.0
11945,53,2,2021-04-17,1015,224,43165,13419,2021-04-17,1618617600.0
11946,53,2,2021-04-18,3,0,43168,13419,2021-04-18,1618704000.0
11947,53,2,2021-04-19,1342,462,44510,13881,2021-04-19,1618790400.0
11948,53,2,2021-04-20,1237,924,45747,14805,2021-04-20,1618876800.0
11949,53,2,2021-04-21,1159,921,46906,15726,2021-04-21,1618963200.0
11950,53,2,2021-04-22,3020,1197,49926,16923,2021-04-22,1619049600.0
11951,53,2,2021-04-23,2374,1498,52300,18421,2021-04-23,1619136000.0
11952,53,2,2021-04-24,906,18,53206,18439,2021-04-24,1619222400.0
11953,53,2,2021-04-25,0,0,53206,18439,2021-04-25,1619308800.0
11954,53,2,2021-04-26,1789,631,54995,19070,2021-04-26,1619395200.0
11955,53,2,2021-04-27,1354,1421,56349,20491,2021-04-27,1619481600.0
11956,53,2,2021-04-28,1347,1253,57696,21744,2021-04-28,1619568000.0
11957,53,2,2021-04-29,3494,1752,61190,23496,2021-04-29,1619654400.0
11958,53,2,2021-04-30,3060,1171,64250,24667,2021-04-30,1619740800.0
11959,53,2,2021-05-01,169,2,64419,24669,2021-05-01,1619827200.0
11960,53,2,2021-05-02,2277,83,66696,24752,2021-05-02,1619913600.0
11961,53,2,2021-05-03,1526,756,68222,25508,2021-05-03,1620000000.0
11962,53,2,2021-05-04,1205,1200,69427,26708,2021-05-04,1620086400.0
11963,53,2,2021-05-05,1005,1287,70432,27995,2021-05-05,1620172800.0
11964,53,2,2021-05-06,1457,2365,71889,30360,2021-05-06,1620259200.0
11965,53,2,2021-05-07,1244,2140,73133,32500,2021-05-07,1620345600.0
11966,53,2,2021-05-08,2103,21,75236,32521,2021-05-08,1620432000.0
11967,53,2,2021-05-09,1415,415,76651,32936,2021-05-09,1620518400.0
11968,53,2,2021-05-10,3051,1670,79702,34606,2021-05-10,1620604800.0
11969,53,2,2021-05-11,2247,1991,81949,36597,2021-05-11,1620691200.0
11970,53,2,2021-05-12,2831,1530,84780,38127,2021-05-12,1620777600.0
11971,53,2,2021-05-13,1790,225,86570,38352,2021-05-13,1620864000.0
11972,53,2,2021-05-14,2523,1423,89093,39775,2021-05-14,1620950400.0
11973,53,2,2021-05-15,3625,539,92718,40314,2021-05-15,1621036800.0
11974,53,2,2021-05-16,1,0,92719,40314,2021-05-16,1621123200.0
11975,53,2,2021-05-17,3178,1461,95897,41775,2021-05-17,1621206000.0
11976,53,2,2021-05-18,3177,1346,99074,43121,2021-05-18,1621292400.0
11977,53,2,2021-05-19,3501,956,102575,44077,2021-05-19,1621378800.0
11978,53,2,2021-05-20,4103,2256,106678,46333,2021-05-20,1621465200.0
11979,53,2,2021-05-21,2147,1399,108825,47732,2021-05-21,1621551600.0
11980,53,2,2021-05-22,2734,764,111559,48496,2021-05-22,1621638000.0
11981,53,2,2021-05-23,941,2,112500,48498,2021-05-23,1621724400.0
11982,53,2,2021-05-24,133,83,112633,48581,2021-05-24,1621810800.0
11983,53,2,2021-05-25,408,1389,113041,49970,2021-05-25,1621897200.0
11984,53,2,2021-05-26,404,1110,113445,51080,2021-05-26,1621983600.0
11985,53,2,2021-05-27,559,1657,114004,52737,2021-05-27,1622070000.0
11986,53,2,2021-05-28,1454,1578,115458,54315,2021-05-28,1622156400.0
11987,53,2,2021-05-29,2516,352,117974,54667,2021-05-29,1622242800.0
11988,53,2,2021-05-30,34,6,118008,54673,2021-05-30,1622329200.0
11989,53,2,2021-05-31,1855,1701,119863,56374,2021-05-31,1622415600.0
11990,53,2,2021-06-01,2711,2125,122574,58499,2021-06-01,1622502000.0
11991,53,2,2021-06-02,1547,1617,124121,60116,2021-06-02,1622588400.0
11992,53,2,2021-06-03,2094,2099,126215,62215,2021-06-03,1622674800.0
11993,53,2,2021-06-04,3069,2581,129284,64796,2021-06-04,1622761200.0
11994,53,2,2021-06-05,1838,861,131122,65657,2021-06-05,1622847600.0
11995,53,2,2021-06-06,109,14,131231,65671,2021-06-06,1622934000.0
11996,53,2,2021-06-07,1284,2168,132515,67839,2021-06-07,1623020400.0
11997,53,2,2021-06-08,2324,1810,134839,69649,2021-06-08,1623106800.0
11998,53,2,2021-06-09,1723,1648,136562,71297,2021-06-09,1623193200.0
11999,53,2,2021-06-10,1952,2227,138514,73524,2021-06-10,1623279600.0
12000,53,2,2021-06-11,3551,2206,142065,75730,2021-06-11,1623366000.0
12001,53,2,2021-06-12,2048,727,144113,76457,2021-06-12,1623452400.0
12002,53,2,2021-06-13,97,2158,144210,78615,2021-06-13,1623538800.0
12003,53,2,2021-06-14,1670,1702,145880,80317,2021-06-14,1623625200.0
12004,53,2,2021-06-15,2895,1485,148775,81802,2021-06-15,1623711600.0
12005,53,2,2021-06-16,1854,1222,150629,83024,2021-06-16,1623798000.0
12006,53,2,2021-06-17,2230,1593,152859,84617,2021-06-17,1623884400.0
12007,53,2,2021-06-18,3332,1573,156191,86190,2021-06-18,1623970800.0
12008,53,2,2021-06-19,1368,2481,157559,88671,2021-06-19,1624057200.0
12009,53,2,2021-06-20,55,741,157614,89412,2021-06-20,1624143600.0
12010,53,2,2021-06-21,1252,3105,158866,92517,2021-06-21,1624230000.0
12011,53,2,2021-06-22,2324,2820,161190,95337,2021-06-22,1624316400.0
12012,53,2,2021-06-23,1359,2686,162549,98023,2021-06-23,1624402800.0
12013,53,2,2021-06-24,1760,2866,164309,100889,2021-06-24,1624489200.0
12014,53,2,2021-06-25,2386,3354,166695,104243,2021-06-25,1624575600.0
12015,53,2,2021-06-26,1083,3235,167778,107478,2021-06-26,1624662000.0
12016,53,2,2021-06-27,27,32,167805,107510,2021-06-27,1624748400.0
12017,53,2,2021-06-28,814,2987,168619,110497,2021-06-28,1624834800.0
12018,53,2,2021-06-29,1250,3237,169869,113734,2021-06-29,1624921200.0
12019,53,2,2021-06-30,834,3373,170703,117107,2021-06-30,1625007600.0
12020,53,2,2021-07-01,1127,3830,171830,120937,2021-07-01,1625094000.0
12021,53,2,2021-07-02,1429,2227,173259,123164,2021-07-02,1625180400.0
12022,53,2,2021-07-03,873,3139,174132,126303,2021-07-03,1625266800.0
12023,53,2,2021-07-04,44,661,174176,126964,2021-07-04,1625353200.0
12024,53,2,2021-07-05,564,1086,174740,128050,2021-07-05,1625439600.0
12025,53,2,2021-07-06,902,1358,175642,129408,2021-07-06,1625526000.0
12026,53,2,2021-07-07,566,1236,176208,130644,2021-07-07,1625612400.0
12027,53,2,2021-07-08,1281,1727,177489,132371,2021-07-08,1625698800.0
12028,53,3,2020-12-27,0,0,0,0,2020-12-27,1609023600.0
12029,53,3,2020-12-28,0,0,0,0,2020-12-28,1609110000.0
12030,53,3,2020-12-29,0,0,0,0,2020-12-29,1609196400.0
12031,53,3,2020-12-30,0,0,0,0,2020-12-30,1609282800.0
12032,53,3,2020-12-31,0,0,0,0,2020-12-31,1609369200.0
12033,53,3,2021-01-01,0,0,0,0,2021-01-01,1609455600.0
12034,53,3,2021-01-02,0,0,0,0,2021-01-02,1609542000.0
12035,53,3,2021-01-03,0,0,0,0,2021-01-03,1609628400.0
12036,53,3,2021-01-04,0,0,0,0,2021-01-04,1609714800.0
12037,53,3,2021-01-05,0,0,0,0,2021-01-05,1609801200.0
12038,53,3,2021-01-06,0,0,0,0,2021-01-06,1609887600.0
12039,53,3,2021-01-07,0,0,0,0,2021-01-07,1609974000.0
12040,53,3,2021-01-08,0,0,0,0,2021-01-08,1610060400.0
12041,53,3,2021-01-09,0,0,0,0,2021-01-09,1610146800.0
12042,53,3,2021-01-10,0,0,0,0,2021-01-10,1610233200.0
12043,53,3,2021-01-11,0,0,0,0,2021-01-11,1610319600.0
12044,53,3,2021-01-12,0,0,0,0,2021-01-12,1610406000.0
12045,53,3,2021-01-13,0,0,0,0,2021-01-13,1610492400.0
12046,53,3,2021-01-14,0,0,0,0,2021-01-14,1610578800.0
12047,53,3,2021-01-15,0,0,0,0,2021-01-15,1610665200.0
12048,53,3,2021-01-16,0,0,0,0,2021-01-16,1610751600.0
12049,53,3,2021-01-17,0,0,0,0,2021-01-17,1610838000.0
12050,53,3,2021-01-18,0,0,0,0,2021-01-18,1610924400.0
12051,53,3,2021-01-19,0,0,0,0,2021-01-19,1611010800.0
12052,53,3,2021-01-20,0,0,0,0,2021-01-20,1611097200.0
12053,53,3,2021-01-21,0,0,0,0,2021-01-21,1611183600.0
12054,53,3,2021-01-22,0,0,0,0,2021-01-22,1611270000.0
12055,53,3,2021-01-23,0,0,0,0,2021-01-23,1611356400.0
12056,53,3,2021-01-24,0,0,0,0,2021-01-24,1611442800.0
12057,53,3,2021-01-25,0,0,0,0,2021-01-25,1611529200.0
12058,53,3,2021-01-26,0,0,0,0,2021-01-26,1611615600.0
12059,53,3,2021-01-27,0,0,0,0,2021-01-27,1611702000.0
12060,53,3,2021-01-28,0,0,0,0,2021-01-28,1611788400.0
12061,53,3,2021-01-29,0,0,0,0,2021-01-29,1611874800.0
12062,53,3,2021-01-30,0,0,0,0,2021-01-30,1611961200.0
12063,53,3,2021-01-31,0,0,0,0,2021-01-31,1612047600.0
12064,53,3,2021-02-01,0,0,0,0,2021-02-01,1612134000.0
12065,53,3,2021-02-02,0,0,0,0,2021-02-02,1612220400.0
12066,53,3,2021-02-03,0,0,0,0,2021-02-03,1612306800.0
12067,53,3,2021-02-04,0,0,0,0,2021-02-04,1612393200.0
12068,53,3,2021-02-05,0,0,0,0,2021-02-05,1612479600.0
12069,53,3,2021-02-06,7,0,7,0,2021-02-06,1612566000.0
12070,53,3,2021-02-07,0,0,7,0,2021-02-07,1612652400.0
12071,53,3,2021-02-08,117,0,124,0,2021-02-08,1612738800.0
12072,53,3,2021-02-09,283,0,407,0,2021-02-09,1612825200.0
12073,53,3,2021-02-10,331,0,738,0,2021-02-10,1612911600.0
12074,53,3,2021-02-11,452,0,1190,0,2021-02-11,1612998000.0
12075,53,3,2021-02-12,441,0,1631,0,2021-02-12,1613084400.0
12076,53,3,2021-02-13,4,0,1635,0,2021-02-13,1613170800.0
12077,53,3,2021-02-14,0,0,1635,0,2021-02-14,1613257200.0
12078,53,3,2021-02-15,491,0,2126,0,2021-02-15,1613343600.0
12079,53,3,2021-02-16,829,0,2955,0,2021-02-16,1613430000.0
12080,53,3,2021-02-17,961,0,3916,0,2021-02-17,1613516400.0
12081,53,3,2021-02-18,1291,0,5207,0,2021-02-18,1613602800.0
12082,53,3,2021-02-19,1657,0,6864,0,2021-02-19,1613689200.0
12083,53,3,2021-02-20,343,0,7207,0,2021-02-20,1613775600.0
12084,53,3,2021-02-21,45,0,7252,0,2021-02-21,1613862000.0
12085,53,3,2021-02-22,799,0,8051,0,2021-02-22,1613948400.0
12086,53,3,2021-02-23,639,0,8690,0,2021-02-23,1614034800.0
12087,53,3,2021-02-24,1233,0,9923,0,2021-02-24,1614121200.0
12088,53,3,2021-02-25,3660,0,13583,0,2021-02-25,1614207600.0
12089,53,3,2021-02-26,4842,0,18425,0,2021-02-26,1614294000.0
12090,53,3,2021-02-27,2407,0,20832,0,2021-02-27,1614380400.0
12091,53,3,2021-02-28,71,0,20903,0,2021-02-28,1614466800.0
12092,53,3,2021-03-01,1084,0,21987,0,2021-03-01,1614553200.0
12093,53,3,2021-03-02,1956,0,23943,0,2021-03-02,1614639600.0
12094,53,3,2021-03-03,2516,1,26459,1,2021-03-03,1614726000.0
12095,53,3,2021-03-04,4754,0,31213,1,2021-03-04,1614812400.0
12096,53,3,2021-03-05,6907,1,38120,2,2021-03-05,1614898800.0
12097,53,3,2021-03-06,4282,2,42402,4,2021-03-06,1614985200.0
12098,53,3,2021-03-07,781,0,43183,4,2021-03-07,1615071600.0
12099,53,3,2021-03-08,2295,1,45478,5,2021-03-08,1615158000.0
12100,53,3,2021-03-09,4758,1,50236,6,2021-03-09,1615244400.0
12101,53,3,2021-03-10,4574,2,54810,8,2021-03-10,1615330800.0
12102,53,3,2021-03-11,8348,2,63158,10,2021-03-11,1615417200.0
12103,53,3,2021-03-12,12989,3,76147,13,2021-03-12,1615503600.0
12104,53,3,2021-03-13,7234,3,83381,16,2021-03-13,1615590000.0
12105,53,3,2021-03-14,435,0,83816,16,2021-03-14,1615676400.0
12106,53,3,2021-03-15,2608,1,86424,17,2021-03-15,1615762800.0
12107,53,3,2021-03-16,79,0,86503,17,2021-03-16,1615849200.0
12108,53,3,2021-03-17,101,0,86604,17,2021-03-17,1615935600.0
12109,53,3,2021-03-18,46,0,86650,17,2021-03-18,1616022000.0
12110,53,3,2021-03-19,5090,0,91740,17,2021-03-19,1616108400.0
12111,53,3,2021-03-20,3521,1,95261,18,2021-03-20,1616194800.0
12112,53,3,2021-03-21,110,0,95371,18,2021-03-21,1616281200.0
12113,53,3,2021-03-22,1921,1,97292,19,2021-03-22,1616367600.0
12114,53,3,2021-03-23,4758,2,102050,21,2021-03-23,1616454000.0
12115,53,3,2021-03-24,5704,8,107754,29,2021-03-24,1616540400.0
12116,53,3,2021-03-25,8825,3,116579,32,2021-03-25,1616626800.0
12117,53,3,2021-03-26,11023,5,127602,37,2021-03-26,1616713200.0
12118,53,3,2021-03-27,3691,0,131293,37,2021-03-27,1616799600.0
12119,53,3,2021-03-28,127,0,131420,37,2021-03-28,1616886000.0
12120,53,3,2021-03-29,3066,0,134486,37,2021-03-29,1616972400.0
12121,53,3,2021-03-30,4998,5,139484,42,2021-03-30,1617058800.0
12122,53,3,2021-03-31,3821,2,143305,44,2021-03-31,1617145200.0
12123,53,3,2021-04-01,5068,5,148373,49,2021-04-01,1617231600.0
12124,53,3,2021-04-02,6131,8,154504,57,2021-04-02,1617318000.0
12125,53,3,2021-04-03,1872,4,156376,61,2021-04-03,1617404400.0
12126,53,3,2021-04-04,39,0,156415,61,2021-04-04,1617490800.0
12127,53,3,2021-04-05,58,0,156473,61,2021-04-05,1617577200.0
12128,53,3,2021-04-06,1504,0,157977,61,2021-04-06,1617663600.0
12129,53,3,2021-04-07,2215,3,160192,64,2021-04-07,1617750000.0
12130,53,3,2021-04-08,6061,1,166253,65,2021-04-08,1617836400.0
12131,53,3,2021-04-09,12198,31,178451,96,2021-04-09,1617922800.0
12132,53,3,2021-04-10,4490,10,182941,106,2021-04-10,1618009200.0
12133,53,3,2021-04-11,104,0,183045,106,2021-04-11,1618095600.0
12134,53,3,2021-04-12,3490,2,186535,108,2021-04-12,1618185600.0
12135,53,3,2021-04-13,6081,9,192616,117,2021-04-13,1618272000.0
12136,53,3,2021-04-14,4850,4,197466,121,2021-04-14,1618358400.0
12137,53,3,2021-04-15,6963,4,204429,125,2021-04-15,1618444800.0
12138,53,3,2021-04-16,9545,29,213974,154,2021-04-16,1618531200.0
12139,53,3,2021-04-17,3681,3,217655,157,2021-04-17,1618617600.0
12140,53,3,2021-04-18,68,0,217723,157,2021-04-18,1618704000.0
12141,53,3,2021-04-19,2033,3,219756,160,2021-04-19,1618790400.0
12142,53,3,2021-04-20,3435,12,223191,172,2021-04-20,1618876800.0
12143,53,3,2021-04-21,3319,12,226510,184,2021-04-21,1618963200.0
12144,53,3,2021-04-22,4497,33,231007,217,2021-04-22,1619049600.0
12145,53,3,2021-04-23,6489,53,237496,270,2021-04-23,1619136000.0
12146,53,3,2021-04-24,3118,36,240614,306,2021-04-24,1619222400.0
12147,53,3,2021-04-25,26,0,240640,306,2021-04-25,1619308800.0
12148,53,3,2021-04-26,1510,4,242150,310,2021-04-26,1619395200.0
12149,53,3,2021-04-27,2727,34,244877,344,2021-04-27,1619481600.0
12150,53,3,2021-04-28,2038,66,246915,410,2021-04-28,1619568000.0
12151,53,3,2021-04-29,3737,449,250652,859,2021-04-29,1619654400.0
12152,53,3,2021-04-30,4697,513,255349,1372,2021-04-30,1619740800.0
12153,53,3,2021-05-01,890,84,256239,1456,2021-05-01,1619827200.0
12154,53,3,2021-05-02,71,16,256310,1472,2021-05-02,1619913600.0
12155,53,3,2021-05-03,983,84,257293,1556,2021-05-03,1620000000.0
12156,53,3,2021-05-04,1829,314,259122,1870,2021-05-04,1620086400.0
12157,53,3,2021-05-05,1444,465,260566,2335,2021-05-05,1620172800.0
12158,53,3,2021-05-06,2953,1078,263519,3413,2021-05-06,1620259200.0
12159,53,3,2021-05-07,4101,1273,267620,4686,2021-05-07,1620345600.0
12160,53,3,2021-05-08,246,197,267866,4883,2021-05-08,1620432000.0
12161,53,3,2021-05-09,30,24,267896,4907,2021-05-09,1620518400.0
12162,53,3,2021-05-10,1192,419,269088,5326,2021-05-10,1620604800.0
12163,53,3,2021-05-11,2243,1029,271331,6355,2021-05-11,1620691200.0
12164,53,3,2021-05-12,1282,1391,272613,7746,2021-05-12,1620777600.0
12165,53,3,2021-05-13,161,181,272774,7927,2021-05-13,1620864000.0
12166,53,3,2021-05-14,1237,1382,274011,9309,2021-05-14,1620950400.0
12167,53,3,2021-05-15,518,999,274529,10308,2021-05-15,1621036800.0
12168,53,3,2021-05-16,14,234,274543,10542,2021-05-16,1621123200.0
12169,53,3,2021-05-17,576,766,275119,11308,2021-05-17,1621206000.0
12170,53,3,2021-05-18,1102,1672,276221,12980,2021-05-18,1621292400.0
12171,53,3,2021-05-19,609,1872,276830,14852,2021-05-19,1621378800.0
12172,53,3,2021-05-20,877,3014,277707,17866,2021-05-20,1621465200.0
12173,53,3,2021-05-21,1012,4225,278719,22091,2021-05-21,1621551600.0
12174,53,3,2021-05-22,318,1677,279037,23768,2021-05-22,1621638000.0
12175,53,3,2021-05-23,12,26,279049,23794,2021-05-23,1621724400.0
12176,53,3,2021-05-24,9,118,279058,23912,2021-05-24,1621810800.0
12177,53,3,2021-05-25,280,2027,279338,25939,2021-05-25,1621897200.0
12178,53,3,2021-05-26,214,2844,279552,28783,2021-05-26,1621983600.0
12179,53,3,2021-05-27,351,4398,279903,33181,2021-05-27,1622070000.0
12180,53,3,2021-05-28,461,5720,280364,38901,2021-05-28,1622156400.0
12181,53,3,2021-05-29,147,2320,280511,41221,2021-05-29,1622242800.0
12182,53,3,2021-05-30,6,40,280517,41261,2021-05-30,1622329200.0
12183,53,3,2021-05-31,169,1740,280686,43001,2021-05-31,1622415600.0
12184,53,3,2021-06-01,138,3382,280824,46383,2021-06-01,1622502000.0
12185,53,3,2021-06-02,143,3338,280967,49721,2021-06-02,1622588400.0
12186,53,3,2021-06-03,184,5373,281151,55094,2021-06-03,1622674800.0
12187,53,3,2021-06-04,227,7713,281378,62807,2021-06-04,1622761200.0
12188,53,3,2021-06-05,96,2784,281474,65591,2021-06-05,1622847600.0
12189,53,3,2021-06-06,4,141,281478,65732,2021-06-06,1622934000.0
12190,53,3,2021-06-07,31,1549,281509,67281,2021-06-07,1623020400.0
12191,53,3,2021-06-08,85,2570,281594,69851,2021-06-08,1623106800.0
12192,53,3,2021-06-09,64,2336,281658,72187,2021-06-09,1623193200.0
12193,53,3,2021-06-10,120,4356,281778,76543,2021-06-10,1623279600.0
12194,53,3,2021-06-11,131,6591,281909,83134,2021-06-11,1623366000.0
12195,53,3,2021-06-12,38,2012,281947,85146,2021-06-12,1623452400.0
12196,53,3,2021-06-13,1,105,281948,85251,2021-06-13,1623538800.0
12197,53,3,2021-06-14,28,2470,281976,87721,2021-06-14,1623625200.0
12198,53,3,2021-06-15,64,4764,282040,92485,2021-06-15,1623711600.0
12199,53,3,2021-06-16,44,4452,282084,96937,2021-06-16,1623798000.0
12200,53,3,2021-06-17,72,6540,282156,103477,2021-06-17,1623884400.0
12201,53,3,2021-06-18,122,9250,282278,112727,2021-06-18,1623970800.0
12202,53,3,2021-06-19,23,2275,282301,115002,2021-06-19,1624057200.0
12203,53,3,2021-06-20,0,60,282301,115062,2021-06-20,1624143600.0
12204,53,3,2021-06-21,35,2786,282336,117848,2021-06-21,1624230000.0
12205,53,3,2021-06-22,29,4682,282365,122530,2021-06-22,1624316400.0
12206,53,3,2021-06-23,38,3891,282403,126421,2021-06-23,1624402800.0
12207,53,3,2021-06-24,54,5759,282457,132180,2021-06-24,1624489200.0
12208,53,3,2021-06-25,82,7515,282539,139695,2021-06-25,1624575600.0
12209,53,3,2021-06-26,15,1771,282554,141466,2021-06-26,1624662000.0
12210,53,3,2021-06-27,4,182,282558,141648,2021-06-27,1624748400.0
12211,53,3,2021-06-28,18,2081,282576,143729,2021-06-28,1624834800.0
12212,53,3,2021-06-29,33,4118,282609,147847,2021-06-29,1624921200.0
12213,53,3,2021-06-30,35,3647,282644,151494,2021-06-30,1625007600.0
12214,53,3,2021-07-01,50,5458,282694,156952,2021-07-01,1625094000.0
12215,53,3,2021-07-02,62,8735,282756,165687,2021-07-02,1625180400.0
12216,53,3,2021-07-03,20,1866,282776,167553,2021-07-03,1625266800.0
12217,53,3,2021-07-04,1,69,282777,167622,2021-07-04,1625353200.0
12218,53,3,2021-07-05,19,2617,282796,170239,2021-07-05,1625439600.0
12219,53,3,2021-07-06,42,4961,282838,175200,2021-07-06,1625526000.0
12220,53,3,2021-07-07,50,4083,282888,179283,2021-07-07,1625612400.0
12221,53,3,2021-07-08,63,5306,282951,184589,2021-07-08,1625698800.0
12222,53,4,2020-12-27,0,0,0,0,2020-12-27,1609023600.0
12223,53,4,2020-12-28,0,0,0,0,2020-12-28,1609110000.0
12224,53,4,2020-12-29,0,0,0,0,2020-12-29,1609196400.0
12225,53,4,2020-12-30,0,0,0,0,2020-12-30,1609282800.0
12226,53,4,2020-12-31,0,0,0,0,2020-12-31,1609369200.0
12227,53,4,2021-01-01,0,0,0,0,2021-01-01,1609455600.0
12228,53,4,2021-01-02,0,0,0,0,2021-01-02,1609542000.0
12229,53,4,2021-01-03,0,0,0,0,2021-01-03,1609628400.0
12230,53,4,2021-01-04,0,0,0,0,2021-01-04,1609714800.0
12231,53,4,2021-01-05,0,0,0,0,2021-01-05,1609801200.0
12232,53,4,2021-01-06,0,0,0,0,2021-01-06,1609887600.0
12233,53,4,2021-01-07,0,0,0,0,2021-01-07,1609974000.0
12234,53,4,2021-01-08,0,0,0,0,2021-01-08,1610060400.0
12235,53,4,2021-01-09,0,0,0,0,2021-01-09,1610146800.0
12236,53,4,2021-01-10,0,0,0,0,2021-01-10,1610233200.0
12237,53,4,2021-01-11,0,0,0,0,2021-01-11,1610319600.0
12238,53,4,2021-01-12,0,0,0,0,2021-01-12,1610406000.0
12239,53,4,2021-01-13,0,0,0,0,2021-01-13,1610492400.0
12240,53,4,2021-01-14,0,0,0,0,2021-01-14,1610578800.0
12241,53,4,2021-01-15,0,0,0,0,2021-01-15,1610665200.0
12242,53,4,2021-01-16,0,0,0,0,2021-01-16,1610751600.0
12243,53,4,2021-01-17,0,0,0,0,2021-01-17,1610838000.0
12244,53,4,2021-01-18,0,0,0,0,2021-01-18,1610924400.0
12245,53,4,2021-01-19,0,0,0,0,2021-01-19,1611010800.0
12246,53,4,2021-01-20,0,0,0,0,2021-01-20,1611097200.0
12247,53,4,2021-01-21,0,0,0,0,2021-01-21,1611183600.0
12248,53,4,2021-01-22,0,0,0,0,2021-01-22,1611270000.0
12249,53,4,2021-01-23,0,0,0,0,2021-01-23,1611356400.0
12250,53,4,2021-01-24,0,0,0,0,2021-01-24,1611442800.0
12251,53,4,2021-01-25,0,0,0,0,2021-01-25,1611529200.0
12252,53,4,2021-01-26,0,0,0,0,2021-01-26,1611615600.0
12253,53,4,2021-01-27,0,0,0,0,2021-01-27,1611702000.0
12254,53,4,2021-01-28,0,0,0,0,2021-01-28,1611788400.0
12255,53,4,2021-01-29,0,0,0,0,2021-01-29,1611874800.0
12256,53,4,2021-01-30,0,0,0,0,2021-01-30,1611961200.0
12257,53,4,2021-01-31,0,0,0,0,2021-01-31,1612047600.0
12258,53,4,2021-02-01,0,0,0,0,2021-02-01,1612134000.0
12259,53,4,2021-02-02,0,0,0,0,2021-02-02,1612220400.0
12260,53,4,2021-02-03,0,0,0,0,2021-02-03,1612306800.0
12261,53,4,2021-02-04,0,0,0,0,2021-02-04,1612393200.0
12262,53,4,2021-02-05,0,0,0,0,2021-02-05,1612479600.0
12263,53,4,2021-02-06,0,0,0,0,2021-02-06,1612566000.0
12264,53,4,2021-02-07,0,0,0,0,2021-02-07,1612652400.0
12265,53,4,2021-02-08,0,0,0,0,2021-02-08,1612738800.0
12266,53,4,2021-02-09,0,0,0,0,2021-02-09,1612825200.0
12267,53,4,2021-02-10,0,0,0,0,2021-02-10,1612911600.0
12268,53,4,2021-02-11,0,0,0,0,2021-02-11,1612998000.0
12269,53,4,2021-02-12,0,0,0,0,2021-02-12,1613084400.0
12270,53,4,2021-02-13,0,0,0,0,2021-02-13,1613170800.0
12271,53,4,2021-02-14,0,0,0,0,2021-02-14,1613257200.0
12272,53,4,2021-02-15,0,0,0,0,2021-02-15,1613343600.0
12273,53,4,2021-02-16,0,0,0,0,2021-02-16,1613430000.0
12274,53,4,2021-02-17,0,0,0,0,2021-02-17,1613516400.0
12275,53,4,2021-02-18,0,0,0,0,2021-02-18,1613602800.0
12276,53,4,2021-02-19,0,0,0,0,2021-02-19,1613689200.0
12277,53,4,2021-02-20,0,0,0,0,2021-02-20,1613775600.0
12278,53,4,2021-02-21,0,0,0,0,2021-02-21,1613862000.0
12279,53,4,2021-02-22,0,0,0,0,2021-02-22,1613948400.0
12280,53,4,2021-02-23,0,0,0,0,2021-02-23,1614034800.0
12281,53,4,2021-02-24,0,0,0,0,2021-02-24,1614121200.0
12282,53,4,2021-02-25,0,0,0,0,2021-02-25,1614207600.0
12283,53,4,2021-02-26,0,0,0,0,2021-02-26,1614294000.0
12284,53,4,2021-02-27,0,0,0,0,2021-02-27,1614380400.0
12285,53,4,2021-02-28,0,0,0,0,2021-02-28,1614466800.0
12286,53,4,2021-03-01,0,0,0,0,2021-03-01,1614553200.0
12287,53,4,2021-03-02,0,0,0,0,2021-03-02,1614639600.0
12288,53,4,2021-03-03,0,0,0,0,2021-03-03,1614726000.0
12289,53,4,2021-03-04,0,0,0,0,2021-03-04,1614812400.0
12290,53,4,2021-03-05,0,0,0,0,2021-03-05,1614898800.0
12291,53,4,2021-03-06,0,0,0,0,2021-03-06,1614985200.0
12292,53,4,2021-03-07,0,0,0,0,2021-03-07,1615071600.0
12293,53,4,2021-03-08,0,0,0,0,2021-03-08,1615158000.0
12294,53,4,2021-03-09,0,0,0,0,2021-03-09,1615244400.0
12295,53,4,2021-03-10,0,0,0,0,2021-03-10,1615330800.0
12296,53,4,2021-03-11,0,0,0,0,2021-03-11,1615417200.0
12297,53,4,2021-03-12,0,0,0,0,2021-03-12,1615503600.0
12298,53,4,2021-03-13,0,0,0,0,2021-03-13,1615590000.0
12299,53,4,2021-03-14,0,0,0,0,2021-03-14,1615676400.0
12300,53,4,2021-03-15,0,0,0,0,2021-03-15,1615762800.0
12301,53,4,2021-03-16,0,0,0,0,2021-03-16,1615849200.0
12302,53,4,2021-03-17,0,0,0,0,2021-03-17,1615935600.0
12303,53,4,2021-03-18,0,0,0,0,2021-03-18,1616022000.0
12304,53,4,2021-03-19,0,0,0,0,2021-03-19,1616108400.0
12305,53,4,2021-03-20,0,0,0,0,2021-03-20,1616194800.0
12306,53,4,2021-03-21,0,0,0,0,2021-03-21,1616281200.0
12307,53,4,2021-03-22,0,0,0,0,2021-03-22,1616367600.0
12308,53,4,2021-03-23,0,0,0,0,2021-03-23,1616454000.0
12309,53,4,2021-03-24,0,0,0,0,2021-03-24,1616540400.0
12310,53,4,2021-03-25,0,0,0,0,2021-03-25,1616626800.0
12311,53,4,2021-03-26,0,0,0,0,2021-03-26,1616713200.0
12312,53,4,2021-03-27,0,0,0,0,2021-03-27,1616799600.0
12313,53,4,2021-03-28,0,0,0,0,2021-03-28,1616886000.0
12314,53,4,2021-03-29,0,0,0,0,2021-03-29,1616972400.0
12315,53,4,2021-03-30,0,0,0,0,2021-03-30,1617058800.0
12316,53,4,2021-03-31,0,0,0,0,2021-03-31,1617145200.0
12317,53,4,2021-04-01,0,0,0,0,2021-04-01,1617231600.0
12318,53,4,2021-04-02,0,0,0,0,2021-04-02,1617318000.0
12319,53,4,2021-04-03,0,0,0,0,2021-04-03,1617404400.0
12320,53,4,2021-04-04,0,0,0,0,2021-04-04,1617490800.0
12321,53,4,2021-04-05,0,0,0,0,2021-04-05,1617577200.0
12322,53,4,2021-04-06,0,0,0,0,2021-04-06,1617663600.0
12323,53,4,2021-04-07,0,0,0,0,2021-04-07,1617750000.0
12324,53,4,2021-04-08,0,0,0,0,2021-04-08,1617836400.0
12325,53,4,2021-04-09,0,0,0,0,2021-04-09,1617922800.0
12326,53,4,2021-04-10,0,0,0,0,2021-04-10,1618009200.0
12327,53,4,2021-04-11,0,0,0,0,2021-04-11,1618095600.0
12328,53,4,2021-04-12,0,0,0,0,2021-04-12,1618185600.0
12329,53,4,2021-04-13,0,0,0,0,2021-04-13,1618272000.0
12330,53,4,2021-04-14,0,0,0,0,2021-04-14,1618358400.0
12331,53,4,2021-04-15,0,0,0,0,2021-04-15,1618444800.0
12332,53,4,2021-04-16,0,0,0,0,2021-04-16,1618531200.0
12333,53,4,2021-04-17,0,0,0,0,2021-04-17,1618617600.0
12334,53,4,2021-04-18,0,0,0,0,2021-04-18,1618704000.0
12335,53,4,2021-04-19,0,0,0,0,2021-04-19,1618790400.0
12336,53,4,2021-04-20,0,0,0,0,2021-04-20,1618876800.0
12337,53,4,2021-04-21,0,0,0,0,2021-04-21,1618963200.0
12338,53,4,2021-04-22,0,0,0,0,2021-04-22,1619049600.0
12339,53,4,2021-04-23,63,0,63,0,2021-04-23,1619136000.0
12340,53,4,2021-04-24,198,0,261,0,2021-04-24,1619222400.0
12341,53,4,2021-04-25,0,0,261,0,2021-04-25,1619308800.0
12342,53,4,2021-04-26,326,0,587,0,2021-04-26,1619395200.0
12343,53,4,2021-04-27,629,1,1216,1,2021-04-27,1619481600.0
12344,53,4,2021-04-28,636,1,1852,2,2021-04-28,1619568000.0
12345,53,4,2021-04-29,1004,0,2856,2,2021-04-29,1619654400.0
12346,53,4,2021-04-30,1206,2,4062,4,2021-04-30,1619740800.0
12347,53,4,2021-05-01,78,0,4140,4,2021-05-01,1619827200.0
12348,53,4,2021-05-02,37,0,4177,4,2021-05-02,1619913600.0
12349,53,4,2021-05-03,338,0,4515,4,2021-05-03,1620000000.0
12350,53,4,2021-05-04,432,0,4947,4,2021-05-04,1620086400.0
12351,53,4,2021-05-05,250,0,5197,4,2021-05-05,1620172800.0
12352,53,4,2021-05-06,629,0,5826,4,2021-05-06,1620259200.0
12353,53,4,2021-05-07,1311,0,7137,4,2021-05-07,1620345600.0
12354,53,4,2021-05-08,71,0,7208,4,2021-05-08,1620432000.0
12355,53,4,2021-05-09,14,0,7222,4,2021-05-09,1620518400.0
12356,53,4,2021-05-10,401,2,7623,6,2021-05-10,1620604800.0
12357,53,4,2021-05-11,960,2,8583,8,2021-05-11,1620691200.0
12358,53,4,2021-05-12,850,1,9433,9,2021-05-12,1620777600.0
12359,53,4,2021-05-13,28,0,9461,9,2021-05-13,1620864000.0
12360,53,4,2021-05-14,781,0,10242,9,2021-05-14,1620950400.0
12361,53,4,2021-05-15,306,0,10548,9,2021-05-15,1621036800.0
12362,53,4,2021-05-16,16,0,10564,9,2021-05-16,1621123200.0
12363,53,4,2021-05-17,336,0,10900,9,2021-05-17,1621206000.0
12364,53,4,2021-05-18,817,1,11717,10,2021-05-18,1621292400.0
12365,53,4,2021-05-19,406,0,12123,10,2021-05-19,1621378800.0
12366,53,4,2021-05-20,905,1,13028,11,2021-05-20,1621465200.0
12367,53,4,2021-05-21,1156,1,14184,12,2021-05-21,1621551600.0
12368,53,4,2021-05-22,389,0,14573,12,2021-05-22,1621638000.0
12369,53,4,2021-05-23,6,0,14579,12,2021-05-23,1621724400.0
12370,53,4,2021-05-24,41,0,14620,12,2021-05-24,1621810800.0
12371,53,4,2021-05-25,518,1,15138,13,2021-05-25,1621897200.0
12372,53,4,2021-05-26,492,1,15630,14,2021-05-26,1621983600.0
12373,53,4,2021-05-27,1265,2,16895,16,2021-05-27,1622070000.0
12374,53,4,2021-05-28,2079,3,18974,19,2021-05-28,1622156400.0
12375,53,4,2021-05-29,679,3,19653,22,2021-05-29,1622242800.0
12376,53,4,2021-05-30,18,1,19671,23,2021-05-30,1622329200.0
12377,53,4,2021-05-31,757,0,20428,23,2021-05-31,1622415600.0
12378,53,4,2021-06-01,997,1,21425,24,2021-06-01,1622502000.0
12379,53,4,2021-06-02,800,2,22225,26,2021-06-02,1622588400.0
12380,53,4,2021-06-03,1180,2,23405,28,2021-06-03,1622674800.0
12381,53,4,2021-06-04,1564,2,24969,30,2021-06-04,1622761200.0
12382,53,4,2021-06-05,646,1,25615,31,2021-06-05,1622847600.0
12383,53,4,2021-06-06,26,0,25641,31,2021-06-06,1622934000.0
12384,53,4,2021-06-07,549,0,26190,31,2021-06-07,1623020400.0
12385,53,4,2021-06-08,970,1,27160,32,2021-06-08,1623106800.0
12386,53,4,2021-06-09,654,1,27814,33,2021-06-09,1623193200.0
12387,53,4,2021-06-10,1089,1,28903,34,2021-06-10,1623279600.0
12388,53,4,2021-06-11,1031,2,29934,36,2021-06-11,1623366000.0
12389,53,4,2021-06-12,344,4,30278,40,2021-06-12,1623452400.0
12390,53,4,2021-06-13,31,0,30309,40,2021-06-13,1623538800.0
12391,53,4,2021-06-14,434,0,30743,40,2021-06-14,1623625200.0
12392,53,4,2021-06-15,653,0,31396,40,2021-06-15,1623711600.0
12393,53,4,2021-06-16,567,0,31963,40,2021-06-16,1623798000.0
12394,53,4,2021-06-17,568,1,32531,41,2021-06-17,1623884400.0
12395,53,4,2021-06-18,874,0,33405,41,2021-06-18,1623970800.0
12396,53,4,2021-06-19,348,0,33753,41,2021-06-19,1624057200.0
12397,53,4,2021-06-20,23,0,33776,41,2021-06-20,1624143600.0
12398,53,4,2021-06-21,301,0,34077,41,2021-06-21,1624230000.0
12399,53,4,2021-06-22,534,2,34611,43,2021-06-22,1624316400.0
12400,53,4,2021-06-23,354,1,34965,44,2021-06-23,1624402800.0
12401,53,4,2021-06-24,467,3,35432,47,2021-06-24,1624489200.0
12402,53,4,2021-06-25,544,1,35976,48,2021-06-25,1624575600.0
12403,53,4,2021-06-26,237,1,36213,49,2021-06-26,1624662000.0
12404,53,4,2021-06-27,17,0,36230,49,2021-06-27,1624748400.0
12405,53,4,2021-06-28,215,1,36445,50,2021-06-28,1624834800.0
12406,53,4,2021-06-29,513,1,36958,51,2021-06-29,1624921200.0
12407,53,4,2021-06-30,391,5,37349,56,2021-06-30,1625007600.0
12408,53,4,2021-07-01,459,0,37808,56,2021-07-01,1625094000.0
12409,53,4,2021-07-02,607,0,38415,56,2021-07-02,1625180400.0
12410,53,4,2021-07-03,241,0,38656,56,2021-07-03,1625266800.0
12411,53,4,2021-07-04,19,1,38675,57,2021-07-04,1625353200.0
12412,53,4,2021-07-05,232,1,38907,58,2021-07-05,1625439600.0
12413,53,4,2021-07-06,451,0,39358,58,2021-07-06,1625526000.0
12414,53,4,2021-07-07,370,3,39728,61,2021-07-07,1625612400.0
12415,53,4,2021-07-08,535,4,40263,65,2021-07-08,1625698800.0
12416,75,1,2020-12-27,1,0,1,0,2020-12-27,1609023600.0
12417,75,1,2020-12-28,3,0,4,0,2020-12-28,1609110000.0
12418,75,1,2020-12-29,3,0,7,0,2020-12-29,1609196400.0
12419,75,1,2020-12-30,2,0,9,0,2020-12-30,1609282800.0
12420,75,1,2020-12-31,0,0,9,0,2020-12-31,1609369200.0
12421,75,1,2021-01-01,4,0,13,0,2021-01-01,1609455600.0
12422,75,1,2021-01-02,2,0,15,0,2021-01-02,1609542000.0
12423,75,1,2021-01-03,0,0,15,0,2021-01-03,1609628400.0
12424,75,1,2021-01-04,90,0,105,0,2021-01-04,1609714800.0
12425,75,1,2021-01-05,125,0,230,0,2021-01-05,1609801200.0
12426,75,1,2021-01-06,736,0,966,0,2021-01-06,1609887600.0
12427,75,1,2021-01-07,4923,0,5889,0,2021-01-07,1609974000.0
12428,75,1,2021-01-08,5470,0,11359,0,2021-01-08,1610060400.0
12429,75,1,2021-01-09,845,0,12204,0,2021-01-09,1610146800.0
12430,75,1,2021-01-10,478,0,12682,0,2021-01-10,1610233200.0
12431,75,1,2021-01-11,3585,0,16267,0,2021-01-11,1610319600.0
12432,75,1,2021-01-12,5947,0,22214,0,2021-01-12,1610406000.0
12433,75,1,2021-01-13,6553,0,28767,0,2021-01-13,1610492400.0
12434,75,1,2021-01-14,8126,0,36893,0,2021-01-14,1610578800.0
12435,75,1,2021-01-15,7631,0,44524,0,2021-01-15,1610665200.0
12436,75,1,2021-01-16,1609,12,46133,12,2021-01-16,1610751600.0
12437,75,1,2021-01-17,426,3,46559,15,2021-01-17,1610838000.0
12438,75,1,2021-01-18,6890,24,53449,39,2021-01-18,1610924400.0
12439,75,1,2021-01-19,14048,8,67497,47,2021-01-19,1611010800.0
12440,75,1,2021-01-20,15538,5,83035,52,2021-01-20,1611097200.0
12441,75,1,2021-01-21,16966,16,100001,68,2021-01-21,1611183600.0
12442,75,1,2021-01-22,12974,14,112975,82,2021-01-22,1611270000.0
12443,75,1,2021-01-23,4421,2,117396,84,2021-01-23,1611356400.0
12444,75,1,2021-01-24,701,1,118097,85,2021-01-24,1611442800.0
12445,75,1,2021-01-25,8870,212,126967,297,2021-01-25,1611529200.0
12446,75,1,2021-01-26,11724,446,138691,743,2021-01-26,1611615600.0
12447,75,1,2021-01-27,12298,759,150989,1502,2021-01-27,1611702000.0
12448,75,1,2021-01-28,12924,2636,163913,4138,2021-01-28,1611788400.0
12449,75,1,2021-01-29,10009,2978,173922,7116,2021-01-29,1611874800.0
12450,75,1,2021-01-30,3379,515,177301,7631,2021-01-30,1611961200.0
12451,75,1,2021-01-31,646,418,177947,8049,2021-01-31,1612047600.0
12452,75,1,2021-02-01,5716,2638,183663,10687,2021-02-01,1612134000.0
12453,75,1,2021-02-02,9616,4342,193279,15029,2021-02-02,1612220400.0
12454,75,1,2021-02-03,9596,4356,202875,19385,2021-02-03,1612306800.0
12455,75,1,2021-02-04,10766,5667,213641,25052,2021-02-04,1612393200.0
12456,75,1,2021-02-05,7489,5629,221130,30681,2021-02-05,1612479600.0
12457,75,1,2021-02-06,2349,1104,223479,31785,2021-02-06,1612566000.0
12458,75,1,2021-02-07,316,245,223795,32030,2021-02-07,1612652400.0
12459,75,1,2021-02-08,4815,3645,228610,35675,2021-02-08,1612738800.0
12460,75,1,2021-02-09,6863,8043,235473,43718,2021-02-09,1612825200.0
12461,75,1,2021-02-10,6798,8733,242271,52451,2021-02-10,1612911600.0
12462,75,1,2021-02-11,7820,10245,250091,62696,2021-02-11,1612998000.0
12463,75,1,2021-02-12,6541,8748,256632,71444,2021-02-12,1613084400.0
12464,75,1,2021-02-13,1842,1753,258474,73197,2021-02-13,1613170800.0
12465,75,1,2021-02-14,254,363,258728,73560,2021-02-14,1613257200.0
12466,75,1,2021-02-15,2486,7829,261214,81389,2021-02-15,1613343600.0
12467,75,1,2021-02-16,3547,10492,264761,91881,2021-02-16,1613430000.0
12468,75,1,2021-02-17,3730,11270,268491,103151,2021-02-17,1613516400.0
12469,75,1,2021-02-18,4155,12771,272646,115922,2021-02-18,1613602800.0
12470,75,1,2021-02-19,4228,9580,276874,125502,2021-02-19,1613689200.0
12471,75,1,2021-02-20,748,2627,277622,128129,2021-02-20,1613775600.0
12472,75,1,2021-02-21,139,665,277761,128794,2021-02-21,1613862000.0
12473,75,1,2021-02-22,2392,8485,280153,137279,2021-02-22,1613948400.0
12474,75,1,2021-02-23,3679,10885,283832,148164,2021-02-23,1614034800.0
12475,75,1,2021-02-24,4367,10247,288199,158411,2021-02-24,1614121200.0
12476,75,1,2021-02-25,5137,11602,293336,170013,2021-02-25,1614207600.0
12477,75,1,2021-02-26,4695,8748,298031,178761,2021-02-26,1614294000.0
12478,75,1,2021-02-27,1525,2461,299556,181222,2021-02-27,1614380400.0
12479,75,1,2021-02-28,132,691,299688,181913,2021-02-28,1614466800.0
12480,75,1,2021-03-01,2466,6964,302154,188877,2021-03-01,1614553200.0
12481,75,1,2021-03-02,3614,8074,305768,196951,2021-03-02,1614639600.0
12482,75,1,2021-03-03,4112,7706,309880,204657,2021-03-03,1614726000.0
12483,75,1,2021-03-04,4921,8021,314801,212678,2021-03-04,1614812400.0
12484,75,1,2021-03-05,4921,7240,319722,219918,2021-03-05,1614898800.0
12485,75,1,2021-03-06,1848,2135,321570,222053,2021-03-06,1614985200.0
12486,75,1,2021-03-07,515,427,322085,222480,2021-03-07,1615071600.0
12487,75,1,2021-03-08,4304,5312,326389,227792,2021-03-08,1615158000.0
12488,75,1,2021-03-09,6632,6371,333021,234163,2021-03-09,1615244400.0
12489,75,1,2021-03-10,8124,6184,341145,240347,2021-03-10,1615330800.0
12490,75,1,2021-03-11,9435,6479,350580,246826,2021-03-11,1615417200.0
12491,75,1,2021-03-12,8951,5017,359531,251843,2021-03-12,1615503600.0
12492,75,1,2021-03-13,3845,1105,363376,252948,2021-03-13,1615590000.0
12493,75,1,2021-03-14,815,234,364191,253182,2021-03-14,1615676400.0
12494,75,1,2021-03-15,8967,3277,373158,256459,2021-03-15,1615762800.0
12495,75,1,2021-03-16,12301,3389,385459,259848,2021-03-16,1615849200.0
12496,75,1,2021-03-17,13470,3467,398929,263315,2021-03-17,1615935600.0
12497,75,1,2021-03-18,14746,4082,413675,267397,2021-03-18,1616022000.0
12498,75,1,2021-03-19,13799,3853,427474,271250,2021-03-19,1616108400.0
12499,75,1,2021-03-20,6398,678,433872,271928,2021-03-20,1616194800.0
12500,75,1,2021-03-21,1887,86,435759,272014,2021-03-21,1616281200.0
12501,75,1,2021-03-22,11923,3041,447682,275055,2021-03-22,1616367600.0
12502,75,1,2021-03-23,14433,3205,462115,278260,2021-03-23,1616454000.0
12503,75,1,2021-03-24,15565,3572,477680,281832,2021-03-24,1616540400.0
12504,75,1,2021-03-25,17030,3745,494710,285577,2021-03-25,1616626800.0
12505,75,1,2021-03-26,17896,3319,512606,288896,2021-03-26,1616713200.0
12506,75,1,2021-03-27,7308,1047,519914,289943,2021-03-27,1616799600.0
12507,75,1,2021-03-28,1536,366,521450,290309,2021-03-28,1616886000.0
12508,75,1,2021-03-29,14789,3443,536239,293752,2021-03-29,1616972400.0
12509,75,1,2021-03-30,18821,4457,555060,298209,2021-03-30,1617058800.0
12510,75,1,2021-03-31,19556,4726,574616,302935,2021-03-31,1617145200.0
12511,75,1,2021-04-01,21412,4797,596028,307732,2021-04-01,1617231600.0
12512,75,1,2021-04-02,19005,5190,615033,312922,2021-04-02,1617318000.0
12513,75,1,2021-04-03,7566,2285,622599,315207,2021-04-03,1617404400.0
12514,75,1,2021-04-04,973,318,623572,315525,2021-04-04,1617490800.0
12515,75,1,2021-04-05,4626,312,628198,315837,2021-04-05,1617577200.0
12516,75,1,2021-04-06,19855,8952,648053,324789,2021-04-06,1617663600.0
12517,75,1,2021-04-07,25144,9412,673197,334201,2021-04-07,1617750000.0
12518,75,1,2021-04-08,25808,10370,699005,344571,2021-04-08,1617836400.0
12519,75,1,2021-04-09,24979,8818,723984,353389,2021-04-09,1617922800.0
12520,75,1,2021-04-10,13324,4006,737308,357395,2021-04-10,1618009200.0
12521,75,1,2021-04-11,3640,616,740948,358011,2021-04-11,1618095600.0
12522,75,1,2021-04-12,18810,10422,759758,368433,2021-04-12,1618185600.0
12523,75,1,2021-04-13,21966,12491,781724,380924,2021-04-13,1618272000.0
12524,75,1,2021-04-14,23875,12768,805599,393692,2021-04-14,1618358400.0
12525,75,1,2021-04-15,23644,12790,829243,406482,2021-04-15,1618444800.0
12526,75,1,2021-04-16,21262,12766,850505,419248,2021-04-16,1618531200.0
12527,75,1,2021-04-17,11887,5932,862392,425180,2021-04-17,1618617600.0
12528,75,1,2021-04-18,1725,1929,864117,427109,2021-04-18,1618704000.0
12529,75,1,2021-04-19,15999,13320,880116,440429,2021-04-19,1618790400.0
12530,75,1,2021-04-20,20223,16232,900339,456661,2021-04-20,1618876800.0
12531,75,1,2021-04-21,20574,15757,920913,472418,2021-04-21,1618963200.0
12532,75,1,2021-04-22,20718,16369,941631,488787,2021-04-22,1619049600.0
12533,75,1,2021-04-23,18680,16817,960311,505604,2021-04-23,1619136000.0
12534,75,1,2021-04-24,11451,6401,971762,512005,2021-04-24,1619222400.0
12535,75,1,2021-04-25,3032,936,974794,512941,2021-04-25,1619308800.0
12536,75,1,2021-04-26,18295,16026,993089,528967,2021-04-26,1619395200.0
12537,75,1,2021-04-27,21876,19422,1014965,548389,2021-04-27,1619481600.0
12538,75,1,2021-04-28,23110,19232,1038075,567621,2021-04-28,1619568000.0
12539,75,1,2021-04-29,27625,19466,1065700,587087,2021-04-29,1619654400.0
12540,75,1,2021-04-30,27026,17146,1092726,604233,2021-04-30,1619740800.0
12541,75,1,2021-05-01,11680,3299,1104406,607532,2021-05-01,1619827200.0
12542,75,1,2021-05-02,6242,1204,1110648,608736,2021-05-02,1619913600.0
12543,75,1,2021-05-03,22979,17782,1133627,626518,2021-05-03,1620000000.0
12544,75,1,2021-05-04,23874,22913,1157501,649431,2021-05-04,1620086400.0
12545,75,1,2021-05-05,25731,24452,1183232,673883,2021-05-05,1620172800.0
12546,75,1,2021-05-06,25693,22484,1208925,696367,2021-05-06,1620259200.0
12547,75,1,2021-05-07,25340,23193,1234265,719560,2021-05-07,1620345600.0
12548,75,1,2021-05-08,14434,5426,1248699,724986,2021-05-08,1620432000.0
12549,75,1,2021-05-09,6258,2811,1254957,727797,2021-05-09,1620518400.0
12550,75,1,2021-05-10,20695,22466,1275652,750263,2021-05-10,1620604800.0
12551,75,1,2021-05-11,26290,23211,1301942,773474,2021-05-11,1620691200.0
12552,75,1,2021-05-12,29049,21423,1330991,794897,2021-05-12,1620777600.0
12553,75,1,2021-05-13,19808,4842,1350799,799739,2021-05-13,1620864000.0
12554,75,1,2021-05-14,28286,13250,1379085,812989,2021-05-14,1620950400.0
12555,75,1,2021-05-15,18653,6261,1397738,819250,2021-05-15,1621036800.0
12556,75,1,2021-05-16,5773,1529,1403511,820779,2021-05-16,1621123200.0
12557,75,1,2021-05-17,28166,12911,1431677,833690,2021-05-17,1621206000.0
12558,75,1,2021-05-18,34102,12348,1465779,846038,2021-05-18,1621292400.0
12559,75,1,2021-05-19,34967,10552,1500746,856590,2021-05-19,1621378800.0
12560,75,1,2021-05-20,35518,9455,1536264,866045,2021-05-20,1621465200.0
12561,75,1,2021-05-21,33716,9012,1569980,875057,2021-05-21,1621551600.0
12562,75,1,2021-05-22,17396,4114,1587376,879171,2021-05-22,1621638000.0
12563,75,1,2021-05-23,5046,759,1592422,879930,2021-05-23,1621724400.0
12564,75,1,2021-05-24,17661,2274,1610083,882204,2021-05-24,1621810800.0
12565,75,1,2021-05-25,32420,12320,1642503,894524,2021-05-25,1621897200.0
12566,75,1,2021-05-26,34214,11616,1676717,906140,2021-05-26,1621983600.0
12567,75,1,2021-05-27,37005,12571,1713722,918711,2021-05-27,1622070000.0
12568,75,1,2021-05-28,31994,14067,1745716,932778,2021-05-28,1622156400.0
12569,75,1,2021-05-29,16560,8520,1762276,941298,2021-05-29,1622242800.0
12570,75,1,2021-05-30,5680,845,1767956,942143,2021-05-30,1622329200.0
12571,75,1,2021-05-31,28523,15025,1796479,957168,2021-05-31,1622415600.0
12572,75,1,2021-06-01,35056,17061,1831535,974229,2021-06-01,1622502000.0
12573,75,1,2021-06-02,35399,16028,1866934,990257,2021-06-02,1622588400.0
12574,75,1,2021-06-03,38532,14728,1905466,1004985,2021-06-03,1622674800.0
12575,75,1,2021-06-04,34065,18025,1939531,1023010,2021-06-04,1622761200.0
12576,75,1,2021-06-05,19786,9753,1959317,1032763,2021-06-05,1622847600.0
12577,75,1,2021-06-06,8255,2612,1967572,1035375,2021-06-06,1622934000.0
12578,75,1,2021-06-07,27510,23822,1995082,1059197,2021-06-07,1623020400.0
12579,75,1,2021-06-08,31248,25221,2026330,1084418,2021-06-08,1623106800.0
12580,75,1,2021-06-09,34097,22198,2060427,1106616,2021-06-09,1623193200.0
12581,75,1,2021-06-10,36203,19133,2096630,1125749,2021-06-10,1623279600.0
12582,75,1,2021-06-11,31148,23253,2127778,1149002,2021-06-11,1623366000.0
12583,75,1,2021-06-12,19368,12837,2147146,1161839,2021-06-12,1623452400.0
12584,75,1,2021-06-13,7786,4577,2154932,1166416,2021-06-13,1623538800.0
12585,75,1,2021-06-14,20544,28327,2175476,1194743,2021-06-14,1623625200.0
12586,75,1,2021-06-15,27207,27035,2202683,1221778,2021-06-15,1623711600.0
12587,75,1,2021-06-16,29833,24060,2232516,1245838,2021-06-16,1623798000.0
12588,75,1,2021-06-17,29494,18983,2262010,1264821,2021-06-17,1623884400.0
12589,75,1,2021-06-18,27084,24558,2289094,1289379,2021-06-18,1623970800.0
12590,75,1,2021-06-19,17012,15258,2306106,1304637,2021-06-19,1624057200.0
12591,75,1,2021-06-20,6046,4562,2312152,1309199,2021-06-20,1624143600.0
12592,75,1,2021-06-21,18797,28569,2330949,1337768,2021-06-21,1624230000.0
12593,75,1,2021-06-22,20629,29225,2351578,1366993,2021-06-22,1624316400.0
12594,75,1,2021-06-23,22779,28305,2374357,1395298,2021-06-23,1624402800.0
12595,75,1,2021-06-24,22866,21220,2397223,1416518,2021-06-24,1624489200.0
12596,75,1,2021-06-25,18614,31291,2415837,1447809,2021-06-25,1624575600.0
12597,75,1,2021-06-26,11510,18409,2427347,1466218,2021-06-26,1624662000.0
12598,75,1,2021-06-27,4409,6271,2431756,1472489,2021-06-27,1624748400.0
12599,75,1,2021-06-28,12705,34669,2444461,1507158,2021-06-28,1624834800.0
12600,75,1,2021-06-29,15030,36079,2459491,1543237,2021-06-29,1624921200.0
12601,75,1,2021-06-30,17109,33342,2476600,1576579,2021-06-30,1625007600.0
12602,75,1,2021-07-01,18924,28983,2495524,1605562,2021-07-01,1625094000.0
12603,75,1,2021-07-02,16906,32573,2512430,1638135,2021-07-02,1625180400.0
12604,75,1,2021-07-03,8373,19615,2520803,1657750,2021-07-03,1625266800.0
12605,75,1,2021-07-04,3291,5967,2524094,1663717,2021-07-04,1625353200.0
12606,75,1,2021-07-05,12601,33558,2536695,1697275,2021-07-05,1625439600.0
12607,75,1,2021-07-06,15252,37257,2551947,1734532,2021-07-06,1625526000.0
12608,75,1,2021-07-07,17783,36049,2569730,1770581,2021-07-07,1625612400.0
12609,75,1,2021-07-08,19369,30352,2589099,1800933,2021-07-08,1625698800.0
12610,75,2,2020-12-27,0,0,0,0,2020-12-27,1609023600.0
12611,75,2,2020-12-28,0,0,0,0,2020-12-28,1609110000.0
12612,75,2,2020-12-29,0,0,0,0,2020-12-29,1609196400.0
12613,75,2,2020-12-30,0,0,0,0,2020-12-30,1609282800.0
12614,75,2,2020-12-31,0,0,0,0,2020-12-31,1609369200.0
12615,75,2,2021-01-01,0,0,0,0,2021-01-01,1609455600.0
12616,75,2,2021-01-02,0,0,0,0,2021-01-02,1609542000.0
12617,75,2,2021-01-03,0,0,0,0,2021-01-03,1609628400.0
12618,75,2,2021-01-04,0,0,0,0,2021-01-04,1609714800.0
12619,75,2,2021-01-05,0,0,0,0,2021-01-05,1609801200.0
12620,75,2,2021-01-06,0,0,0,0,2021-01-06,1609887600.0
12621,75,2,2021-01-07,0,0,0,0,2021-01-07,1609974000.0
12622,75,2,2021-01-08,0,0,0,0,2021-01-08,1610060400.0
12623,75,2,2021-01-09,0,0,0,0,2021-01-09,1610146800.0
12624,75,2,2021-01-10,0,0,0,0,2021-01-10,1610233200.0
12625,75,2,2021-01-11,0,0,0,0,2021-01-11,1610319600.0
12626,75,2,2021-01-12,0,0,0,0,2021-01-12,1610406000.0
12627,75,2,2021-01-13,0,0,0,0,2021-01-13,1610492400.0
12628,75,2,2021-01-14,1,0,1,0,2021-01-14,1610578800.0
12629,75,2,2021-01-15,0,0,1,0,2021-01-15,1610665200.0
12630,75,2,2021-01-16,0,0,1,0,2021-01-16,1610751600.0
12631,75,2,2021-01-17,0,0,1,0,2021-01-17,1610838000.0
12632,75,2,2021-01-18,3,0,4,0,2021-01-18,1610924400.0
12633,75,2,2021-01-19,7,0,11,0,2021-01-19,1611010800.0
12634,75,2,2021-01-20,0,0,11,0,2021-01-20,1611097200.0
12635,75,2,2021-01-21,1,0,12,0,2021-01-21,1611183600.0
12636,75,2,2021-01-22,1,0,13,0,2021-01-22,1611270000.0
12637,75,2,2021-01-23,0,0,13,0,2021-01-23,1611356400.0
12638,75,2,2021-01-24,0,0,13,0,2021-01-24,1611442800.0
12639,75,2,2021-01-25,3,0,16,0,2021-01-25,1611529200.0
12640,75,2,2021-01-26,1,0,17,0,2021-01-26,1611615600.0
12641,75,2,2021-01-27,2,0,19,0,2021-01-27,1611702000.0
12642,75,2,2021-01-28,18,0,37,0,2021-01-28,1611788400.0
12643,75,2,2021-01-29,0,0,37,0,2021-01-29,1611874800.0
12644,75,2,2021-01-30,0,0,37,0,2021-01-30,1611961200.0
12645,75,2,2021-01-31,0,0,37,0,2021-01-31,1612047600.0
12646,75,2,2021-02-01,0,0,37,0,2021-02-01,1612134000.0
12647,75,2,2021-02-02,1,0,38,0,2021-02-02,1612220400.0
12648,75,2,2021-02-03,0,0,38,0,2021-02-03,1612306800.0
12649,75,2,2021-02-04,1,0,39,0,2021-02-04,1612393200.0
12650,75,2,2021-02-05,1,0,40,0,2021-02-05,1612479600.0
12651,75,2,2021-02-06,0,0,40,0,2021-02-06,1612566000.0
12652,75,2,2021-02-07,0,0,40,0,2021-02-07,1612652400.0
12653,75,2,2021-02-08,0,1,40,1,2021-02-08,1612738800.0
12654,75,2,2021-02-09,1,5,41,6,2021-02-09,1612825200.0
12655,75,2,2021-02-10,1,1,42,7,2021-02-10,1612911600.0
12656,75,2,2021-02-11,0,0,42,7,2021-02-11,1612998000.0
12657,75,2,2021-02-12,1,1,43,8,2021-02-12,1613084400.0
12658,75,2,2021-02-13,0,0,43,8,2021-02-13,1613170800.0
12659,75,2,2021-02-14,0,0,43,8,2021-02-14,1613257200.0
12660,75,2,2021-02-15,61,0,104,8,2021-02-15,1613343600.0
12661,75,2,2021-02-16,274,0,378,8,2021-02-16,1613430000.0
12662,75,2,2021-02-17,282,0,660,8,2021-02-17,1613516400.0
12663,75,2,2021-02-18,395,1,1055,9,2021-02-18,1613602800.0
12664,75,2,2021-02-19,232,1,1287,10,2021-02-19,1613689200.0
12665,75,2,2021-02-20,45,0,1332,10,2021-02-20,1613775600.0
12666,75,2,2021-02-21,0,0,1332,10,2021-02-21,1613862000.0
12667,75,2,2021-02-22,279,1,1611,11,2021-02-22,1613948400.0
12668,75,2,2021-02-23,491,0,2102,11,2021-02-23,1614034800.0
12669,75,2,2021-02-24,486,2,2588,13,2021-02-24,1614121200.0
12670,75,2,2021-02-25,569,15,3157,28,2021-02-25,1614207600.0
12671,75,2,2021-02-26,556,1,3713,29,2021-02-26,1614294000.0
12672,75,2,2021-02-27,56,0,3769,29,2021-02-27,1614380400.0
12673,75,2,2021-02-28,2,0,3771,29,2021-02-28,1614466800.0
12674,75,2,2021-03-01,371,0,4142,29,2021-03-01,1614553200.0
12675,75,2,2021-03-02,1125,2,5267,31,2021-03-02,1614639600.0
12676,75,2,2021-03-03,923,0,6190,31,2021-03-03,1614726000.0
12677,75,2,2021-03-04,1791,1,7981,32,2021-03-04,1614812400.0
12678,75,2,2021-03-05,1454,1,9435,33,2021-03-05,1614898800.0
12679,75,2,2021-03-06,119,1,9554,34,2021-03-06,1614985200.0
12680,75,2,2021-03-07,0,0,9554,34,2021-03-07,1615071600.0
12681,75,2,2021-03-08,788,0,10342,34,2021-03-08,1615158000.0
12682,75,2,2021-03-09,1651,2,11993,36,2021-03-09,1615244400.0
12683,75,2,2021-03-10,1112,2,13105,38,2021-03-10,1615330800.0
12684,75,2,2021-03-11,1415,1,14520,39,2021-03-11,1615417200.0
12685,75,2,2021-03-12,1429,0,15949,39,2021-03-12,1615503600.0
12686,75,2,2021-03-13,519,2,16468,41,2021-03-13,1615590000.0
12687,75,2,2021-03-14,50,0,16518,41,2021-03-14,1615676400.0
12688,75,2,2021-03-15,1085,59,17603,100,2021-03-15,1615762800.0
12689,75,2,2021-03-16,1282,234,18885,334,2021-03-16,1615849200.0
12690,75,2,2021-03-17,1223,287,20108,621,2021-03-17,1615935600.0
12691,75,2,2021-03-18,1523,395,21631,1016,2021-03-18,1616022000.0
12692,75,2,2021-03-19,1736,230,23367,1246,2021-03-19,1616108400.0
12693,75,2,2021-03-20,1111,46,24478,1292,2021-03-20,1616194800.0
12694,75,2,2021-03-21,298,0,24776,1292,2021-03-21,1616281200.0
12695,75,2,2021-03-22,1495,302,26271,1594,2021-03-22,1616367600.0
12696,75,2,2021-03-23,2449,467,28720,2061,2021-03-23,1616454000.0
12697,75,2,2021-03-24,2044,515,30764,2576,2021-03-24,1616540400.0
12698,75,2,2021-03-25,2617,595,33381,3171,2021-03-25,1616626800.0
12699,75,2,2021-03-26,2801,496,36182,3667,2021-03-26,1616713200.0
12700,75,2,2021-03-27,1787,56,37969,3723,2021-03-27,1616799600.0
12701,75,2,2021-03-28,915,0,38884,3723,2021-03-28,1616886000.0
12702,75,2,2021-03-29,2571,437,41455,4160,2021-03-29,1616972400.0
12703,75,2,2021-03-30,3092,1138,44547,5298,2021-03-30,1617058800.0
12704,75,2,2021-03-31,3134,890,47681,6188,2021-03-31,1617145200.0
12705,75,2,2021-04-01,3915,1635,51596,7823,2021-04-01,1617231600.0
12706,75,2,2021-04-02,4131,1262,55727,9085,2021-04-02,1617318000.0
12707,75,2,2021-04-03,1925,217,57652,9302,2021-04-03,1617404400.0
12708,75,2,2021-04-04,1044,1,58696,9303,2021-04-04,1617490800.0
12709,75,2,2021-04-05,1526,211,60222,9514,2021-04-05,1617577200.0
12710,75,2,2021-04-06,3561,1570,63783,11084,2021-04-06,1617663600.0
12711,75,2,2021-04-07,4015,1155,67798,12239,2021-04-07,1617750000.0
12712,75,2,2021-04-08,5170,1355,72968,13594,2021-04-08,1617836400.0
12713,75,2,2021-04-09,4930,1421,77898,15015,2021-04-09,1617922800.0
12714,75,2,2021-04-10,2661,621,80559,15636,2021-04-10,1618009200.0
12715,75,2,2021-04-11,799,51,81358,15687,2021-04-11,1618095600.0
12716,75,2,2021-04-12,2983,1024,84341,16711,2021-04-12,1618185600.0
12717,75,2,2021-04-13,3728,1289,88069,18000,2021-04-13,1618272000.0
12718,75,2,2021-04-14,3335,1139,91404,19139,2021-04-14,1618358400.0
12719,75,2,2021-04-15,3452,1571,94856,20710,2021-04-15,1618444800.0
12720,75,2,2021-04-16,3327,1774,98183,22484,2021-04-16,1618531200.0
12721,75,2,2021-04-17,2602,1176,100785,23660,2021-04-17,1618617600.0
12722,75,2,2021-04-18,1633,60,102418,23720,2021-04-18,1618704000.0
12723,75,2,2021-04-19,2550,1269,104968,24989,2021-04-19,1618790400.0
12724,75,2,2021-04-20,2920,2358,107888,27347,2021-04-20,1618876800.0
12725,75,2,2021-04-21,2574,1805,110462,29152,2021-04-21,1618963200.0
12726,75,2,2021-04-22,2755,2670,113217,31822,2021-04-22,1619049600.0
12727,75,2,2021-04-23,2799,2724,116016,34546,2021-04-23,1619136000.0
12728,75,2,2021-04-24,1570,2131,117586,36677,2021-04-24,1619222400.0
12729,75,2,2021-04-25,841,467,118427,37144,2021-04-25,1619308800.0
12730,75,2,2021-04-26,1657,2441,120084,39585,2021-04-26,1619395200.0
12731,75,2,2021-04-27,2284,3148,122368,42733,2021-04-27,1619481600.0
12732,75,2,2021-04-28,3383,2906,125751,45639,2021-04-28,1619568000.0
12733,75,2,2021-04-29,1814,3872,127565,49511,2021-04-29,1619654400.0
12734,75,2,2021-04-30,2124,4526,129689,54037,2021-04-30,1619740800.0
12735,75,2,2021-05-01,2789,1703,132478,55740,2021-05-01,1619827200.0
12736,75,2,2021-05-02,494,1169,132972,56909,2021-05-02,1619913600.0
12737,75,2,2021-05-03,2436,1705,135408,58614,2021-05-03,1620000000.0
12738,75,2,2021-05-04,2905,3832,138313,62446,2021-05-04,1620086400.0
12739,75,2,2021-05-05,2840,3686,141153,66132,2021-05-05,1620172800.0
12740,75,2,2021-05-06,4217,4757,145370,70889,2021-05-06,1620259200.0
12741,75,2,2021-05-07,3808,4604,149178,75493,2021-05-07,1620345600.0
12742,75,2,2021-05-08,2210,1359,151388,76852,2021-05-08,1620432000.0
12743,75,2,2021-05-09,829,962,152217,77814,2021-05-09,1620518400.0
12744,75,2,2021-05-10,2295,3522,154512,81336,2021-05-10,1620604800.0
12745,75,2,2021-05-11,4284,4038,158796,85374,2021-05-11,1620691200.0
12746,75,2,2021-05-12,3512,3332,162308,88706,2021-05-12,1620777600.0
12747,75,2,2021-05-13,2372,1225,164680,89931,2021-05-13,1620864000.0
12748,75,2,2021-05-14,3160,2949,167840,92880,2021-05-14,1620950400.0
12749,75,2,2021-05-15,3070,1635,170910,94515,2021-05-15,1621036800.0
12750,75,2,2021-05-16,1521,75,172431,94590,2021-05-16,1621123200.0
12751,75,2,2021-05-17,4363,2385,176794,96975,2021-05-17,1621206000.0
12752,75,2,2021-05-18,6202,2182,182996,99157,2021-05-18,1621292400.0
12753,75,2,2021-05-19,6285,2071,189281,101228,2021-05-19,1621378800.0
12754,75,2,2021-05-20,8026,1808,197307,103036,2021-05-20,1621465200.0
12755,75,2,2021-05-21,6416,2195,203723,105231,2021-05-21,1621551600.0
12756,75,2,2021-05-22,4960,933,208683,106164,2021-05-22,1621638000.0
12757,75,2,2021-05-23,2734,57,211417,106221,2021-05-23,1621724400.0
12758,75,2,2021-05-24,1093,498,212510,106719,2021-05-24,1621810800.0
12759,75,2,2021-05-25,3249,2093,215759,108812,2021-05-25,1621897200.0
12760,75,2,2021-05-26,3173,1594,218932,110406,2021-05-26,1621983600.0
12761,75,2,2021-05-27,3893,1662,222825,112068,2021-05-27,1622070000.0
12762,75,2,2021-05-28,2927,1707,225752,113775,2021-05-28,1622156400.0
12763,75,2,2021-05-29,1610,1072,227362,114847,2021-05-29,1622242800.0
12764,75,2,2021-05-30,50,823,227412,115670,2021-05-30,1622329200.0
12765,75,2,2021-05-31,1542,1763,228954,117433,2021-05-31,1622415600.0
12766,75,2,2021-06-01,3393,1460,232347,118893,2021-06-01,1622502000.0
12767,75,2,2021-06-02,4191,1719,236538,120612,2021-06-02,1622588400.0
12768,75,2,2021-06-03,6394,1632,242932,122244,2021-06-03,1622674800.0
12769,75,2,2021-06-04,7375,2058,250307,124302,2021-06-04,1622761200.0
12770,75,2,2021-06-05,3307,1367,253614,125669,2021-06-05,1622847600.0
12771,75,2,2021-06-06,408,844,254022,126513,2021-06-06,1622934000.0
12772,75,2,2021-06-07,2758,2157,256780,128670,2021-06-07,1623020400.0
12773,75,2,2021-06-08,5368,2475,262148,131145,2021-06-08,1623106800.0
12774,75,2,2021-06-09,3827,2620,265975,133765,2021-06-09,1623193200.0
12775,75,2,2021-06-10,4646,954,270621,134719,2021-06-10,1623279600.0
12776,75,2,2021-06-11,6744,1746,277365,136465,2021-06-11,1623366000.0
12777,75,2,2021-06-12,2920,2802,280285,139267,2021-06-12,1623452400.0
12778,75,2,2021-06-13,259,357,280544,139624,2021-06-13,1623538800.0
12779,75,2,2021-06-14,2584,3113,283128,142737,2021-06-14,1623625200.0
12780,75,2,2021-06-15,4401,2911,287529,145648,2021-06-15,1623711600.0
12781,75,2,2021-06-16,3712,2853,291241,148501,2021-06-16,1623798000.0
12782,75,2,2021-06-17,4932,4180,296173,152681,2021-06-17,1623884400.0
12783,75,2,2021-06-18,6055,4055,302228,156736,2021-06-18,1623970800.0
12784,75,2,2021-06-19,2407,2341,304635,159077,2021-06-19,1624057200.0
12785,75,2,2021-06-20,131,376,304766,159453,2021-06-20,1624143600.0
12786,75,2,2021-06-21,1969,2765,306735,162218,2021-06-21,1624230000.0
12787,75,2,2021-06-22,3639,3855,310374,166073,2021-06-22,1624316400.0
12788,75,2,2021-06-23,2488,3665,312862,169738,2021-06-23,1624402800.0
12789,75,2,2021-06-24,3824,2670,316686,172408,2021-06-24,1624489200.0
12790,75,2,2021-06-25,4048,4116,320734,176524,2021-06-25,1624575600.0
12791,75,2,2021-06-26,1549,4010,322283,180534,2021-06-26,1624662000.0
12792,75,2,2021-06-27,146,1764,322429,182298,2021-06-27,1624748400.0
12793,75,2,2021-06-28,1544,5216,323973,187514,2021-06-28,1624834800.0
12794,75,2,2021-06-29,2701,6892,326674,194406,2021-06-29,1624921200.0
12795,75,2,2021-06-30,2061,6894,328735,201300,2021-06-30,1625007600.0
12796,75,2,2021-07-01,2324,7014,331059,208314,2021-07-01,1625094000.0
12797,75,2,2021-07-02,2809,7486,333868,215800,2021-07-02,1625180400.0
12798,75,2,2021-07-03,962,5056,334830,220856,2021-07-03,1625266800.0
12799,75,2,2021-07-04,58,1151,334888,222007,2021-07-04,1625353200.0
12800,75,2,2021-07-05,974,3466,335862,225473,2021-07-05,1625439600.0
12801,75,2,2021-07-06,1861,5021,337723,230494,2021-07-06,1625526000.0
12802,75,2,2021-07-07,1787,4540,339510,235034,2021-07-07,1625612400.0
12803,75,2,2021-07-08,2240,5946,341750,240980,2021-07-08,1625698800.0
12804,75,3,2020-12-27,0,0,0,0,2020-12-27,1609023600.0
12805,75,3,2020-12-28,0,0,0,0,2020-12-28,1609110000.0
12806,75,3,2020-12-29,0,0,0,0,2020-12-29,1609196400.0
12807,75,3,2020-12-30,0,0,0,0,2020-12-30,1609282800.0
12808,75,3,2020-12-31,0,0,0,0,2020-12-31,1609369200.0
12809,75,3,2021-01-01,0,0,0,0,2021-01-01,1609455600.0
12810,75,3,2021-01-02,0,0,0,0,2021-01-02,1609542000.0
12811,75,3,2021-01-03,0,0,0,0,2021-01-03,1609628400.0
12812,75,3,2021-01-04,0,0,0,0,2021-01-04,1609714800.0
12813,75,3,2021-01-05,0,0,0,0,2021-01-05,1609801200.0
12814,75,3,2021-01-06,0,0,0,0,2021-01-06,1609887600.0
12815,75,3,2021-01-07,0,0,0,0,2021-01-07,1609974000.0
12816,75,3,2021-01-08,0,0,0,0,2021-01-08,1610060400.0
12817,75,3,2021-01-09,0,0,0,0,2021-01-09,1610146800.0
12818,75,3,2021-01-10,0,0,0,0,2021-01-10,1610233200.0
12819,75,3,2021-01-11,0,0,0,0,2021-01-11,1610319600.0
12820,75,3,2021-01-12,0,0,0,0,2021-01-12,1610406000.0
12821,75,3,2021-01-13,0,0,0,0,2021-01-13,1610492400.0
12822,75,3,2021-01-14,0,0,0,0,2021-01-14,1610578800.0
12823,75,3,2021-01-15,0,0,0,0,2021-01-15,1610665200.0
12824,75,3,2021-01-16,0,0,0,0,2021-01-16,1610751600.0
12825,75,3,2021-01-17,0,0,0,0,2021-01-17,1610838000.0
12826,75,3,2021-01-18,0,0,0,0,2021-01-18,1610924400.0
12827,75,3,2021-01-19,0,0,0,0,2021-01-19,1611010800.0
12828,75,3,2021-01-20,0,0,0,0,2021-01-20,1611097200.0
12829,75,3,2021-01-21,0,0,0,0,2021-01-21,1611183600.0
12830,75,3,2021-01-22,0,0,0,0,2021-01-22,1611270000.0
12831,75,3,2021-01-23,0,0,0,0,2021-01-23,1611356400.0
12832,75,3,2021-01-24,0,0,0,0,2021-01-24,1611442800.0
12833,75,3,2021-01-25,0,0,0,0,2021-01-25,1611529200.0
12834,75,3,2021-01-26,0,0,0,0,2021-01-26,1611615600.0
12835,75,3,2021-01-27,0,0,0,0,2021-01-27,1611702000.0
12836,75,3,2021-01-28,0,0,0,0,2021-01-28,1611788400.0
12837,75,3,2021-01-29,0,0,0,0,2021-01-29,1611874800.0
12838,75,3,2021-01-30,0,0,0,0,2021-01-30,1611961200.0
12839,75,3,2021-01-31,0,0,0,0,2021-01-31,1612047600.0
12840,75,3,2021-02-01,0,0,0,0,2021-02-01,1612134000.0
12841,75,3,2021-02-02,0,0,0,0,2021-02-02,1612220400.0
12842,75,3,2021-02-03,0,0,0,0,2021-02-03,1612306800.0
12843,75,3,2021-02-04,0,0,0,0,2021-02-04,1612393200.0
12844,75,3,2021-02-05,0,0,0,0,2021-02-05,1612479600.0
12845,75,3,2021-02-06,33,0,33,0,2021-02-06,1612566000.0
12846,75,3,2021-02-07,358,0,391,0,2021-02-07,1612652400.0
12847,75,3,2021-02-08,321,0,712,0,2021-02-08,1612738800.0
12848,75,3,2021-02-09,452,0,1164,0,2021-02-09,1612825200.0
12849,75,3,2021-02-10,744,0,1908,0,2021-02-10,1612911600.0
12850,75,3,2021-02-11,1052,0,2960,0,2021-02-11,1612998000.0
12851,75,3,2021-02-12,870,0,3830,0,2021-02-12,1613084400.0
12852,75,3,2021-02-13,111,0,3941,0,2021-02-13,1613170800.0
12853,75,3,2021-02-14,20,0,3961,0,2021-02-14,1613257200.0
12854,75,3,2021-02-15,644,0,4605,0,2021-02-15,1613343600.0
12855,75,3,2021-02-16,808,0,5413,0,2021-02-16,1613430000.0
12856,75,3,2021-02-17,747,0,6160,0,2021-02-17,1613516400.0
12857,75,3,2021-02-18,906,0,7066,0,2021-02-18,1613602800.0
12858,75,3,2021-02-19,958,0,8024,0,2021-02-19,1613689200.0
12859,75,3,2021-02-20,196,0,8220,0,2021-02-20,1613775600.0
12860,75,3,2021-02-21,49,0,8269,0,2021-02-21,1613862000.0
12861,75,3,2021-02-22,977,0,9246,0,2021-02-22,1613948400.0
12862,75,3,2021-02-23,1191,0,10437,0,2021-02-23,1614034800.0
12863,75,3,2021-02-24,1279,0,11716,0,2021-02-24,1614121200.0
12864,75,3,2021-02-25,4340,0,16056,0,2021-02-25,1614207600.0
12865,75,3,2021-02-26,7019,0,23075,0,2021-02-26,1614294000.0
12866,75,3,2021-02-27,4206,0,27281,0,2021-02-27,1614380400.0
12867,75,3,2021-02-28,180,0,27461,0,2021-02-28,1614466800.0
12868,75,3,2021-03-01,2258,1,29719,1,2021-03-01,1614553200.0
12869,75,3,2021-03-02,4616,0,34335,1,2021-03-02,1614639600.0
12870,75,3,2021-03-03,5791,0,40126,1,2021-03-03,1614726000.0
12871,75,3,2021-03-04,10029,1,50155,2,2021-03-04,1614812400.0
12872,75,3,2021-03-05,14442,6,64597,8,2021-03-05,1614898800.0
12873,75,3,2021-03-06,11445,1,76042,9,2021-03-06,1614985200.0
12874,75,3,2021-03-07,3207,1,79249,10,2021-03-07,1615071600.0
12875,75,3,2021-03-08,4906,1,84155,11,2021-03-08,1615158000.0
12876,75,3,2021-03-09,8581,2,92736,13,2021-03-09,1615244400.0
12877,75,3,2021-03-10,9029,2,101765,15,2021-03-10,1615330800.0
12878,75,3,2021-03-11,15596,2,117361,17,2021-03-11,1615417200.0
12879,75,3,2021-03-12,20945,8,138306,25,2021-03-12,1615503600.0
12880,75,3,2021-03-13,13512,4,151818,29,2021-03-13,1615590000.0
12881,75,3,2021-03-14,848,0,152666,29,2021-03-14,1615676400.0
12882,75,3,2021-03-15,4030,1,156696,30,2021-03-15,1615762800.0
12883,75,3,2021-03-16,103,2,156799,32,2021-03-16,1615849200.0
12884,75,3,2021-03-17,63,0,156862,32,2021-03-17,1615935600.0
12885,75,3,2021-03-18,118,0,156980,32,2021-03-18,1616022000.0
12886,75,3,2021-03-19,6915,3,163895,35,2021-03-19,1616108400.0
12887,75,3,2021-03-20,6524,2,170419,37,2021-03-20,1616194800.0
12888,75,3,2021-03-21,293,0,170712,37,2021-03-21,1616281200.0
12889,75,3,2021-03-22,3381,5,174093,42,2021-03-22,1616367600.0
12890,75,3,2021-03-23,8403,7,182496,49,2021-03-23,1616454000.0
12891,75,3,2021-03-24,9564,7,192060,56,2021-03-24,1616540400.0
12892,75,3,2021-03-25,16029,12,208089,68,2021-03-25,1616626800.0
12893,75,3,2021-03-26,17944,15,226033,83,2021-03-26,1616713200.0
12894,75,3,2021-03-27,6637,4,232670,87,2021-03-27,1616799600.0
12895,75,3,2021-03-28,276,0,232946,87,2021-03-28,1616886000.0
12896,75,3,2021-03-29,5483,5,238429,92,2021-03-29,1616972400.0
12897,75,3,2021-03-30,9746,9,248175,101,2021-03-30,1617058800.0
12898,75,3,2021-03-31,7074,3,255249,104,2021-03-31,1617145200.0
12899,75,3,2021-04-01,9721,10,264970,114,2021-04-01,1617231600.0
12900,75,3,2021-04-02,9230,17,274200,131,2021-04-02,1617318000.0
12901,75,3,2021-04-03,3360,3,277560,134,2021-04-03,1617404400.0
12902,75,3,2021-04-04,123,0,277683,134,2021-04-04,1617490800.0
12903,75,3,2021-04-05,220,14,277903,148,2021-04-05,1617577200.0
12904,75,3,2021-04-06,2985,2,280888,150,2021-04-06,1617663600.0
12905,75,3,2021-04-07,3229,2,284117,152,2021-04-07,1617750000.0
12906,75,3,2021-04-08,8662,14,292779,166,2021-04-08,1617836400.0
12907,75,3,2021-04-09,19395,27,312174,193,2021-04-09,1617922800.0
12908,75,3,2021-04-10,8515,12,320689,205,2021-04-10,1618009200.0
12909,75,3,2021-04-11,539,1,321228,206,2021-04-11,1618095600.0
12910,75,3,2021-04-12,5607,4,326835,210,2021-04-12,1618185600.0
12911,75,3,2021-04-13,10072,22,336907,232,2021-04-13,1618272000.0
12912,75,3,2021-04-14,8272,29,345179,261,2021-04-14,1618358400.0
12913,75,3,2021-04-15,10631,44,355810,305,2021-04-15,1618444800.0
12914,75,3,2021-04-16,12587,62,368397,367,2021-04-16,1618531200.0
12915,75,3,2021-04-17,5101,13,373498,380,2021-04-17,1618617600.0
12916,75,3,2021-04-18,719,3,374217,383,2021-04-18,1618704000.0
12917,75,3,2021-04-19,2353,18,376570,401,2021-04-19,1618790400.0
12918,75,3,2021-04-20,5372,37,381942,438,2021-04-20,1618876800.0
12919,75,3,2021-04-21,4705,17,386647,455,2021-04-21,1618963200.0
12920,75,3,2021-04-22,6942,72,393589,527,2021-04-22,1619049600.0
12921,75,3,2021-04-23,7512,82,401101,609,2021-04-23,1619136000.0
12922,75,3,2021-04-24,3833,130,404934,739,2021-04-24,1619222400.0
12923,75,3,2021-04-25,715,11,405649,750,2021-04-25,1619308800.0
12924,75,3,2021-04-26,2037,76,407686,826,2021-04-26,1619395200.0
12925,75,3,2021-04-27,3940,120,411626,946,2021-04-27,1619481600.0
12926,75,3,2021-04-28,3590,178,415216,1124,2021-04-28,1619568000.0
12927,75,3,2021-04-29,5888,535,421104,1659,2021-04-29,1619654400.0
12928,75,3,2021-04-30,6363,1061,427467,2720,2021-04-30,1619740800.0
12929,75,3,2021-05-01,983,183,428450,2903,2021-05-01,1619827200.0
12930,75,3,2021-05-02,488,19,428938,2922,2021-05-02,1619913600.0
12931,75,3,2021-05-03,1331,406,430269,3328,2021-05-03,1620000000.0
12932,75,3,2021-05-04,2621,790,432890,4118,2021-05-04,1620086400.0
12933,75,3,2021-05-05,2171,1196,435061,5314,2021-05-05,1620172800.0
12934,75,3,2021-05-06,4570,2592,439631,7906,2021-05-06,1620259200.0
12935,75,3,2021-05-07,5906,3156,445537,11062,2021-05-07,1620345600.0
12936,75,3,2021-05-08,843,655,446380,11717,2021-05-08,1620432000.0
12937,75,3,2021-05-09,191,146,446571,11863,2021-05-09,1620518400.0
12938,75,3,2021-05-10,1460,1499,448031,13362,2021-05-10,1620604800.0
12939,75,3,2021-05-11,3401,2997,451432,16359,2021-05-11,1620691200.0
12940,75,3,2021-05-12,1934,3149,453366,19508,2021-05-12,1620777600.0
12941,75,3,2021-05-13,264,560,453630,20068,2021-05-13,1620864000.0
12942,75,3,2021-05-14,1677,2854,455307,22922,2021-05-14,1620950400.0
12943,75,3,2021-05-15,858,2174,456165,25096,2021-05-15,1621036800.0
12944,75,3,2021-05-16,114,218,456279,25314,2021-05-16,1621123200.0
12945,75,3,2021-05-17,861,2241,457140,27555,2021-05-17,1621206000.0
12946,75,3,2021-05-18,1650,3069,458790,30624,2021-05-18,1621292400.0
12947,75,3,2021-05-19,1067,3137,459857,33761,2021-05-19,1621378800.0
12948,75,3,2021-05-20,1494,6613,461351,40374,2021-05-20,1621465200.0
12949,75,3,2021-05-21,1489,7275,462840,47649,2021-05-21,1621551600.0
12950,75,3,2021-05-22,496,3527,463336,51176,2021-05-22,1621638000.0
12951,75,3,2021-05-23,40,305,463376,51481,2021-05-23,1621724400.0
12952,75,3,2021-05-24,51,511,463427,51992,2021-05-24,1621810800.0
12953,75,3,2021-05-25,608,4520,464035,56512,2021-05-25,1621897200.0
12954,75,3,2021-05-26,480,5908,464515,62420,2021-05-26,1621983600.0
12955,75,3,2021-05-27,686,9753,465201,72173,2021-05-27,1622070000.0
12956,75,3,2021-05-28,839,11818,466040,83991,2021-05-28,1622156400.0
12957,75,3,2021-05-29,306,6591,466346,90582,2021-05-29,1622242800.0
12958,75,3,2021-05-30,16,363,466362,90945,2021-05-30,1622329200.0
12959,75,3,2021-05-31,197,3652,466559,94597,2021-05-31,1622415600.0
12960,75,3,2021-06-01,320,7141,466879,101738,2021-06-01,1622502000.0
12961,75,3,2021-06-02,248,6916,467127,108654,2021-06-02,1622588400.0
12962,75,3,2021-06-03,363,10553,467490,119207,2021-06-03,1622674800.0
12963,75,3,2021-06-04,433,12353,467923,131560,2021-06-04,1622761200.0
12964,75,3,2021-06-05,195,5264,468118,136824,2021-06-05,1622847600.0
12965,75,3,2021-06-06,20,380,468138,137204,2021-06-06,1622934000.0
12966,75,3,2021-06-07,86,3087,468224,140291,2021-06-07,1623020400.0
12967,75,3,2021-06-08,197,4861,468421,145152,2021-06-08,1623106800.0
12968,75,3,2021-06-09,107,4832,468528,149984,2021-06-09,1623193200.0
12969,75,3,2021-06-10,202,7781,468730,157765,2021-06-10,1623279600.0
12970,75,3,2021-06-11,226,11178,468956,168943,2021-06-11,1623366000.0
12971,75,3,2021-06-12,117,3966,469073,172909,2021-06-12,1623452400.0
12972,75,3,2021-06-13,23,298,469096,173207,2021-06-13,1623538800.0
12973,75,3,2021-06-14,58,4375,469154,177582,2021-06-14,1623625200.0
12974,75,3,2021-06-15,110,8490,469264,186072,2021-06-15,1623711600.0
12975,75,3,2021-06-16,94,7496,469358,193568,2021-06-16,1623798000.0
12976,75,3,2021-06-17,160,11881,469518,205449,2021-06-17,1623884400.0
12977,75,3,2021-06-18,138,13284,469656,218733,2021-06-18,1623970800.0
12978,75,3,2021-06-19,63,3930,469719,222663,2021-06-19,1624057200.0
12979,75,3,2021-06-20,4,364,469723,223027,2021-06-20,1624143600.0
12980,75,3,2021-06-21,41,4022,469764,227049,2021-06-21,1624230000.0
12981,75,3,2021-06-22,80,7975,469844,235024,2021-06-22,1624316400.0
12982,75,3,2021-06-23,63,6290,469907,241314,2021-06-23,1624402800.0
12983,75,3,2021-06-24,91,8803,469998,250117,2021-06-24,1624489200.0
12984,75,3,2021-06-25,113,10285,470111,260402,2021-06-25,1624575600.0
12985,75,3,2021-06-26,52,3027,470163,263429,2021-06-26,1624662000.0
12986,75,3,2021-06-27,1,210,470164,263639,2021-06-27,1624748400.0
12987,75,3,2021-06-28,27,3102,470191,266741,2021-06-28,1624834800.0
12988,75,3,2021-06-29,59,6601,470250,273342,2021-06-29,1624921200.0
12989,75,3,2021-06-30,56,5355,470306,278697,2021-06-30,1625007600.0
12990,75,3,2021-07-01,84,7689,470390,286386,2021-07-01,1625094000.0
12991,75,3,2021-07-02,111,10497,470501,296883,2021-07-02,1625180400.0
12992,75,3,2021-07-03,52,3104,470553,299987,2021-07-03,1625266800.0
12993,75,3,2021-07-04,5,383,470558,300370,2021-07-04,1625353200.0
12994,75,3,2021-07-05,42,3550,470600,303920,2021-07-05,1625439600.0
12995,75,3,2021-07-06,72,7327,470672,311247,2021-07-06,1625526000.0
12996,75,3,2021-07-07,46,5379,470718,316626,2021-07-07,1625612400.0
12997,75,3,2021-07-08,82,7207,470800,323833,2021-07-08,1625698800.0
12998,75,4,2020-12-27,0,0,0,0,2020-12-27,1609023600.0
12999,75,4,2020-12-28,0,0,0,0,2020-12-28,1609110000.0
13000,75,4,2020-12-29,0,0,0,0,2020-12-29,1609196400.0
13001,75,4,2020-12-30,0,0,0,0,2020-12-30,1609282800.0
13002,75,4,2020-12-31,0,0,0,0,2020-12-31,1609369200.0
13003,75,4,2021-01-01,0,0,0,0,2021-01-01,1609455600.0
13004,75,4,2021-01-02,0,0,0,0,2021-01-02,1609542000.0
13005,75,4,2021-01-03,0,0,0,0,2021-01-03,1609628400.0
13006,75,4,2021-01-04,0,0,0,0,2021-01-04,1609714800.0
13007,75,4,2021-01-05,0,0,0,0,2021-01-05,1609801200.0
13008,75,4,2021-01-06,0,0,0,0,2021-01-06,1609887600.0
13009,75,4,2021-01-07,0,0,0,0,2021-01-07,1609974000.0
13010,75,4,2021-01-08,0,0,0,0,2021-01-08,1610060400.0
13011,75,4,2021-01-09,0,0,0,0,2021-01-09,1610146800.0
13012,75,4,2021-01-10,0,0,0,0,2021-01-10,1610233200.0
13013,75,4,2021-01-11,0,0,0,0,2021-01-11,1610319600.0
13014,75,4,2021-01-12,0,0,0,0,2021-01-12,1610406000.0
13015,75,4,2021-01-13,0,0,0,0,2021-01-13,1610492400.0
13016,75,4,2021-01-14,0,0,0,0,2021-01-14,1610578800.0
13017,75,4,2021-01-15,0,0,0,0,2021-01-15,1610665200.0
13018,75,4,2021-01-16,0,0,0,0,2021-01-16,1610751600.0
13019,75,4,2021-01-17,0,0,0,0,2021-01-17,1610838000.0
13020,75,4,2021-01-18,0,0,0,0,2021-01-18,1610924400.0
13021,75,4,2021-01-19,0,0,0,0,2021-01-19,1611010800.0
13022,75,4,2021-01-20,0,0,0,0,2021-01-20,1611097200.0
13023,75,4,2021-01-21,0,0,0,0,2021-01-21,1611183600.0
13024,75,4,2021-01-22,0,0,0,0,2021-01-22,1611270000.0
13025,75,4,2021-01-23,0,0,0,0,2021-01-23,1611356400.0
13026,75,4,2021-01-24,0,0,0,0,2021-01-24,1611442800.0
13027,75,4,2021-01-25,0,0,0,0,2021-01-25,1611529200.0
13028,75,4,2021-01-26,0,0,0,0,2021-01-26,1611615600.0
13029,75,4,2021-01-27,0,0,0,0,2021-01-27,1611702000.0
13030,75,4,2021-01-28,0,0,0,0,2021-01-28,1611788400.0
13031,75,4,2021-01-29,0,0,0,0,2021-01-29,1611874800.0
13032,75,4,2021-01-30,0,0,0,0,2021-01-30,1611961200.0
13033,75,4,2021-01-31,0,0,0,0,2021-01-31,1612047600.0
13034,75,4,2021-02-01,0,0,0,0,2021-02-01,1612134000.0
13035,75,4,2021-02-02,0,0,0,0,2021-02-02,1612220400.0
13036,75,4,2021-02-03,0,0,0,0,2021-02-03,1612306800.0
13037,75,4,2021-02-04,0,0,0,0,2021-02-04,1612393200.0
13038,75,4,2021-02-05,0,0,0,0,2021-02-05,1612479600.0
13039,75,4,2021-02-06,0,0,0,0,2021-02-06,1612566000.0
13040,75,4,2021-02-07,0,0,0,0,2021-02-07,1612652400.0
13041,75,4,2021-02-08,0,0,0,0,2021-02-08,1612738800.0
13042,75,4,2021-02-09,0,0,0,0,2021-02-09,1612825200.0
13043,75,4,2021-02-10,0,0,0,0,2021-02-10,1612911600.0
13044,75,4,2021-02-11,0,0,0,0,2021-02-11,1612998000.0
13045,75,4,2021-02-12,0,0,0,0,2021-02-12,1613084400.0
13046,75,4,2021-02-13,0,0,0,0,2021-02-13,1613170800.0
13047,75,4,2021-02-14,0,0,0,0,2021-02-14,1613257200.0
13048,75,4,2021-02-15,0,0,0,0,2021-02-15,1613343600.0
13049,75,4,2021-02-16,0,0,0,0,2021-02-16,1613430000.0
13050,75,4,2021-02-17,0,0,0,0,2021-02-17,1613516400.0
13051,75,4,2021-02-18,0,0,0,0,2021-02-18,1613602800.0
13052,75,4,2021-02-19,0,0,0,0,2021-02-19,1613689200.0
13053,75,4,2021-02-20,0,0,0,0,2021-02-20,1613775600.0
13054,75,4,2021-02-21,0,0,0,0,2021-02-21,1613862000.0
13055,75,4,2021-02-22,0,0,0,0,2021-02-22,1613948400.0
13056,75,4,2021-02-23,0,0,0,0,2021-02-23,1614034800.0
13057,75,4,2021-02-24,0,0,0,0,2021-02-24,1614121200.0
13058,75,4,2021-02-25,0,0,0,0,2021-02-25,1614207600.0
13059,75,4,2021-02-26,0,0,0,0,2021-02-26,1614294000.0
13060,75,4,2021-02-27,0,0,0,0,2021-02-27,1614380400.0
13061,75,4,2021-02-28,0,0,0,0,2021-02-28,1614466800.0
13062,75,4,2021-03-01,0,0,0,0,2021-03-01,1614553200.0
13063,75,4,2021-03-02,0,0,0,0,2021-03-02,1614639600.0
13064,75,4,2021-03-03,0,0,0,0,2021-03-03,1614726000.0
13065,75,4,2021-03-04,0,0,0,0,2021-03-04,1614812400.0
13066,75,4,2021-03-05,0,0,0,0,2021-03-05,1614898800.0
13067,75,4,2021-03-06,0,0,0,0,2021-03-06,1614985200.0
13068,75,4,2021-03-07,0,0,0,0,2021-03-07,1615071600.0
13069,75,4,2021-03-08,0,0,0,0,2021-03-08,1615158000.0
13070,75,4,2021-03-09,0,0,0,0,2021-03-09,1615244400.0
13071,75,4,2021-03-10,0,0,0,0,2021-03-10,1615330800.0
13072,75,4,2021-03-11,0,0,0,0,2021-03-11,1615417200.0
13073,75,4,2021-03-12,0,0,0,0,2021-03-12,1615503600.0
13074,75,4,2021-03-13,0,0,0,0,2021-03-13,1615590000.0
13075,75,4,2021-03-14,0,0,0,0,2021-03-14,1615676400.0
13076,75,4,2021-03-15,0,0,0,0,2021-03-15,1615762800.0
13077,75,4,2021-03-16,0,0,0,0,2021-03-16,1615849200.0
13078,75,4,2021-03-17,0,0,0,0,2021-03-17,1615935600.0
13079,75,4,2021-03-18,0,0,0,0,2021-03-18,1616022000.0
13080,75,4,2021-03-19,0,0,0,0,2021-03-19,1616108400.0
13081,75,4,2021-03-20,0,0,0,0,2021-03-20,1616194800.0
13082,75,4,2021-03-21,0,0,0,0,2021-03-21,1616281200.0
13083,75,4,2021-03-22,0,0,0,0,2021-03-22,1616367600.0
13084,75,4,2021-03-23,0,0,0,0,2021-03-23,1616454000.0
13085,75,4,2021-03-24,0,0,0,0,2021-03-24,1616540400.0
13086,75,4,2021-03-25,0,0,0,0,2021-03-25,1616626800.0
13087,75,4,2021-03-26,0,0,0,0,2021-03-26,1616713200.0
13088,75,4,2021-03-27,0,0,0,0,2021-03-27,1616799600.0
13089,75,4,2021-03-28,0,0,0,0,2021-03-28,1616886000.0
13090,75,4,2021-03-29,0,0,0,0,2021-03-29,1616972400.0
13091,75,4,2021-03-30,0,0,0,0,2021-03-30,1617058800.0
13092,75,4,2021-03-31,0,0,0,0,2021-03-31,1617145200.0
13093,75,4,2021-04-01,0,0,0,0,2021-04-01,1617231600.0
13094,75,4,2021-04-02,0,0,0,0,2021-04-02,1617318000.0
13095,75,4,2021-04-03,0,0,0,0,2021-04-03,1617404400.0
13096,75,4,2021-04-04,0,0,0,0,2021-04-04,1617490800.0
13097,75,4,2021-04-05,0,0,0,0,2021-04-05,1617577200.0
13098,75,4,2021-04-06,0,0,0,0,2021-04-06,1617663600.0
13099,75,4,2021-04-07,0,0,0,0,2021-04-07,1617750000.0
13100,75,4,2021-04-08,0,0,0,0,2021-04-08,1617836400.0
13101,75,4,2021-04-09,0,0,0,0,2021-04-09,1617922800.0
13102,75,4,2021-04-10,0,0,0,0,2021-04-10,1618009200.0
13103,75,4,2021-04-11,0,0,0,0,2021-04-11,1618095600.0
13104,75,4,2021-04-12,0,0,0,0,2021-04-12,1618185600.0
13105,75,4,2021-04-13,0,0,0,0,2021-04-13,1618272000.0
13106,75,4,2021-04-14,0,0,0,0,2021-04-14,1618358400.0
13107,75,4,2021-04-15,0,0,0,0,2021-04-15,1618444800.0
13108,75,4,2021-04-16,0,0,0,0,2021-04-16,1618531200.0
13109,75,4,2021-04-17,0,0,0,0,2021-04-17,1618617600.0
13110,75,4,2021-04-18,0,0,0,0,2021-04-18,1618704000.0
13111,75,4,2021-04-19,0,0,0,0,2021-04-19,1618790400.0
13112,75,4,2021-04-20,0,0,0,0,2021-04-20,1618876800.0
13113,75,4,2021-04-21,0,0,0,0,2021-04-21,1618963200.0
13114,75,4,2021-04-22,0,0,0,0,2021-04-22,1619049600.0
13115,75,4,2021-04-23,96,0,96,0,2021-04-23,1619136000.0
13116,75,4,2021-04-24,177,0,273,0,2021-04-24,1619222400.0
13117,75,4,2021-04-25,10,0,283,0,2021-04-25,1619308800.0
13118,75,4,2021-04-26,343,0,626,0,2021-04-26,1619395200.0
13119,75,4,2021-04-27,1107,1,1733,1,2021-04-27,1619481600.0
13120,75,4,2021-04-28,1070,1,2803,2,2021-04-28,1619568000.0
13121,75,4,2021-04-29,1958,1,4761,3,2021-04-29,1619654400.0
13122,75,4,2021-04-30,2254,0,7015,3,2021-04-30,1619740800.0
13123,75,4,2021-05-01,244,0,7259,3,2021-05-01,1619827200.0
13124,75,4,2021-05-02,40,0,7299,3,2021-05-02,1619913600.0
13125,75,4,2021-05-03,526,0,7825,3,2021-05-03,1620000000.0
13126,75,4,2021-05-04,967,1,8792,4,2021-05-04,1620086400.0
13127,75,4,2021-05-05,775,0,9567,4,2021-05-05,1620172800.0
13128,75,4,2021-05-06,1497,6,11064,10,2021-05-06,1620259200.0
13129,75,4,2021-05-07,2401,1,13465,11,2021-05-07,1620345600.0
13130,75,4,2021-05-08,245,1,13710,12,2021-05-08,1620432000.0
13131,75,4,2021-05-09,35,0,13745,12,2021-05-09,1620518400.0
13132,75,4,2021-05-10,770,0,14515,12,2021-05-10,1620604800.0
13133,75,4,2021-05-11,1638,0,16153,12,2021-05-11,1620691200.0
13134,75,4,2021-05-12,1145,0,17298,12,2021-05-12,1620777600.0
13135,75,4,2021-05-13,263,0,17561,12,2021-05-13,1620864000.0
13136,75,4,2021-05-14,784,1,18345,13,2021-05-14,1620950400.0
13137,75,4,2021-05-15,379,0,18724,13,2021-05-15,1621036800.0
13138,75,4,2021-05-16,22,0,18746,13,2021-05-16,1621123200.0
13139,75,4,2021-05-17,553,1,19299,14,2021-05-17,1621206000.0
13140,75,4,2021-05-18,932,0,20231,14,2021-05-18,1621292400.0
13141,75,4,2021-05-19,502,0,20733,14,2021-05-19,1621378800.0
13142,75,4,2021-05-20,1001,0,21734,14,2021-05-20,1621465200.0
13143,75,4,2021-05-21,1391,0,23125,14,2021-05-21,1621551600.0
13144,75,4,2021-05-22,469,1,23594,15,2021-05-22,1621638000.0
13145,75,4,2021-05-23,24,0,23618,15,2021-05-23,1621724400.0
13146,75,4,2021-05-24,97,0,23715,15,2021-05-24,1621810800.0
13147,75,4,2021-05-25,703,5,24418,20,2021-05-25,1621897200.0
13148,75,4,2021-05-26,917,1,25335,21,2021-05-26,1621983600.0
13149,75,4,2021-05-27,1461,2,26796,23,2021-05-27,1622070000.0
13150,75,4,2021-05-28,3216,4,30012,27,2021-05-28,1622156400.0
13151,75,4,2021-05-29,1203,1,31215,28,2021-05-29,1622242800.0
13152,75,4,2021-05-30,52,0,31267,28,2021-05-30,1622329200.0
13153,75,4,2021-05-31,1386,1,32653,29,2021-05-31,1622415600.0
13154,75,4,2021-06-01,2302,3,34955,32,2021-06-01,1622502000.0
13155,75,4,2021-06-02,1653,3,36608,35,2021-06-02,1622588400.0
13156,75,4,2021-06-03,2363,3,38971,38,2021-06-03,1622674800.0
13157,75,4,2021-06-04,2566,3,41537,41,2021-06-04,1622761200.0
13158,75,4,2021-06-05,1143,3,42680,44,2021-06-05,1622847600.0
13159,75,4,2021-06-06,69,0,42749,44,2021-06-06,1622934000.0
13160,75,4,2021-06-07,1085,2,43834,46,2021-06-07,1623020400.0
13161,75,4,2021-06-08,1693,4,45527,50,2021-06-08,1623106800.0
13162,75,4,2021-06-09,1340,4,46867,54,2021-06-09,1623193200.0
13163,75,4,2021-06-10,1997,1,48864,55,2021-06-10,1623279600.0
13164,75,4,2021-06-11,2182,2,51046,57,2021-06-11,1623366000.0
13165,75,4,2021-06-12,808,0,51854,57,2021-06-12,1623452400.0
13166,75,4,2021-06-13,41,0,51895,57,2021-06-13,1623538800.0
13167,75,4,2021-06-14,784,1,52679,58,2021-06-14,1623625200.0
13168,75,4,2021-06-15,1426,3,54105,61,2021-06-15,1623711600.0
13169,75,4,2021-06-16,1053,0,55158,61,2021-06-16,1623798000.0
13170,75,4,2021-06-17,1506,1,56664,62,2021-06-17,1623884400.0
13171,75,4,2021-06-18,1434,5,58098,67,2021-06-18,1623970800.0
13172,75,4,2021-06-19,656,1,58754,68,2021-06-19,1624057200.0
13173,75,4,2021-06-20,38,0,58792,68,2021-06-20,1624143600.0
13174,75,4,2021-06-21,607,0,59399,68,2021-06-21,1624230000.0
13175,75,4,2021-06-22,890,2,60289,70,2021-06-22,1624316400.0
13176,75,4,2021-06-23,836,4,61125,74,2021-06-23,1624402800.0
13177,75,4,2021-06-24,1096,1,62221,75,2021-06-24,1624489200.0
13178,75,4,2021-06-25,1227,2,63448,77,2021-06-25,1624575600.0
13179,75,4,2021-06-26,495,2,63943,79,2021-06-26,1624662000.0
13180,75,4,2021-06-27,15,0,63958,79,2021-06-27,1624748400.0
13181,75,4,2021-06-28,532,1,64490,80,2021-06-28,1624834800.0
13182,75,4,2021-06-29,761,3,65251,83,2021-06-29,1624921200.0
13183,75,4,2021-06-30,847,6,66098,89,2021-06-30,1625007600.0
13184,75,4,2021-07-01,994,4,67092,93,2021-07-01,1625094000.0
13185,75,4,2021-07-02,1211,16,68303,109,2021-07-02,1625180400.0
13186,75,4,2021-07-03,559,1,68862,110,2021-07-03,1625266800.0
13187,75,4,2021-07-04,21,0,68883,110,2021-07-04,1625353200.0
13188,75,4,2021-07-05,470,1,69353,111,2021-07-05,1625439600.0
13189,75,4,2021-07-06,905,1,70258,112,2021-07-06,1625526000.0
13190,75,4,2021-07-07,837,0,71095,112,2021-07-07,1625612400.0
13191,75,4,2021-07-08,1145,4,72240,116,2021-07-08,1625698800.0
13192,76,1,2020-12-27,0,0,0,0,2020-12-27,1609023600.0
13193,76,1,2020-12-28,5,0,5,0,2020-12-28,1609110000.0
13194,76,1,2020-12-29,0,0,5,0,2020-12-29,1609196400.0
13195,76,1,2020-12-30,0,0,5,0,2020-12-30,1609282800.0
13196,76,1,2020-12-31,1,0,6,0,2020-12-31,1609369200.0
13197,76,1,2021-01-01,3,0,9,0,2021-01-01,1609455600.0
13198,76,1,2021-01-02,2,0,11,0,2021-01-02,1609542000.0
13199,76,1,2021-01-03,2,0,13,0,2021-01-03,1609628400.0
13200,76,1,2021-01-04,59,0,72,0,2021-01-04,1609714800.0
13201,76,1,2021-01-05,473,0,545,0,2021-01-05,1609801200.0
13202,76,1,2021-01-06,784,0,1329,0,2021-01-06,1609887600.0
13203,76,1,2021-01-07,2555,0,3884,0,2021-01-07,1609974000.0
13204,76,1,2021-01-08,3218,0,7102,0,2021-01-08,1610060400.0
13205,76,1,2021-01-09,1539,0,8641,0,2021-01-09,1610146800.0
13206,76,1,2021-01-10,517,0,9158,0,2021-01-10,1610233200.0
13207,76,1,2021-01-11,3524,0,12682,0,2021-01-11,1610319600.0
13208,76,1,2021-01-12,5752,0,18434,0,2021-01-12,1610406000.0
13209,76,1,2021-01-13,6477,0,24911,0,2021-01-13,1610492400.0
13210,76,1,2021-01-14,8998,0,33909,0,2021-01-14,1610578800.0
13211,76,1,2021-01-15,7253,0,41162,0,2021-01-15,1610665200.0
13212,76,1,2021-01-16,1953,16,43115,16,2021-01-16,1610751600.0
13213,76,1,2021-01-17,710,2,43825,18,2021-01-17,1610838000.0
13214,76,1,2021-01-18,7706,12,51531,30,2021-01-18,1610924400.0
13215,76,1,2021-01-19,11207,10,62738,40,2021-01-19,1611010800.0
13216,76,1,2021-01-20,13725,9,76463,49,2021-01-20,1611097200.0
13217,76,1,2021-01-21,16723,6,93186,55,2021-01-21,1611183600.0
13218,76,1,2021-01-22,11924,15,105110,70,2021-01-22,1611270000.0
13219,76,1,2021-01-23,3897,5,109007,75,2021-01-23,1611356400.0
13220,76,1,2021-01-24,771,10,109778,85,2021-01-24,1611442800.0
13221,76,1,2021-01-25,7829,85,117607,170,2021-01-25,1611529200.0
13222,76,1,2021-01-26,10350,266,127957,436,2021-01-26,1611615600.0
13223,76,1,2021-01-27,10850,461,138807,897,2021-01-27,1611702000.0
13224,76,1,2021-01-28,10140,1681,148947,2578,2021-01-28,1611788400.0
13225,76,1,2021-01-29,8092,1980,157039,4558,2021-01-29,1611874800.0
13226,76,1,2021-01-30,3186,769,160225,5327,2021-01-30,1611961200.0
13227,76,1,2021-01-31,521,267,160746,5594,2021-01-31,1612047600.0
13228,76,1,2021-02-01,5857,2596,166603,8190,2021-02-01,1612134000.0
13229,76,1,2021-02-02,10064,3987,176667,12177,2021-02-02,1612220400.0
13230,76,1,2021-02-03,9520,4048,186187,16225,2021-02-03,1612306800.0
13231,76,1,2021-02-04,10107,5925,196294,22150,2021-02-04,1612393200.0
13232,76,1,2021-02-05,7775,4984,204069,27134,2021-02-05,1612479600.0
13233,76,1,2021-02-06,2679,1047,206748,28181,2021-02-06,1612566000.0
13234,76,1,2021-02-07,476,494,207224,28675,2021-02-07,1612652400.0
13235,76,1,2021-02-08,4580,4512,211804,33187,2021-02-08,1612738800.0
13236,76,1,2021-02-09,5791,6788,217595,39975,2021-02-09,1612825200.0
13237,76,1,2021-02-10,6353,9194,223948,49169,2021-02-10,1612911600.0
13238,76,1,2021-02-11,7845,10665,231793,59834,2021-02-11,1612998000.0
13239,76,1,2021-02-12,6427,7629,238220,67463,2021-02-12,1613084400.0
13240,76,1,2021-02-13,2219,2260,240439,69723,2021-02-13,1613170800.0
13241,76,1,2021-02-14,335,993,240774,70716,2021-02-14,1613257200.0
13242,76,1,2021-02-15,2286,6444,243060,77160,2021-02-15,1613343600.0
13243,76,1,2021-02-16,3039,8658,246099,85818,2021-02-16,1613430000.0
13244,76,1,2021-02-17,3132,9603,249231,95421,2021-02-17,1613516400.0
13245,76,1,2021-02-18,4026,9927,253257,105348,2021-02-18,1613602800.0
13246,76,1,2021-02-19,3179,8075,256436,113423,2021-02-19,1613689200.0
13247,76,1,2021-02-20,836,3023,257272,116446,2021-02-20,1613775600.0
13248,76,1,2021-02-21,201,589,257473,117035,2021-02-21,1613862000.0
13249,76,1,2021-02-22,2229,7614,259702,124649,2021-02-22,1613948400.0
13250,76,1,2021-02-23,3606,10189,263308,134838,2021-02-23,1614034800.0
13251,76,1,2021-02-24,3628,10373,266936,145211,2021-02-24,1614121200.0
13252,76,1,2021-02-25,4786,9801,271722,155012,2021-02-25,1614207600.0
13253,76,1,2021-02-26,4558,8295,276280,163307,2021-02-26,1614294000.0
13254,76,1,2021-02-27,1106,3066,277386,166373,2021-02-27,1614380400.0
13255,76,1,2021-02-28,122,449,277508,166822,2021-02-28,1614466800.0
13256,76,1,2021-03-01,2602,6074,280110,172896,2021-03-01,1614553200.0
13257,76,1,2021-03-02,3775,7476,283885,180372,2021-03-02,1614639600.0
13258,76,1,2021-03-03,4360,7363,288245,187735,2021-03-03,1614726000.0
13259,76,1,2021-03-04,5311,7693,293556,195428,2021-03-04,1614812400.0
13260,76,1,2021-03-05,5333,6897,298889,202325,2021-03-05,1614898800.0
13261,76,1,2021-03-06,2054,2002,300943,204327,2021-03-06,1614985200.0
13262,76,1,2021-03-07,479,351,301422,204678,2021-03-07,1615071600.0
13263,76,1,2021-03-08,4581,5291,306003,209969,2021-03-08,1615158000.0
13264,76,1,2021-03-09,7413,6000,313416,215969,2021-03-09,1615244400.0
13265,76,1,2021-03-10,7494,5871,320910,221840,2021-03-10,1615330800.0
13266,76,1,2021-03-11,8531,5567,329441,227407,2021-03-11,1615417200.0
13267,76,1,2021-03-12,8629,4420,338070,231827,2021-03-12,1615503600.0
13268,76,1,2021-03-13,3896,1728,341966,233555,2021-03-13,1615590000.0
13269,76,1,2021-03-14,1289,283,343255,233838,2021-03-14,1615676400.0
13270,76,1,2021-03-15,8595,2687,351850,236525,2021-03-15,1615762800.0
13271,76,1,2021-03-16,10995,3731,362845,240256,2021-03-16,1615849200.0
13272,76,1,2021-03-17,12042,3177,374887,243433,2021-03-17,1615935600.0
13273,76,1,2021-03-18,12800,4092,387687,247525,2021-03-18,1616022000.0
13274,76,1,2021-03-19,12414,3179,400101,250704,2021-03-19,1616108400.0
13275,76,1,2021-03-20,5262,679,405363,251383,2021-03-20,1616194800.0
13276,76,1,2021-03-21,1134,187,406497,251570,2021-03-21,1616281200.0
13277,76,1,2021-03-22,10732,3052,417229,254622,2021-03-22,1616367600.0
13278,76,1,2021-03-23,13381,3500,430610,258122,2021-03-23,1616454000.0
13279,76,1,2021-03-24,13217,3577,443827,261699,2021-03-24,1616540400.0
13280,76,1,2021-03-25,15152,3610,458979,265309,2021-03-25,1616626800.0
13281,76,1,2021-03-26,13828,3431,472807,268740,2021-03-26,1616713200.0
13282,76,1,2021-03-27,9696,1062,482503,269802,2021-03-27,1616799600.0
13283,76,1,2021-03-28,3359,145,485862,269947,2021-03-28,1616886000.0
13284,76,1,2021-03-29,14183,4040,500045,273987,2021-03-29,1616972400.0
13285,76,1,2021-03-30,17818,4770,517863,278757,2021-03-30,1617058800.0
13286,76,1,2021-03-31,17726,4674,535589,283431,2021-03-31,1617145200.0
13287,76,1,2021-04-01,21538,4365,557127,287796,2021-04-01,1617231600.0
13288,76,1,2021-04-02,18150,4615,575277,292411,2021-04-02,1617318000.0
13289,76,1,2021-04-03,7459,2075,582736,294486,2021-04-03,1617404400.0
13290,76,1,2021-04-04,3314,578,586050,295064,2021-04-04,1617490800.0
13291,76,1,2021-04-05,3301,373,589351,295437,2021-04-05,1617577200.0
13292,76,1,2021-04-06,17852,8887,607203,304324,2021-04-06,1617663600.0
13293,76,1,2021-04-07,20002,8646,627205,312970,2021-04-07,1617750000.0
13294,76,1,2021-04-08,23583,8496,650788,321466,2021-04-08,1617836400.0
13295,76,1,2021-04-09,21289,7905,672077,329371,2021-04-09,1617922800.0
13296,76,1,2021-04-10,14754,3939,686831,333310,2021-04-10,1618009200.0
13297,76,1,2021-04-11,7447,1249,694278,334559,2021-04-11,1618095600.0
13298,76,1,2021-04-12,18747,9506,713025,344065,2021-04-12,1618185600.0
13299,76,1,2021-04-13,24987,11445,738012,355510,2021-04-13,1618272000.0
13300,76,1,2021-04-14,24223,11722,762235,367232,2021-04-14,1618358400.0
13301,76,1,2021-04-15,26295,12023,788530,379255,2021-04-15,1618444800.0
13302,76,1,2021-04-16,23041,11291,811571,390546,2021-04-16,1618531200.0
13303,76,1,2021-04-17,16618,4799,828189,395345,2021-04-17,1618617600.0
13304,76,1,2021-04-18,6987,906,835176,396251,2021-04-18,1618704000.0
13305,76,1,2021-04-19,18416,11685,853592,407936,2021-04-19,1618790400.0
13306,76,1,2021-04-20,22264,14890,875856,422826,2021-04-20,1618876800.0
13307,76,1,2021-04-21,21736,14633,897592,437459,2021-04-21,1618963200.0
13308,76,1,2021-04-22,23230,15291,920822,452750,2021-04-22,1619049600.0
13309,76,1,2021-04-23,20849,13564,941671,466314,2021-04-23,1619136000.0
13310,76,1,2021-04-24,14030,8310,955701,474624,2021-04-24,1619222400.0
13311,76,1,2021-04-25,6034,3087,961735,477711,2021-04-25,1619308800.0
13312,76,1,2021-04-26,17019,15569,978754,493280,2021-04-26,1619395200.0
13313,76,1,2021-04-27,21691,17799,1000445,511079,2021-04-27,1619481600.0
13314,76,1,2021-04-28,21571,16743,1022016,527822,2021-04-28,1619568000.0
13315,76,1,2021-04-29,23360,16262,1045376,544084,2021-04-29,1619654400.0
13316,76,1,2021-04-30,23740,14706,1069116,558790,2021-04-30,1619740800.0
13317,76,1,2021-05-01,15482,4635,1084598,563425,2021-05-01,1619827200.0
13318,76,1,2021-05-02,8725,3358,1093323,566783,2021-05-02,1619913600.0
13319,76,1,2021-05-03,23397,13149,1116720,579932,2021-05-03,1620000000.0
13320,76,1,2021-05-04,25867,21111,1142587,601043,2021-05-04,1620086400.0
13321,76,1,2021-05-05,24141,21366,1166728,622409,2021-05-05,1620172800.0
13322,76,1,2021-05-06,24778,22680,1191506,645089,2021-05-06,1620259200.0
13323,76,1,2021-05-07,22435,21817,1213941,666906,2021-05-07,1620345600.0
13324,76,1,2021-05-08,13325,7279,1227266,674185,2021-05-08,1620432000.0
13325,76,1,2021-05-09,5952,7169,1233218,681354,2021-05-09,1620518400.0
13326,76,1,2021-05-10,17639,23103,1250857,704457,2021-05-10,1620604800.0
13327,76,1,2021-05-11,21359,24724,1272216,729181,2021-05-11,1620691200.0
13328,76,1,2021-05-12,24271,22302,1296487,751483,2021-05-12,1620777600.0
13329,76,1,2021-05-13,19332,8027,1315819,759510,2021-05-13,1620864000.0
13330,76,1,2021-05-14,26478,16052,1342297,775562,2021-05-14,1620950400.0
13331,76,1,2021-05-15,16684,8445,1358981,784007,2021-05-15,1621036800.0
13332,76,1,2021-05-16,9152,2757,1368133,786764,2021-05-16,1621123200.0
13333,76,1,2021-05-17,20916,13742,1389049,800506,2021-05-17,1621206000.0
13334,76,1,2021-05-18,27210,12180,1416259,812686,2021-05-18,1621292400.0
13335,76,1,2021-05-19,29381,10672,1445640,823358,2021-05-19,1621378800.0
13336,76,1,2021-05-20,31626,9151,1477266,832509,2021-05-20,1621465200.0
13337,76,1,2021-05-21,29248,9633,1506514,842142,2021-05-21,1621551600.0
13338,76,1,2021-05-22,16933,4360,1523447,846502,2021-05-22,1621638000.0
13339,76,1,2021-05-23,8986,740,1532433,847242,2021-05-23,1621724400.0
13340,76,1,2021-05-24,14316,2336,1546749,849578,2021-05-24,1621810800.0
13341,76,1,2021-05-25,28226,12491,1574975,862069,2021-05-25,1621897200.0
13342,76,1,2021-05-26,30758,10338,1605733,872407,2021-05-26,1621983600.0
13343,76,1,2021-05-27,32399,10950,1638132,883357,2021-05-27,1622070000.0
13344,76,1,2021-05-28,28387,12284,1666519,895641,2021-05-28,1622156400.0
13345,76,1,2021-05-29,18113,9129,1684632,904770,2021-05-29,1622242800.0
13346,76,1,2021-05-30,6093,4715,1690725,909485,2021-05-30,1622329200.0
13347,76,1,2021-05-31,23152,14792,1713877,924277,2021-05-31,1622415600.0
13348,76,1,2021-06-01,25695,17352,1739572,941629,2021-06-01,1622502000.0
13349,76,1,2021-06-02,25633,15903,1765205,957532,2021-06-02,1622588400.0
13350,76,1,2021-06-03,26714,16464,1791919,973996,2021-06-03,1622674800.0
13351,76,1,2021-06-04,25635,17283,1817554,991279,2021-06-04,1622761200.0
13352,76,1,2021-06-05,22818,12063,1840372,1003342,2021-06-05,1622847600.0
13353,76,1,2021-06-06,13838,4302,1854210,1007644,2021-06-06,1622934000.0
13354,76,1,2021-06-07,21978,19757,1876188,1027401,2021-06-07,1623020400.0
13355,76,1,2021-06-08,26742,21491,1902930,1048892,2021-06-08,1623106800.0
13356,76,1,2021-06-09,27496,20503,1930426,1069395,2021-06-09,1623193200.0
13357,76,1,2021-06-10,25855,17512,1956281,1086907,2021-06-10,1623279600.0
13358,76,1,2021-06-11,26406,21368,1982687,1108275,2021-06-11,1623366000.0
13359,76,1,2021-06-12,20960,15775,2003647,1124050,2021-06-12,1623452400.0
13360,76,1,2021-06-13,11781,5394,2015428,1129444,2021-06-13,1623538800.0
13361,76,1,2021-06-14,18378,25764,2033806,1155208,2021-06-14,1623625200.0
13362,76,1,2021-06-15,23376,25597,2057182,1180805,2021-06-15,1623711600.0
13363,76,1,2021-06-16,22973,23878,2080155,1204683,2021-06-16,1623798000.0
13364,76,1,2021-06-17,21675,17609,2101830,1222292,2021-06-17,1623884400.0
13365,76,1,2021-06-18,21342,21876,2123172,1244168,2021-06-18,1623970800.0
13366,76,1,2021-06-19,18834,13939,2142006,1258107,2021-06-19,1624057200.0
13367,76,1,2021-06-20,8749,6659,2150755,1264766,2021-06-20,1624143600.0
13368,76,1,2021-06-21,13016,22804,2163771,1287570,2021-06-21,1624230000.0
13369,76,1,2021-06-22,14836,24059,2178607,1311629,2021-06-22,1624316400.0
13370,76,1,2021-06-23,15772,24220,2194379,1335849,2021-06-23,1624402800.0
13371,76,1,2021-06-24,13554,18608,2207933,1354457,2021-06-24,1624489200.0
13372,76,1,2021-06-25,13922,27063,2221855,1381520,2021-06-25,1624575600.0
13373,76,1,2021-06-26,10824,18163,2232679,1399683,2021-06-26,1624662000.0
13374,76,1,2021-06-27,5569,9009,2238248,1408692,2021-06-27,1624748400.0
13375,76,1,2021-06-28,10898,25676,2249146,1434368,2021-06-28,1624834800.0
13376,76,1,2021-06-29,12197,29053,2261343,1463421,2021-06-29,1624921200.0
13377,76,1,2021-06-30,14660,30438,2276003,1493859,2021-06-30,1625007600.0
13378,76,1,2021-07-01,13411,24200,2289414,1518059,2021-07-01,1625094000.0
13379,76,1,2021-07-02,14672,27496,2304086,1545555,2021-07-02,1625180400.0
13380,76,1,2021-07-03,10744,19943,2314830,1565498,2021-07-03,1625266800.0
13381,76,1,2021-07-04,5308,9347,2320138,1574845,2021-07-04,1625353200.0
13382,76,1,2021-07-05,12392,26674,2332530,1601519,2021-07-05,1625439600.0
13383,76,1,2021-07-06,14563,31954,2347093,1633473,2021-07-06,1625526000.0
13384,76,1,2021-07-07,15122,29806,2362215,1663279,2021-07-07,1625612400.0
13385,76,1,2021-07-08,13112,24969,2375327,1688248,2021-07-08,1625698800.0
13386,76,2,2020-12-27,0,0,0,0,2020-12-27,1609023600.0
13387,76,2,2020-12-28,0,0,0,0,2020-12-28,1609110000.0
13388,76,2,2020-12-29,0,0,0,0,2020-12-29,1609196400.0
13389,76,2,2020-12-30,0,0,0,0,2020-12-30,1609282800.0
13390,76,2,2020-12-31,0,0,0,0,2020-12-31,1609369200.0
13391,76,2,2021-01-01,0,0,0,0,2021-01-01,1609455600.0
13392,76,2,2021-01-02,0,0,0,0,2021-01-02,1609542000.0
13393,76,2,2021-01-03,0,0,0,0,2021-01-03,1609628400.0
13394,76,2,2021-01-04,0,0,0,0,2021-01-04,1609714800.0
13395,76,2,2021-01-05,0,0,0,0,2021-01-05,1609801200.0
13396,76,2,2021-01-06,0,0,0,0,2021-01-06,1609887600.0
13397,76,2,2021-01-07,0,0,0,0,2021-01-07,1609974000.0
13398,76,2,2021-01-08,0,0,0,0,2021-01-08,1610060400.0
13399,76,2,2021-01-09,0,0,0,0,2021-01-09,1610146800.0
13400,76,2,2021-01-10,0,0,0,0,2021-01-10,1610233200.0
13401,76,2,2021-01-11,0,0,0,0,2021-01-11,1610319600.0
13402,76,2,2021-01-12,0,0,0,0,2021-01-12,1610406000.0
13403,76,2,2021-01-13,0,0,0,0,2021-01-13,1610492400.0
13404,76,2,2021-01-14,1,0,1,0,2021-01-14,1610578800.0
13405,76,2,2021-01-15,2,0,3,0,2021-01-15,1610665200.0
13406,76,2,2021-01-16,1,0,4,0,2021-01-16,1610751600.0
13407,76,2,2021-01-17,0,0,4,0,2021-01-17,1610838000.0
13408,76,2,2021-01-18,2,0,6,0,2021-01-18,1610924400.0
13409,76,2,2021-01-19,4,0,10,0,2021-01-19,1611010800.0
13410,76,2,2021-01-20,2,0,12,0,2021-01-20,1611097200.0
13411,76,2,2021-01-21,3,0,15,0,2021-01-21,1611183600.0
13412,76,2,2021-01-22,4,0,19,0,2021-01-22,1611270000.0
13413,76,2,2021-01-23,1,0,20,0,2021-01-23,1611356400.0
13414,76,2,2021-01-24,0,0,20,0,2021-01-24,1611442800.0
13415,76,2,2021-01-25,2,0,22,0,2021-01-25,1611529200.0
13416,76,2,2021-01-26,0,0,22,0,2021-01-26,1611615600.0
13417,76,2,2021-01-27,0,0,22,0,2021-01-27,1611702000.0
13418,76,2,2021-01-28,1,0,23,0,2021-01-28,1611788400.0
13419,76,2,2021-01-29,0,0,23,0,2021-01-29,1611874800.0
13420,76,2,2021-01-30,1,0,24,0,2021-01-30,1611961200.0
13421,76,2,2021-01-31,0,0,24,0,2021-01-31,1612047600.0
13422,76,2,2021-02-01,0,0,24,0,2021-02-01,1612134000.0
13423,76,2,2021-02-02,0,0,24,0,2021-02-02,1612220400.0
13424,76,2,2021-02-03,3,0,27,0,2021-02-03,1612306800.0
13425,76,2,2021-02-04,0,0,27,0,2021-02-04,1612393200.0
13426,76,2,2021-02-05,0,1,27,1,2021-02-05,1612479600.0
13427,76,2,2021-02-06,0,0,27,1,2021-02-06,1612566000.0
13428,76,2,2021-02-07,0,0,27,1,2021-02-07,1612652400.0
13429,76,2,2021-02-08,78,3,105,4,2021-02-08,1612738800.0
13430,76,2,2021-02-09,130,1,235,5,2021-02-09,1612825200.0
13431,76,2,2021-02-10,303,3,538,8,2021-02-10,1612911600.0
13432,76,2,2021-02-11,621,1,1159,9,2021-02-11,1612998000.0
13433,76,2,2021-02-12,698,1,1857,10,2021-02-12,1613084400.0
13434,76,2,2021-02-13,362,0,2219,10,2021-02-13,1613170800.0
13435,76,2,2021-02-14,0,0,2219,10,2021-02-14,1613257200.0
13436,76,2,2021-02-15,437,1,2656,11,2021-02-15,1613343600.0
13437,76,2,2021-02-16,584,2,3240,13,2021-02-16,1613430000.0
13438,76,2,2021-02-17,573,2,3813,15,2021-02-17,1613516400.0
13439,76,2,2021-02-18,778,2,4591,17,2021-02-18,1613602800.0
13440,76,2,2021-02-19,648,3,5239,20,2021-02-19,1613689200.0
13441,76,2,2021-02-20,385,1,5624,21,2021-02-20,1613775600.0
13442,76,2,2021-02-21,0,0,5624,21,2021-02-21,1613862000.0
13443,76,2,2021-02-22,308,1,5932,22,2021-02-22,1613948400.0
13444,76,2,2021-02-23,469,1,6401,23,2021-02-23,1614034800.0
13445,76,2,2021-02-24,308,2,6709,25,2021-02-24,1614121200.0
13446,76,2,2021-02-25,590,2,7299,27,2021-02-25,1614207600.0
13447,76,2,2021-02-26,248,1,7547,28,2021-02-26,1614294000.0
13448,76,2,2021-02-27,135,2,7682,30,2021-02-27,1614380400.0
13449,76,2,2021-02-28,1,0,7683,30,2021-02-28,1614466800.0
13450,76,2,2021-03-01,457,2,8140,32,2021-03-01,1614553200.0
13451,76,2,2021-03-02,549,0,8689,32,2021-03-02,1614639600.0
13452,76,2,2021-03-03,526,0,9215,32,2021-03-03,1614726000.0
13453,76,2,2021-03-04,913,5,10128,37,2021-03-04,1614812400.0
13454,76,2,2021-03-05,541,4,10669,41,2021-03-05,1614898800.0
13455,76,2,2021-03-06,648,3,11317,44,2021-03-06,1614985200.0
13456,76,2,2021-03-07,1,0,11318,44,2021-03-07,1615071600.0
13457,76,2,2021-03-08,486,99,11804,143,2021-03-08,1615158000.0
13458,76,2,2021-03-09,457,254,12261,397,2021-03-09,1615244400.0
13459,76,2,2021-03-10,716,410,12977,807,2021-03-10,1615330800.0
13460,76,2,2021-03-11,1196,554,14173,1361,2021-03-11,1615417200.0
13461,76,2,2021-03-12,802,581,14975,1942,2021-03-12,1615503600.0
13462,76,2,2021-03-13,772,311,15747,2253,2021-03-13,1615590000.0
13463,76,2,2021-03-14,2,48,15749,2301,2021-03-14,1615676400.0
13464,76,2,2021-03-15,529,464,16278,2765,2021-03-15,1615762800.0
13465,76,2,2021-03-16,695,622,16973,3387,2021-03-16,1615849200.0
13466,76,2,2021-03-17,735,606,17708,3993,2021-03-17,1615935600.0
13467,76,2,2021-03-18,789,674,18497,4667,2021-03-18,1616022000.0
13468,76,2,2021-03-19,938,493,19435,5160,2021-03-19,1616108400.0
13469,76,2,2021-03-20,1464,343,20899,5503,2021-03-20,1616194800.0
13470,76,2,2021-03-21,1736,1,22635,5504,2021-03-21,1616281200.0
13471,76,2,2021-03-22,793,305,23428,5809,2021-03-22,1616367600.0
13472,76,2,2021-03-23,1165,516,24593,6325,2021-03-23,1616454000.0
13473,76,2,2021-03-24,1745,295,26338,6620,2021-03-24,1616540400.0
13474,76,2,2021-03-25,1736,534,28074,7154,2021-03-25,1616626800.0
13475,76,2,2021-03-26,2035,239,30109,7393,2021-03-26,1616713200.0
13476,76,2,2021-03-27,1816,129,31925,7522,2021-03-27,1616799600.0
13477,76,2,2021-03-28,1092,0,33017,7522,2021-03-28,1616886000.0
13478,76,2,2021-03-29,2210,536,35227,8058,2021-03-29,1616972400.0
13479,76,2,2021-03-30,1949,469,37176,8527,2021-03-30,1617058800.0
13480,76,2,2021-03-31,2551,484,39727,9011,2021-03-31,1617145200.0
13481,76,2,2021-04-01,4298,864,44025,9875,2021-04-01,1617231600.0
13482,76,2,2021-04-02,2459,602,46484,10477,2021-04-02,1617318000.0
13483,76,2,2021-04-03,2091,586,48575,11063,2021-04-03,1617404400.0
13484,76,2,2021-04-04,959,3,49534,11066,2021-04-04,1617490800.0
13485,76,2,2021-04-05,894,239,50428,11305,2021-04-05,1617577200.0
13486,76,2,2021-04-06,1566,443,51994,11748,2021-04-06,1617663600.0
13487,76,2,2021-04-07,2304,663,54298,12411,2021-04-07,1617750000.0
13488,76,2,2021-04-08,3378,1051,57676,13462,2021-04-08,1617836400.0
13489,76,2,2021-04-09,3235,891,60911,14353,2021-04-09,1617922800.0
13490,76,2,2021-04-10,3044,744,63955,15097,2021-04-10,1618009200.0
13491,76,2,2021-04-11,758,3,64713,15100,2021-04-11,1618095600.0
13492,76,2,2021-04-12,1770,450,66483,15550,2021-04-12,1618185600.0
13493,76,2,2021-04-13,1871,617,68354,16167,2021-04-13,1618272000.0
13494,76,2,2021-04-14,1837,639,70191,16806,2021-04-14,1618358400.0
13495,76,2,2021-04-15,2284,772,72475,17578,2021-04-15,1618444800.0
13496,76,2,2021-04-16,1626,937,74101,18515,2021-04-16,1618531200.0
13497,76,2,2021-04-17,1397,1375,75498,19890,2021-04-17,1618617600.0
13498,76,2,2021-04-18,136,1583,75634,21473,2021-04-18,1618704000.0
13499,76,2,2021-04-19,1236,699,76870,22172,2021-04-19,1618790400.0
13500,76,2,2021-04-20,1376,1014,78246,23186,2021-04-20,1618876800.0
13501,76,2,2021-04-21,1886,1525,80132,24711,2021-04-21,1618963200.0
13502,76,2,2021-04-22,2587,1725,82719,26436,2021-04-22,1619049600.0
13503,76,2,2021-04-23,2299,1824,85018,28260,2021-04-23,1619136000.0
13504,76,2,2021-04-24,2552,1493,87570,29753,2021-04-24,1619222400.0
13505,76,2,2021-04-25,497,917,88067,30670,2021-04-25,1619308800.0
13506,76,2,2021-04-26,1273,1957,89340,32627,2021-04-26,1619395200.0
13507,76,2,2021-04-27,1242,1874,90582,34501,2021-04-27,1619481600.0
13508,76,2,2021-04-28,1096,2355,91678,36856,2021-04-28,1619568000.0
13509,76,2,2021-04-29,1571,4093,93249,40949,2021-04-29,1619654400.0
13510,76,2,2021-04-30,1756,1988,95005,42937,2021-04-30,1619740800.0
13511,76,2,2021-05-01,1209,1467,96214,44404,2021-05-01,1619827200.0
13512,76,2,2021-05-02,572,1019,96786,45423,2021-05-02,1619913600.0
13513,76,2,2021-05-03,1544,1695,98330,47118,2021-05-03,1620000000.0
13514,76,2,2021-05-04,1358,1716,99688,48834,2021-05-04,1620086400.0
13515,76,2,2021-05-05,1955,2182,101643,51016,2021-05-05,1620172800.0
13516,76,2,2021-05-06,2783,3729,104426,54745,2021-05-06,1620259200.0
13517,76,2,2021-05-07,4333,3291,108759,58036,2021-05-07,1620345600.0
13518,76,2,2021-05-08,3628,1705,112387,59741,2021-05-08,1620432000.0
13519,76,2,2021-05-09,3545,799,115932,60540,2021-05-09,1620518400.0
13520,76,2,2021-05-10,4740,1948,120672,62488,2021-05-10,1620604800.0
13521,76,2,2021-05-11,6672,1982,127344,64470,2021-05-11,1620691200.0
13522,76,2,2021-05-12,6724,2122,134068,66592,2021-05-12,1620777600.0
13523,76,2,2021-05-13,6423,386,140491,66978,2021-05-13,1620864000.0
13524,76,2,2021-05-14,6372,1080,146863,68058,2021-05-14,1620950400.0
13525,76,2,2021-05-15,7373,1163,154236,69221,2021-05-15,1621036800.0
13526,76,2,2021-05-16,6208,202,160444,69423,2021-05-16,1621123200.0
13527,76,2,2021-05-17,5825,1312,166269,70735,2021-05-17,1621206000.0
13528,76,2,2021-05-18,6213,1458,172482,72193,2021-05-18,1621292400.0
13529,76,2,2021-05-19,6293,1107,178775,73300,2021-05-19,1621378800.0
13530,76,2,2021-05-20,7467,1215,186242,74515,2021-05-20,1621465200.0
13531,76,2,2021-05-21,6280,831,192522,75346,2021-05-21,1621551600.0
13532,76,2,2021-05-22,9451,786,201973,76132,2021-05-22,1621638000.0
13533,76,2,2021-05-23,4262,115,206235,76247,2021-05-23,1621724400.0
13534,76,2,2021-05-24,985,17,207220,76264,2021-05-24,1621810800.0
13535,76,2,2021-05-25,2293,959,209513,77223,2021-05-25,1621897200.0
13536,76,2,2021-05-26,1732,742,211245,77965,2021-05-26,1621983600.0
13537,76,2,2021-05-27,2353,1685,213598,79650,2021-05-27,1622070000.0
13538,76,2,2021-05-28,1161,1643,214759,81293,2021-05-28,1622156400.0
13539,76,2,2021-05-29,765,881,215524,82174,2021-05-29,1622242800.0
13540,76,2,2021-05-30,157,149,215681,82323,2021-05-30,1622329200.0
13541,76,2,2021-05-31,1110,1370,216791,83693,2021-05-31,1622415600.0
13542,76,2,2021-06-01,2862,1659,219653,85352,2021-06-01,1622502000.0
13543,76,2,2021-06-02,3444,2362,223097,87714,2021-06-02,1622588400.0
13544,76,2,2021-06-03,4947,2764,228044,90478,2021-06-03,1622674800.0
13545,76,2,2021-06-04,6864,2395,234908,92873,2021-06-04,1622761200.0
13546,76,2,2021-06-05,2427,1608,237335,94481,2021-06-05,1622847600.0
13547,76,2,2021-06-06,175,596,237510,95077,2021-06-06,1622934000.0
13548,76,2,2021-06-07,2732,2166,240242,97243,2021-06-07,1623020400.0
13549,76,2,2021-06-08,3980,1527,244222,98770,2021-06-08,1623106800.0
13550,76,2,2021-06-09,3380,1144,247602,99914,2021-06-09,1623193200.0
13551,76,2,2021-06-10,4225,1610,251827,101524,2021-06-10,1623279600.0
13552,76,2,2021-06-11,5097,2072,256924,103596,2021-06-11,1623366000.0
13553,76,2,2021-06-12,1676,1432,258600,105028,2021-06-12,1623452400.0
13554,76,2,2021-06-13,152,600,258752,105628,2021-06-13,1623538800.0
13555,76,2,2021-06-14,2508,1317,261260,106945,2021-06-14,1623625200.0
13556,76,2,2021-06-15,4174,1871,265434,108816,2021-06-15,1623711600.0
13557,76,2,2021-06-16,3002,2535,268436,111351,2021-06-16,1623798000.0
13558,76,2,2021-06-17,3716,2554,272152,113905,2021-06-17,1623884400.0
13559,76,2,2021-06-18,4581,4343,276733,118248,2021-06-18,1623970800.0
13560,76,2,2021-06-19,1579,4627,278312,122875,2021-06-19,1624057200.0
13561,76,2,2021-06-20,102,2633,278414,125508,2021-06-20,1624143600.0
13562,76,2,2021-06-21,1484,6504,279898,132012,2021-06-21,1624230000.0
13563,76,2,2021-06-22,2531,6435,282429,138447,2021-06-22,1624316400.0
13564,76,2,2021-06-23,2346,5488,284775,143935,2021-06-23,1624402800.0
13565,76,2,2021-06-24,2788,6013,287563,149948,2021-06-24,1624489200.0
13566,76,2,2021-06-25,3194,6691,290757,156639,2021-06-25,1624575600.0
13567,76,2,2021-06-26,1060,6897,291817,163536,2021-06-26,1624662000.0
13568,76,2,2021-06-27,92,4707,291909,168243,2021-06-27,1624748400.0
13569,76,2,2021-06-28,1176,7515,293085,175758,2021-06-28,1624834800.0
13570,76,2,2021-06-29,1872,6525,294957,182283,2021-06-29,1624921200.0
13571,76,2,2021-06-30,1592,5850,296549,188133,2021-06-30,1625007600.0
13572,76,2,2021-07-01,1960,7330,298509,195463,2021-07-01,1625094000.0
13573,76,2,2021-07-02,2184,6135,300693,201598,2021-07-02,1625180400.0
13574,76,2,2021-07-03,766,9271,301459,210869,2021-07-03,1625266800.0
13575,76,2,2021-07-04,130,2328,301589,213197,2021-07-04,1625353200.0
13576,76,2,2021-07-05,805,2266,302394,215463,2021-07-05,1625439600.0
13577,76,2,2021-07-06,1388,4107,303782,219570,2021-07-06,1625526000.0
13578,76,2,2021-07-07,1338,4361,305120,223931,2021-07-07,1625612400.0
13579,76,2,2021-07-08,1753,3534,306873,227465,2021-07-08,1625698800.0
13580,76,3,2020-12-27,0,0,0,0,2020-12-27,1609023600.0
13581,76,3,2020-12-28,0,0,0,0,2020-12-28,1609110000.0
13582,76,3,2020-12-29,0,0,0,0,2020-12-29,1609196400.0
13583,76,3,2020-12-30,0,0,0,0,2020-12-30,1609282800.0
13584,76,3,2020-12-31,0,0,0,0,2020-12-31,1609369200.0
13585,76,3,2021-01-01,0,0,0,0,2021-01-01,1609455600.0
13586,76,3,2021-01-02,0,0,0,0,2021-01-02,1609542000.0
13587,76,3,2021-01-03,0,0,0,0,2021-01-03,1609628400.0
13588,76,3,2021-01-04,0,0,0,0,2021-01-04,1609714800.0
13589,76,3,2021-01-05,0,0,0,0,2021-01-05,1609801200.0
13590,76,3,2021-01-06,0,0,0,0,2021-01-06,1609887600.0
13591,76,3,2021-01-07,0,0,0,0,2021-01-07,1609974000.0
13592,76,3,2021-01-08,0,0,0,0,2021-01-08,1610060400.0
13593,76,3,2021-01-09,0,0,0,0,2021-01-09,1610146800.0
13594,76,3,2021-01-10,0,0,0,0,2021-01-10,1610233200.0
13595,76,3,2021-01-11,0,0,0,0,2021-01-11,1610319600.0
13596,76,3,2021-01-12,0,0,0,0,2021-01-12,1610406000.0
13597,76,3,2021-01-13,0,0,0,0,2021-01-13,1610492400.0
13598,76,3,2021-01-14,0,0,0,0,2021-01-14,1610578800.0
13599,76,3,2021-01-15,0,0,0,0,2021-01-15,1610665200.0
13600,76,3,2021-01-16,0,0,0,0,2021-01-16,1610751600.0
13601,76,3,2021-01-17,0,0,0,0,2021-01-17,1610838000.0
13602,76,3,2021-01-18,0,0,0,0,2021-01-18,1610924400.0
13603,76,3,2021-01-19,0,0,0,0,2021-01-19,1611010800.0
13604,76,3,2021-01-20,0,0,0,0,2021-01-20,1611097200.0
13605,76,3,2021-01-21,0,0,0,0,2021-01-21,1611183600.0
13606,76,3,2021-01-22,0,0,0,0,2021-01-22,1611270000.0
13607,76,3,2021-01-23,0,0,0,0,2021-01-23,1611356400.0
13608,76,3,2021-01-24,0,0,0,0,2021-01-24,1611442800.0
13609,76,3,2021-01-25,0,0,0,0,2021-01-25,1611529200.0
13610,76,3,2021-01-26,0,0,0,0,2021-01-26,1611615600.0
13611,76,3,2021-01-27,0,0,0,0,2021-01-27,1611702000.0
13612,76,3,2021-01-28,0,0,0,0,2021-01-28,1611788400.0
13613,76,3,2021-01-29,0,0,0,0,2021-01-29,1611874800.0
13614,76,3,2021-01-30,0,0,0,0,2021-01-30,1611961200.0
13615,76,3,2021-01-31,0,0,0,0,2021-01-31,1612047600.0
13616,76,3,2021-02-01,0,0,0,0,2021-02-01,1612134000.0
13617,76,3,2021-02-02,0,0,0,0,2021-02-02,1612220400.0
13618,76,3,2021-02-03,0,0,0,0,2021-02-03,1612306800.0
13619,76,3,2021-02-04,0,0,0,0,2021-02-04,1612393200.0
13620,76,3,2021-02-05,0,0,0,0,2021-02-05,1612479600.0
13621,76,3,2021-02-06,21,0,21,0,2021-02-06,1612566000.0
13622,76,3,2021-02-07,66,0,87,0,2021-02-07,1612652400.0
13623,76,3,2021-02-08,185,0,272,0,2021-02-08,1612738800.0
13624,76,3,2021-02-09,410,0,682,0,2021-02-09,1612825200.0
13625,76,3,2021-02-10,525,0,1207,0,2021-02-10,1612911600.0
13626,76,3,2021-02-11,681,0,1888,0,2021-02-11,1612998000.0
13627,76,3,2021-02-12,925,0,2813,0,2021-02-12,1613084400.0
13628,76,3,2021-02-13,68,0,2881,0,2021-02-13,1613170800.0
13629,76,3,2021-02-14,23,0,2904,0,2021-02-14,1613257200.0
13630,76,3,2021-02-15,656,0,3560,0,2021-02-15,1613343600.0
13631,76,3,2021-02-16,619,0,4179,0,2021-02-16,1613430000.0
13632,76,3,2021-02-17,671,0,4850,0,2021-02-17,1613516400.0
13633,76,3,2021-02-18,1067,0,5917,0,2021-02-18,1613602800.0
13634,76,3,2021-02-19,1017,0,6934,0,2021-02-19,1613689200.0
13635,76,3,2021-02-20,309,0,7243,0,2021-02-20,1613775600.0
13636,76,3,2021-02-21,64,0,7307,0,2021-02-21,1613862000.0
13637,76,3,2021-02-22,743,0,8050,0,2021-02-22,1613948400.0
13638,76,3,2021-02-23,844,0,8894,0,2021-02-23,1614034800.0
13639,76,3,2021-02-24,712,0,9606,0,2021-02-24,1614121200.0
13640,76,3,2021-02-25,2944,0,12550,0,2021-02-25,1614207600.0
13641,76,3,2021-02-26,4834,0,17384,0,2021-02-26,1614294000.0
13642,76,3,2021-02-27,2493,1,19877,1,2021-02-27,1614380400.0
13643,76,3,2021-02-28,308,0,20185,1,2021-02-28,1614466800.0
13644,76,3,2021-03-01,2266,2,22451,3,2021-03-01,1614553200.0
13645,76,3,2021-03-02,3893,2,26344,5,2021-03-02,1614639600.0
13646,76,3,2021-03-03,4365,1,30709,6,2021-03-03,1614726000.0
13647,76,3,2021-03-04,8102,3,38811,9,2021-03-04,1614812400.0
13648,76,3,2021-03-05,11000,4,49811,13,2021-03-05,1614898800.0
13649,76,3,2021-03-06,13187,14,62998,27,2021-03-06,1614985200.0
13650,76,3,2021-03-07,10898,10,73896,37,2021-03-07,1615071600.0
13651,76,3,2021-03-08,4914,3,78810,40,2021-03-08,1615158000.0
13652,76,3,2021-03-09,8365,2,87175,42,2021-03-09,1615244400.0
13653,76,3,2021-03-10,8215,6,95390,48,2021-03-10,1615330800.0
13654,76,3,2021-03-11,12879,6,108269,54,2021-03-11,1615417200.0
13655,76,3,2021-03-12,17019,5,125288,59,2021-03-12,1615503600.0
13656,76,3,2021-03-13,10261,7,135549,66,2021-03-13,1615590000.0
13657,76,3,2021-03-14,1032,2,136581,68,2021-03-14,1615676400.0
13658,76,3,2021-03-15,4407,6,140988,74,2021-03-15,1615762800.0
13659,76,3,2021-03-16,73,0,141061,74,2021-03-16,1615849200.0
13660,76,3,2021-03-17,64,0,141125,74,2021-03-17,1615935600.0
13661,76,3,2021-03-18,114,0,141239,74,2021-03-18,1616022000.0
13662,76,3,2021-03-19,5303,2,146542,76,2021-03-19,1616108400.0
13663,76,3,2021-03-20,3939,1,150481,77,2021-03-20,1616194800.0
13664,76,3,2021-03-21,326,0,150807,77,2021-03-21,1616281200.0
13665,76,3,2021-03-22,3158,3,153965,80,2021-03-22,1616367600.0
13666,76,3,2021-03-23,7706,1,161671,81,2021-03-23,1616454000.0
13667,76,3,2021-03-24,8647,19,170318,100,2021-03-24,1616540400.0
13668,76,3,2021-03-25,15132,13,185450,113,2021-03-25,1616626800.0
13669,76,3,2021-03-26,14997,14,200447,127,2021-03-26,1616713200.0
13670,76,3,2021-03-27,4743,4,205190,131,2021-03-27,1616799600.0
13671,76,3,2021-03-28,414,0,205604,131,2021-03-28,1616886000.0
13672,76,3,2021-03-29,5912,7,211516,138,2021-03-29,1616972400.0
13673,76,3,2021-03-30,9953,16,221469,154,2021-03-30,1617058800.0
13674,76,3,2021-03-31,6623,15,228092,169,2021-03-31,1617145200.0
13675,76,3,2021-04-01,8640,10,236732,179,2021-04-01,1617231600.0
13676,76,3,2021-04-02,8741,27,245473,206,2021-04-02,1617318000.0
13677,76,3,2021-04-03,2606,1,248079,207,2021-04-03,1617404400.0
13678,76,3,2021-04-04,81,0,248160,207,2021-04-04,1617490800.0
13679,76,3,2021-04-05,96,0,248256,207,2021-04-05,1617577200.0
13680,76,3,2021-04-06,3446,5,251702,212,2021-04-06,1617663600.0
13681,76,3,2021-04-07,2978,6,254680,218,2021-04-07,1617750000.0
13682,76,3,2021-04-08,6164,11,260844,229,2021-04-08,1617836400.0
13683,76,3,2021-04-09,14409,70,275253,299,2021-04-09,1617922800.0
13684,76,3,2021-04-10,4909,21,280162,320,2021-04-10,1618009200.0
13685,76,3,2021-04-11,656,3,280818,323,2021-04-11,1618095600.0
13686,76,3,2021-04-12,5539,11,286357,334,2021-04-12,1618185600.0
13687,76,3,2021-04-13,8937,21,295294,355,2021-04-13,1618272000.0
13688,76,3,2021-04-14,6835,38,302129,393,2021-04-14,1618358400.0
13689,76,3,2021-04-15,8902,49,311031,442,2021-04-15,1618444800.0
13690,76,3,2021-04-16,9797,71,320828,513,2021-04-16,1618531200.0
13691,76,3,2021-04-17,3385,28,324213,541,2021-04-17,1618617600.0
13692,76,3,2021-04-18,590,0,324803,541,2021-04-18,1618704000.0
13693,76,3,2021-04-19,2403,18,327206,559,2021-04-19,1618790400.0
13694,76,3,2021-04-20,4343,38,331549,597,2021-04-20,1618876800.0
13695,76,3,2021-04-21,3413,44,334962,641,2021-04-21,1618963200.0
13696,76,3,2021-04-22,4537,45,339499,686,2021-04-22,1619049600.0
13697,76,3,2021-04-23,5431,65,344930,751,2021-04-23,1619136000.0
13698,76,3,2021-04-24,1879,65,346809,816,2021-04-24,1619222400.0
13699,76,3,2021-04-25,370,1,347179,817,2021-04-25,1619308800.0
13700,76,3,2021-04-26,1528,47,348707,864,2021-04-26,1619395200.0
13701,76,3,2021-04-27,3015,113,351722,977,2021-04-27,1619481600.0
13702,76,3,2021-04-28,2299,137,354021,1114,2021-04-28,1619568000.0
13703,76,3,2021-04-29,3266,303,357287,1417,2021-04-29,1619654400.0
13704,76,3,2021-04-30,3524,623,360811,2040,2021-04-30,1619740800.0
13705,76,3,2021-05-01,564,162,361375,2202,2021-05-01,1619827200.0
13706,76,3,2021-05-02,144,7,361519,2209,2021-05-02,1619913600.0
13707,76,3,2021-05-03,1054,404,362573,2613,2021-05-03,1620000000.0
13708,76,3,2021-05-04,1821,867,364394,3480,2021-05-04,1620086400.0
13709,76,3,2021-05-05,1443,1113,365837,4593,2021-05-05,1620172800.0
13710,76,3,2021-05-06,2438,2014,368275,6607,2021-05-06,1620259200.0
13711,76,3,2021-05-07,3123,2664,371398,9271,2021-05-07,1620345600.0
13712,76,3,2021-05-08,234,724,371632,9995,2021-05-08,1620432000.0
13713,76,3,2021-05-09,143,263,371775,10258,2021-05-09,1620518400.0
13714,76,3,2021-05-10,1118,1454,372893,11712,2021-05-10,1620604800.0
13715,76,3,2021-05-11,1979,3342,374872,15054,2021-05-11,1620691200.0
13716,76,3,2021-05-12,1344,2463,376216,17517,2021-05-12,1620777600.0
13717,76,3,2021-05-13,143,222,376359,17739,2021-05-13,1620864000.0
13718,76,3,2021-05-14,1070,2087,377429,19826,2021-05-14,1620950400.0
13719,76,3,2021-05-15,268,1322,377697,21148,2021-05-15,1621036800.0
13720,76,3,2021-05-16,72,139,377769,21287,2021-05-16,1621123200.0
13721,76,3,2021-05-17,609,2274,378378,23561,2021-05-17,1621206000.0
13722,76,3,2021-05-18,1033,3175,379411,26736,2021-05-18,1621292400.0
13723,76,3,2021-05-19,640,2629,380051,29365,2021-05-19,1621378800.0
13724,76,3,2021-05-20,1027,5284,381078,34649,2021-05-20,1621465200.0
13725,76,3,2021-05-21,1044,6295,382122,40944,2021-05-21,1621551600.0
13726,76,3,2021-05-22,236,2373,382358,43317,2021-05-22,1621638000.0
13727,76,3,2021-05-23,32,248,382390,43565,2021-05-23,1621724400.0
13728,76,3,2021-05-24,51,887,382441,44452,2021-05-24,1621810800.0
13729,76,3,2021-05-25,403,4775,382844,49227,2021-05-25,1621897200.0
13730,76,3,2021-05-26,483,5605,383327,54832,2021-05-26,1621983600.0
13731,76,3,2021-05-27,524,8512,383851,63344,2021-05-27,1622070000.0
13732,76,3,2021-05-28,686,10323,384537,73667,2021-05-28,1622156400.0
13733,76,3,2021-05-29,177,4945,384714,78612,2021-05-29,1622242800.0
13734,76,3,2021-05-30,27,1010,384741,79622,2021-05-30,1622329200.0
13735,76,3,2021-05-31,158,3975,384899,83597,2021-05-31,1622415600.0
13736,76,3,2021-06-01,342,6799,385241,90396,2021-06-01,1622502000.0
13737,76,3,2021-06-02,229,5974,385470,96370,2021-06-02,1622588400.0
13738,76,3,2021-06-03,329,9553,385799,105923,2021-06-03,1622674800.0
13739,76,3,2021-06-04,361,10338,386160,116261,2021-06-04,1622761200.0
13740,76,3,2021-06-05,108,3932,386268,120193,2021-06-05,1622847600.0
13741,76,3,2021-06-06,15,620,386283,120813,2021-06-06,1622934000.0
13742,76,3,2021-06-07,96,3163,386379,123976,2021-06-07,1623020400.0
13743,76,3,2021-06-08,188,4925,386567,128901,2021-06-08,1623106800.0
13744,76,3,2021-06-09,138,4095,386705,132996,2021-06-09,1623193200.0
13745,76,3,2021-06-10,149,6393,386854,139389,2021-06-10,1623279600.0
13746,76,3,2021-06-11,192,8562,387046,147951,2021-06-11,1623366000.0
13747,76,3,2021-06-12,58,2611,387104,150562,2021-06-12,1623452400.0
13748,76,3,2021-06-13,21,283,387125,150845,2021-06-13,1623538800.0
13749,76,3,2021-06-14,52,4219,387177,155064,2021-06-14,1623625200.0
13750,76,3,2021-06-15,104,8963,387281,164027,2021-06-15,1623711600.0
13751,76,3,2021-06-16,86,6987,387367,171014,2021-06-16,1623798000.0
13752,76,3,2021-06-17,144,10677,387511,181691,2021-06-17,1623884400.0
13753,76,3,2021-06-18,145,11377,387656,193068,2021-06-18,1623970800.0
13754,76,3,2021-06-19,38,2780,387694,195848,2021-06-19,1624057200.0
13755,76,3,2021-06-20,11,325,387705,196173,2021-06-20,1624143600.0
13756,76,3,2021-06-21,48,4025,387753,200198,2021-06-21,1624230000.0
13757,76,3,2021-06-22,75,7575,387828,207773,2021-06-22,1624316400.0
13758,76,3,2021-06-23,77,5618,387905,213391,2021-06-23,1624402800.0
13759,76,3,2021-06-24,125,7896,388030,221287,2021-06-24,1624489200.0
13760,76,3,2021-06-25,107,8051,388137,229338,2021-06-25,1624575600.0
13761,76,3,2021-06-26,23,2218,388160,231556,2021-06-26,1624662000.0
13762,76,3,2021-06-27,7,272,388167,231828,2021-06-27,1624748400.0
13763,76,3,2021-06-28,33,3088,388200,234916,2021-06-28,1624834800.0
13764,76,3,2021-06-29,78,5832,388278,240748,2021-06-29,1624921200.0
13765,76,3,2021-06-30,94,4490,388372,245238,2021-06-30,1625007600.0
13766,76,3,2021-07-01,83,5915,388455,251153,2021-07-01,1625094000.0
13767,76,3,2021-07-02,94,7515,388549,258668,2021-07-02,1625180400.0
13768,76,3,2021-07-03,33,1668,388582,260336,2021-07-03,1625266800.0
13769,76,3,2021-07-04,6,482,388588,260818,2021-07-04,1625353200.0
13770,76,3,2021-07-05,42,2944,388630,263762,2021-07-05,1625439600.0
13771,76,3,2021-07-06,69,4741,388699,268503,2021-07-06,1625526000.0
13772,76,3,2021-07-07,58,3788,388757,272291,2021-07-07,1625612400.0
13773,76,3,2021-07-08,94,5488,388851,277779,2021-07-08,1625698800.0
13774,76,4,2020-12-27,0,0,0,0,2020-12-27,1609023600.0
13775,76,4,2020-12-28,0,0,0,0,2020-12-28,1609110000.0
13776,76,4,2020-12-29,0,0,0,0,2020-12-29,1609196400.0
13777,76,4,2020-12-30,0,0,0,0,2020-12-30,1609282800.0
13778,76,4,2020-12-31,0,0,0,0,2020-12-31,1609369200.0
13779,76,4,2021-01-01,0,0,0,0,2021-01-01,1609455600.0
13780,76,4,2021-01-02,0,0,0,0,2021-01-02,1609542000.0
13781,76,4,2021-01-03,0,0,0,0,2021-01-03,1609628400.0
13782,76,4,2021-01-04,0,0,0,0,2021-01-04,1609714800.0
13783,76,4,2021-01-05,0,0,0,0,2021-01-05,1609801200.0
13784,76,4,2021-01-06,0,0,0,0,2021-01-06,1609887600.0
13785,76,4,2021-01-07,0,0,0,0,2021-01-07,1609974000.0
13786,76,4,2021-01-08,0,0,0,0,2021-01-08,1610060400.0
13787,76,4,2021-01-09,0,0,0,0,2021-01-09,1610146800.0
13788,76,4,2021-01-10,0,0,0,0,2021-01-10,1610233200.0
13789,76,4,2021-01-11,0,0,0,0,2021-01-11,1610319600.0
13790,76,4,2021-01-12,0,0,0,0,2021-01-12,1610406000.0
13791,76,4,2021-01-13,0,0,0,0,2021-01-13,1610492400.0
13792,76,4,2021-01-14,0,0,0,0,2021-01-14,1610578800.0
13793,76,4,2021-01-15,0,0,0,0,2021-01-15,1610665200.0
13794,76,4,2021-01-16,0,0,0,0,2021-01-16,1610751600.0
13795,76,4,2021-01-17,0,0,0,0,2021-01-17,1610838000.0
13796,76,4,2021-01-18,0,0,0,0,2021-01-18,1610924400.0
13797,76,4,2021-01-19,0,0,0,0,2021-01-19,1611010800.0
13798,76,4,2021-01-20,0,0,0,0,2021-01-20,1611097200.0
13799,76,4,2021-01-21,0,0,0,0,2021-01-21,1611183600.0
13800,76,4,2021-01-22,0,0,0,0,2021-01-22,1611270000.0
13801,76,4,2021-01-23,0,0,0,0,2021-01-23,1611356400.0
13802,76,4,2021-01-24,0,0,0,0,2021-01-24,1611442800.0
13803,76,4,2021-01-25,0,0,0,0,2021-01-25,1611529200.0
13804,76,4,2021-01-26,0,0,0,0,2021-01-26,1611615600.0
13805,76,4,2021-01-27,0,0,0,0,2021-01-27,1611702000.0
13806,76,4,2021-01-28,0,0,0,0,2021-01-28,1611788400.0
13807,76,4,2021-01-29,0,0,0,0,2021-01-29,1611874800.0
13808,76,4,2021-01-30,0,0,0,0,2021-01-30,1611961200.0
13809,76,4,2021-01-31,0,0,0,0,2021-01-31,1612047600.0
13810,76,4,2021-02-01,0,0,0,0,2021-02-01,1612134000.0
13811,76,4,2021-02-02,0,0,0,0,2021-02-02,1612220400.0
13812,76,4,2021-02-03,0,0,0,0,2021-02-03,1612306800.0
13813,76,4,2021-02-04,0,0,0,0,2021-02-04,1612393200.0
13814,76,4,2021-02-05,0,0,0,0,2021-02-05,1612479600.0
13815,76,4,2021-02-06,0,0,0,0,2021-02-06,1612566000.0
13816,76,4,2021-02-07,0,0,0,0,2021-02-07,1612652400.0
13817,76,4,2021-02-08,0,0,0,0,2021-02-08,1612738800.0
13818,76,4,2021-02-09,0,0,0,0,2021-02-09,1612825200.0
13819,76,4,2021-02-10,0,0,0,0,2021-02-10,1612911600.0
13820,76,4,2021-02-11,0,0,0,0,2021-02-11,1612998000.0
13821,76,4,2021-02-12,0,0,0,0,2021-02-12,1613084400.0
13822,76,4,2021-02-13,0,0,0,0,2021-02-13,1613170800.0
13823,76,4,2021-02-14,0,0,0,0,2021-02-14,1613257200.0
13824,76,4,2021-02-15,0,0,0,0,2021-02-15,1613343600.0
13825,76,4,2021-02-16,0,0,0,0,2021-02-16,1613430000.0
13826,76,4,2021-02-17,0,0,0,0,2021-02-17,1613516400.0
13827,76,4,2021-02-18,0,0,0,0,2021-02-18,1613602800.0
13828,76,4,2021-02-19,0,0,0,0,2021-02-19,1613689200.0
13829,76,4,2021-02-20,0,0,0,0,2021-02-20,1613775600.0
13830,76,4,2021-02-21,0,0,0,0,2021-02-21,1613862000.0
13831,76,4,2021-02-22,0,0,0,0,2021-02-22,1613948400.0
13832,76,4,2021-02-23,0,0,0,0,2021-02-23,1614034800.0
13833,76,4,2021-02-24,0,0,0,0,2021-02-24,1614121200.0
13834,76,4,2021-02-25,0,0,0,0,2021-02-25,1614207600.0
13835,76,4,2021-02-26,0,0,0,0,2021-02-26,1614294000.0
13836,76,4,2021-02-27,0,0,0,0,2021-02-27,1614380400.0
13837,76,4,2021-02-28,0,0,0,0,2021-02-28,1614466800.0
13838,76,4,2021-03-01,0,0,0,0,2021-03-01,1614553200.0
13839,76,4,2021-03-02,0,0,0,0,2021-03-02,1614639600.0
13840,76,4,2021-03-03,0,0,0,0,2021-03-03,1614726000.0
13841,76,4,2021-03-04,0,0,0,0,2021-03-04,1614812400.0
13842,76,4,2021-03-05,0,0,0,0,2021-03-05,1614898800.0
13843,76,4,2021-03-06,0,0,0,0,2021-03-06,1614985200.0
13844,76,4,2021-03-07,0,0,0,0,2021-03-07,1615071600.0
13845,76,4,2021-03-08,0,0,0,0,2021-03-08,1615158000.0
13846,76,4,2021-03-09,0,0,0,0,2021-03-09,1615244400.0
13847,76,4,2021-03-10,0,0,0,0,2021-03-10,1615330800.0
13848,76,4,2021-03-11,0,0,0,0,2021-03-11,1615417200.0
13849,76,4,2021-03-12,0,0,0,0,2021-03-12,1615503600.0
13850,76,4,2021-03-13,0,0,0,0,2021-03-13,1615590000.0
13851,76,4,2021-03-14,0,0,0,0,2021-03-14,1615676400.0
13852,76,4,2021-03-15,0,0,0,0,2021-03-15,1615762800.0
13853,76,4,2021-03-16,0,0,0,0,2021-03-16,1615849200.0
13854,76,4,2021-03-17,0,0,0,0,2021-03-17,1615935600.0
13855,76,4,2021-03-18,0,0,0,0,2021-03-18,1616022000.0
13856,76,4,2021-03-19,0,0,0,0,2021-03-19,1616108400.0
13857,76,4,2021-03-20,0,0,0,0,2021-03-20,1616194800.0
13858,76,4,2021-03-21,0,0,0,0,2021-03-21,1616281200.0
13859,76,4,2021-03-22,0,0,0,0,2021-03-22,1616367600.0
13860,76,4,2021-03-23,0,0,0,0,2021-03-23,1616454000.0
13861,76,4,2021-03-24,0,0,0,0,2021-03-24,1616540400.0
13862,76,4,2021-03-25,0,0,0,0,2021-03-25,1616626800.0
13863,76,4,2021-03-26,0,0,0,0,2021-03-26,1616713200.0
13864,76,4,2021-03-27,0,0,0,0,2021-03-27,1616799600.0
13865,76,4,2021-03-28,0,0,0,0,2021-03-28,1616886000.0
13866,76,4,2021-03-29,0,0,0,0,2021-03-29,1616972400.0
13867,76,4,2021-03-30,0,0,0,0,2021-03-30,1617058800.0
13868,76,4,2021-03-31,0,0,0,0,2021-03-31,1617145200.0
13869,76,4,2021-04-01,0,0,0,0,2021-04-01,1617231600.0
13870,76,4,2021-04-02,0,0,0,0,2021-04-02,1617318000.0
13871,76,4,2021-04-03,0,0,0,0,2021-04-03,1617404400.0
13872,76,4,2021-04-04,0,0,0,0,2021-04-04,1617490800.0
13873,76,4,2021-04-05,0,0,0,0,2021-04-05,1617577200.0
13874,76,4,2021-04-06,0,0,0,0,2021-04-06,1617663600.0
13875,76,4,2021-04-07,0,0,0,0,2021-04-07,1617750000.0
13876,76,4,2021-04-08,0,0,0,0,2021-04-08,1617836400.0
13877,76,4,2021-04-09,0,0,0,0,2021-04-09,1617922800.0
13878,76,4,2021-04-10,0,0,0,0,2021-04-10,1618009200.0
13879,76,4,2021-04-11,0,0,0,0,2021-04-11,1618095600.0
13880,76,4,2021-04-12,0,0,0,0,2021-04-12,1618185600.0
13881,76,4,2021-04-13,0,0,0,0,2021-04-13,1618272000.0
13882,76,4,2021-04-14,0,0,0,0,2021-04-14,1618358400.0
13883,76,4,2021-04-15,0,0,0,0,2021-04-15,1618444800.0
13884,76,4,2021-04-16,0,0,0,0,2021-04-16,1618531200.0
13885,76,4,2021-04-17,0,0,0,0,2021-04-17,1618617600.0
13886,76,4,2021-04-18,0,0,0,0,2021-04-18,1618704000.0
13887,76,4,2021-04-19,0,0,0,0,2021-04-19,1618790400.0
13888,76,4,2021-04-20,0,0,0,0,2021-04-20,1618876800.0
13889,76,4,2021-04-21,0,0,0,0,2021-04-21,1618963200.0
13890,76,4,2021-04-22,0,0,0,0,2021-04-22,1619049600.0
13891,76,4,2021-04-23,130,0,130,0,2021-04-23,1619136000.0
13892,76,4,2021-04-24,32,0,162,0,2021-04-24,1619222400.0
13893,76,4,2021-04-25,11,0,173,0,2021-04-25,1619308800.0
13894,76,4,2021-04-26,128,0,301,0,2021-04-26,1619395200.0
13895,76,4,2021-04-27,783,0,1084,0,2021-04-27,1619481600.0
13896,76,4,2021-04-28,933,0,2017,0,2021-04-28,1619568000.0
13897,76,4,2021-04-29,1540,0,3557,0,2021-04-29,1619654400.0
13898,76,4,2021-04-30,1758,0,5315,0,2021-04-30,1619740800.0
13899,76,4,2021-05-01,171,0,5486,0,2021-05-01,1619827200.0
13900,76,4,2021-05-02,51,0,5537,0,2021-05-02,1619913600.0
13901,76,4,2021-05-03,533,0,6070,0,2021-05-03,1620000000.0
13902,76,4,2021-05-04,964,1,7034,1,2021-05-04,1620086400.0
13903,76,4,2021-05-05,671,0,7705,1,2021-05-05,1620172800.0
13904,76,4,2021-05-06,1046,0,8751,1,2021-05-06,1620259200.0
13905,76,4,2021-05-07,1738,4,10489,5,2021-05-07,1620345600.0
13906,76,4,2021-05-08,173,0,10662,5,2021-05-08,1620432000.0
13907,76,4,2021-05-09,68,0,10730,5,2021-05-09,1620518400.0
13908,76,4,2021-05-10,587,2,11317,7,2021-05-10,1620604800.0
13909,76,4,2021-05-11,1646,1,12963,8,2021-05-11,1620691200.0
13910,76,4,2021-05-12,1002,3,13965,11,2021-05-12,1620777600.0
13911,76,4,2021-05-13,54,0,14019,11,2021-05-13,1620864000.0
13912,76,4,2021-05-14,618,0,14637,11,2021-05-14,1620950400.0
13913,76,4,2021-05-15,165,1,14802,12,2021-05-15,1621036800.0
13914,76,4,2021-05-16,25,0,14827,12,2021-05-16,1621123200.0
13915,76,4,2021-05-17,488,1,15315,13,2021-05-17,1621206000.0
13916,76,4,2021-05-18,974,2,16289,15,2021-05-18,1621292400.0
13917,76,4,2021-05-19,523,0,16812,15,2021-05-19,1621378800.0
13918,76,4,2021-05-20,883,1,17695,16,2021-05-20,1621465200.0
13919,76,4,2021-05-21,1213,4,18908,20,2021-05-21,1621551600.0
13920,76,4,2021-05-22,369,0,19277,20,2021-05-22,1621638000.0
13921,76,4,2021-05-23,34,0,19311,20,2021-05-23,1621724400.0
13922,76,4,2021-05-24,69,0,19380,20,2021-05-24,1621810800.0
13923,76,4,2021-05-25,779,0,20159,20,2021-05-25,1621897200.0
13924,76,4,2021-05-26,712,1,20871,21,2021-05-26,1621983600.0
13925,76,4,2021-05-27,1136,11,22007,32,2021-05-27,1622070000.0
13926,76,4,2021-05-28,2260,10,24267,42,2021-05-28,1622156400.0
13927,76,4,2021-05-29,772,9,25039,51,2021-05-29,1622242800.0
13928,76,4,2021-05-30,73,0,25112,51,2021-05-30,1622329200.0
13929,76,4,2021-05-31,1313,2,26425,53,2021-05-31,1622415600.0
13930,76,4,2021-06-01,2280,4,28705,57,2021-06-01,1622502000.0
13931,76,4,2021-06-02,1505,2,30210,59,2021-06-02,1622588400.0
13932,76,4,2021-06-03,2204,1,32414,60,2021-06-03,1622674800.0
13933,76,4,2021-06-04,2243,5,34657,65,2021-06-04,1622761200.0
13934,76,4,2021-06-05,668,4,35325,69,2021-06-05,1622847600.0
13935,76,4,2021-06-06,72,0,35397,69,2021-06-06,1622934000.0
13936,76,4,2021-06-07,939,2,36336,71,2021-06-07,1623020400.0
13937,76,4,2021-06-08,1513,4,37849,75,2021-06-08,1623106800.0
13938,76,4,2021-06-09,1275,2,39124,77,2021-06-09,1623193200.0
13939,76,4,2021-06-10,1745,1,40869,78,2021-06-10,1623279600.0
13940,76,4,2021-06-11,1848,10,42717,88,2021-06-11,1623366000.0
13941,76,4,2021-06-12,497,1,43214,89,2021-06-12,1623452400.0
13942,76,4,2021-06-13,83,0,43297,89,2021-06-13,1623538800.0
13943,76,4,2021-06-14,621,2,43918,91,2021-06-14,1623625200.0
13944,76,4,2021-06-15,1080,2,44998,93,2021-06-15,1623711600.0
13945,76,4,2021-06-16,944,1,45942,94,2021-06-16,1623798000.0
13946,76,4,2021-06-17,1246,1,47188,95,2021-06-17,1623884400.0
13947,76,4,2021-06-18,1330,4,48518,99,2021-06-18,1623970800.0
13948,76,4,2021-06-19,345,2,48863,101,2021-06-19,1624057200.0
13949,76,4,2021-06-20,49,0,48912,101,2021-06-20,1624143600.0
13950,76,4,2021-06-21,483,4,49395,105,2021-06-21,1624230000.0
13951,76,4,2021-06-22,787,1,50182,106,2021-06-22,1624316400.0
13952,76,4,2021-06-23,755,7,50937,113,2021-06-23,1624402800.0
13953,76,4,2021-06-24,977,3,51914,116,2021-06-24,1624489200.0
13954,76,4,2021-06-25,1093,3,53007,119,2021-06-25,1624575600.0
13955,76,4,2021-06-26,336,0,53343,119,2021-06-26,1624662000.0
13956,76,4,2021-06-27,44,0,53387,119,2021-06-27,1624748400.0
13957,76,4,2021-06-28,455,3,53842,122,2021-06-28,1624834800.0
13958,76,4,2021-06-29,688,5,54530,127,2021-06-29,1624921200.0
13959,76,4,2021-06-30,683,2,55213,129,2021-06-30,1625007600.0
13960,76,4,2021-07-01,924,1,56137,130,2021-07-01,1625094000.0
13961,76,4,2021-07-02,817,5,56954,135,2021-07-02,1625180400.0
13962,76,4,2021-07-03,348,3,57302,138,2021-07-03,1625266800.0
13963,76,4,2021-07-04,63,0,57365,138,2021-07-04,1625353200.0
13964,76,4,2021-07-05,474,3,57839,141,2021-07-05,1625439600.0
13965,76,4,2021-07-06,842,5,58681,146,2021-07-06,1625526000.0
13966,76,4,2021-07-07,672,4,59353,150,2021-07-07,1625612400.0
13967,76,4,2021-07-08,1002,3,60355,153,2021-07-08,1625698800.0
13968,84,1,2020-12-27,1,0,1,0,2020-12-27,1609023600.0
13969,84,1,2020-12-28,7,0,8,0,2020-12-28,1609110000.0
13970,84,1,2020-12-29,5,0,13,0,2020-12-29,1609196400.0
13971,84,1,2020-12-30,6,0,19,0,2020-12-30,1609282800.0
13972,84,1,2020-12-31,15,0,34,0,2020-12-31,1609369200.0
13973,84,1,2021-01-01,10,0,44,0,2021-01-01,1609455600.0
13974,84,1,2021-01-02,2,0,46,0,2021-01-02,1609542000.0
13975,84,1,2021-01-03,0,0,46,0,2021-01-03,1609628400.0
13976,84,1,2021-01-04,174,0,220,0,2021-01-04,1609714800.0
13977,84,1,2021-01-05,470,0,690,0,2021-01-05,1609801200.0
13978,84,1,2021-01-06,1136,0,1826,0,2021-01-06,1609887600.0
13979,84,1,2021-01-07,2892,0,4718,0,2021-01-07,1609974000.0
13980,84,1,2021-01-08,3083,0,7801,0,2021-01-08,1610060400.0
13981,84,1,2021-01-09,514,0,8315,0,2021-01-09,1610146800.0
13982,84,1,2021-01-10,161,0,8476,0,2021-01-10,1610233200.0
13983,84,1,2021-01-11,4303,0,12779,0,2021-01-11,1610319600.0
13984,84,1,2021-01-12,6369,0,19148,0,2021-01-12,1610406000.0
13985,84,1,2021-01-13,6855,0,26003,0,2021-01-13,1610492400.0
13986,84,1,2021-01-14,9064,0,35067,0,2021-01-14,1610578800.0
13987,84,1,2021-01-15,7727,0,42794,0,2021-01-15,1610665200.0
13988,84,1,2021-01-16,2948,2,45742,2,2021-01-16,1610751600.0
13989,84,1,2021-01-17,914,2,46656,4,2021-01-17,1610838000.0
13990,84,1,2021-01-18,8306,20,54962,24,2021-01-18,1610924400.0
13991,84,1,2021-01-19,14177,16,69139,40,2021-01-19,1611010800.0
13992,84,1,2021-01-20,14475,16,83614,56,2021-01-20,1611097200.0
13993,84,1,2021-01-21,13592,19,97206,75,2021-01-21,1611183600.0
13994,84,1,2021-01-22,11521,19,108727,94,2021-01-22,1611270000.0
13995,84,1,2021-01-23,4306,1,113033,95,2021-01-23,1611356400.0
13996,84,1,2021-01-24,810,0,113843,95,2021-01-24,1611442800.0
13997,84,1,2021-01-25,8649,136,122492,231,2021-01-25,1611529200.0
13998,84,1,2021-01-26,11813,294,134305,525,2021-01-26,1611615600.0
13999,84,1,2021-01-27,12026,588,146331,1113,2021-01-27,1611702000.0
14000,84,1,2021-01-28,13796,1502,160127,2615,2021-01-28,1611788400.0
14001,84,1,2021-01-29,10745,1286,170872,3901,2021-01-29,1611874800.0
14002,84,1,2021-01-30,4142,142,175014,4043,2021-01-30,1611961200.0
14003,84,1,2021-01-31,499,1,175513,4044,2021-01-31,1612047600.0
14004,84,1,2021-02-01,6490,1861,182003,5905,2021-02-01,1612134000.0
14005,84,1,2021-02-02,10313,3459,192316,9364,2021-02-02,1612220400.0
14006,84,1,2021-02-03,11161,3870,203477,13234,2021-02-03,1612306800.0
14007,84,1,2021-02-04,12344,5447,215821,18681,2021-02-04,1612393200.0
14008,84,1,2021-02-05,8279,4642,224100,23323,2021-02-05,1612479600.0
14009,84,1,2021-02-06,2435,931,226535,24254,2021-02-06,1612566000.0
14010,84,1,2021-02-07,270,435,226805,24689,2021-02-07,1612652400.0
14011,84,1,2021-02-08,5202,4913,232007,29602,2021-02-08,1612738800.0
14012,84,1,2021-02-09,7093,8135,239100,37737,2021-02-09,1612825200.0
14013,84,1,2021-02-10,7191,8454,246291,46191,2021-02-10,1612911600.0
14014,84,1,2021-02-11,7623,9684,253914,55875,2021-02-11,1612998000.0
14015,84,1,2021-02-12,7001,7725,260915,63600,2021-02-12,1613084400.0
14016,84,1,2021-02-13,1882,2287,262797,65887,2021-02-13,1613170800.0
14017,84,1,2021-02-14,303,445,263100,66332,2021-02-14,1613257200.0
14018,84,1,2021-02-15,2862,7525,265962,73857,2021-02-15,1613343600.0
14019,84,1,2021-02-16,3924,9754,269886,83611,2021-02-16,1613430000.0
14020,84,1,2021-02-17,3993,10409,273879,94020,2021-02-17,1613516400.0
14021,84,1,2021-02-18,5016,10486,278895,104506,2021-02-18,1613602800.0
14022,84,1,2021-02-19,4335,8472,283230,112978,2021-02-19,1613689200.0
14023,84,1,2021-02-20,1185,3067,284415,116045,2021-02-20,1613775600.0
14024,84,1,2021-02-21,151,504,284566,116549,2021-02-21,1613862000.0
14025,84,1,2021-02-22,2719,8632,287285,125181,2021-02-22,1613948400.0
14026,84,1,2021-02-23,4886,11096,292171,136277,2021-02-23,1614034800.0
14027,84,1,2021-02-24,5601,11693,297772,147970,2021-02-24,1614121200.0
14028,84,1,2021-02-25,7099,13355,304871,161325,2021-02-25,1614207600.0
14029,84,1,2021-02-26,6289,9983,311160,171308,2021-02-26,1614294000.0
14030,84,1,2021-02-27,1684,2770,312844,174078,2021-02-27,1614380400.0
14031,84,1,2021-02-28,242,498,313086,174576,2021-02-28,1614466800.0
14032,84,1,2021-03-01,5618,6096,318704,180672,2021-03-01,1614553200.0
14033,84,1,2021-03-02,7964,8218,326668,188890,2021-03-02,1614639600.0
14034,84,1,2021-03-03,7730,7934,334398,196824,2021-03-03,1614726000.0
14035,84,1,2021-03-04,9568,7729,343966,204553,2021-03-04,1614812400.0
14036,84,1,2021-03-05,8622,6857,352588,211410,2021-03-05,1614898800.0
14037,84,1,2021-03-06,5743,1958,358331,213368,2021-03-06,1614985200.0
14038,84,1,2021-03-07,3024,330,361355,213698,2021-03-07,1615071600.0
14039,84,1,2021-03-08,7336,6097,368691,219795,2021-03-08,1615158000.0
14040,84,1,2021-03-09,9549,6779,378240,226574,2021-03-09,1615244400.0
14041,84,1,2021-03-10,9699,6493,387939,233067,2021-03-10,1615330800.0
14042,84,1,2021-03-11,11592,6928,399531,239995,2021-03-11,1615417200.0
14043,84,1,2021-03-12,10646,6437,410177,246432,2021-03-12,1615503600.0
14044,84,1,2021-03-13,6293,1394,416470,247826,2021-03-13,1615590000.0
14045,84,1,2021-03-14,2706,390,419176,248216,2021-03-14,1615676400.0
14046,84,1,2021-03-15,10833,4027,430009,252243,2021-03-15,1615762800.0
14047,84,1,2021-03-16,13783,5271,443792,257514,2021-03-16,1615849200.0
14048,84,1,2021-03-17,14159,5464,457951,262978,2021-03-17,1615935600.0
14049,84,1,2021-03-18,16723,5855,474674,268833,2021-03-18,1616022000.0
14050,84,1,2021-03-19,15279,4185,489953,273018,2021-03-19,1616108400.0
14051,84,1,2021-03-20,6826,1006,496779,274024,2021-03-20,1616194800.0
14052,84,1,2021-03-21,2782,170,499561,274194,2021-03-21,1616281200.0
14053,84,1,2021-03-22,12700,4019,512261,278213,2021-03-22,1616367600.0
14054,84,1,2021-03-23,16125,4719,528386,282932,2021-03-23,1616454000.0
14055,84,1,2021-03-24,15911,4408,544297,287340,2021-03-24,1616540400.0
14056,84,1,2021-03-25,19228,4564,563525,291904,2021-03-25,1616626800.0
14057,84,1,2021-03-26,18876,4805,582401,296709,2021-03-26,1616713200.0
14058,84,1,2021-03-27,9727,2252,592128,298961,2021-03-27,1616799600.0
14059,84,1,2021-03-28,4303,361,596431,299322,2021-03-28,1616886000.0
14060,84,1,2021-03-29,13468,6879,609899,306201,2021-03-29,1616972400.0
14061,84,1,2021-03-30,17232,8208,627131,314409,2021-03-30,1617058800.0
14062,84,1,2021-03-31,17048,9078,644179,323487,2021-03-31,1617145200.0
14063,84,1,2021-04-01,20348,8525,664527,332012,2021-04-01,1617231600.0
14064,84,1,2021-04-02,18067,8504,682594,340516,2021-04-02,1617318000.0
14065,84,1,2021-04-03,7127,5129,689721,345645,2021-04-03,1617404400.0
14066,84,1,2021-04-04,4969,1525,694690,347170,2021-04-04,1617490800.0
14067,84,1,2021-04-05,7982,990,702672,348160,2021-04-05,1617577200.0
14068,84,1,2021-04-06,18834,10939,721506,359099,2021-04-06,1617663600.0
14069,84,1,2021-04-07,21538,11858,743044,370957,2021-04-07,1617750000.0
14070,84,1,2021-04-08,24936,11859,767980,382816,2021-04-08,1617836400.0
14071,84,1,2021-04-09,24788,11561,792768,394377,2021-04-09,1617922800.0
14072,84,1,2021-04-10,12160,6102,804928,400479,2021-04-10,1618009200.0
14073,84,1,2021-04-11,6126,2212,811054,402691,2021-04-11,1618095600.0
14074,84,1,2021-04-12,19327,12229,830381,414920,2021-04-12,1618185600.0
14075,84,1,2021-04-13,24094,13881,854475,428801,2021-04-13,1618272000.0
14076,84,1,2021-04-14,25124,13469,879599,442270,2021-04-14,1618358400.0
14077,84,1,2021-04-15,27206,13661,906805,455931,2021-04-15,1618444800.0
14078,84,1,2021-04-16,23683,13980,930488,469911,2021-04-16,1618531200.0
14079,84,1,2021-04-17,15034,6258,945522,476169,2021-04-17,1618617600.0
14080,84,1,2021-04-18,5832,2359,951354,478528,2021-04-18,1618704000.0
14081,84,1,2021-04-19,21111,14362,972465,492890,2021-04-19,1618790400.0
14082,84,1,2021-04-20,24137,17008,996602,509898,2021-04-20,1618876800.0
14083,84,1,2021-04-21,22445,16575,1019047,526473,2021-04-21,1618963200.0
14084,84,1,2021-04-22,24731,17003,1043778,543476,2021-04-22,1619049600.0
14085,84,1,2021-04-23,23326,17230,1067104,560706,2021-04-23,1619136000.0
14086,84,1,2021-04-24,14209,8451,1081313,569157,2021-04-24,1619222400.0
14087,84,1,2021-04-25,6873,2736,1088186,571893,2021-04-25,1619308800.0
14088,84,1,2021-04-26,20444,15723,1108630,587616,2021-04-26,1619395200.0
14089,84,1,2021-04-27,25076,17714,1133706,605330,2021-04-27,1619481600.0
14090,84,1,2021-04-28,26507,16733,1160213,622063,2021-04-28,1619568000.0
14091,84,1,2021-04-29,29700,17051,1189913,639114,2021-04-29,1619654400.0
14092,84,1,2021-04-30,26274,16821,1216187,655935,2021-04-30,1619740800.0
14093,84,1,2021-05-01,15250,3056,1231437,658991,2021-05-01,1619827200.0
14094,84,1,2021-05-02,7486,3835,1238923,662826,2021-05-02,1619913600.0
14095,84,1,2021-05-03,25573,18353,1264496,681179,2021-05-03,1620000000.0
14096,84,1,2021-05-04,29996,22959,1294492,704138,2021-05-04,1620086400.0
14097,84,1,2021-05-05,34261,21387,1328753,725525,2021-05-05,1620172800.0
14098,84,1,2021-05-06,39053,21578,1367806,747103,2021-05-06,1620259200.0
14099,84,1,2021-05-07,37535,23436,1405341,770539,2021-05-07,1620345600.0
14100,84,1,2021-05-08,20294,4483,1425635,775022,2021-05-08,1620432000.0
14101,84,1,2021-05-09,14474,6780,1440109,781802,2021-05-09,1620518400.0
14102,84,1,2021-05-10,29814,23251,1469923,805053,2021-05-10,1620604800.0
14103,84,1,2021-05-11,42750,24628,1512673,829681,2021-05-11,1620691200.0
14104,84,1,2021-05-12,48738,20577,1561411,850258,2021-05-12,1620777600.0
14105,84,1,2021-05-13,39367,6287,1600778,856545,2021-05-13,1620864000.0
14106,84,1,2021-05-14,49067,15297,1649845,871842,2021-05-14,1620950400.0
14107,84,1,2021-05-15,41027,7481,1690872,879323,2021-05-15,1621036800.0
14108,84,1,2021-05-16,27341,2220,1718213,881543,2021-05-16,1621123200.0
14109,84,1,2021-05-17,39362,15852,1757575,897395,2021-05-17,1621206000.0
14110,84,1,2021-05-18,46170,15519,1803745,912914,2021-05-18,1621292400.0
14111,84,1,2021-05-19,46063,12472,1849808,925386,2021-05-19,1621378800.0
14112,84,1,2021-05-20,49899,13029,1899707,938415,2021-05-20,1621465200.0
14113,84,1,2021-05-21,48502,13063,1948209,951478,2021-05-21,1621551600.0
14114,84,1,2021-05-22,31686,5423,1979895,956901,2021-05-22,1621638000.0
14115,84,1,2021-05-23,14378,1912,1994273,958813,2021-05-23,1621724400.0
14116,84,1,2021-05-24,35867,4222,2030140,963035,2021-05-24,1621810800.0
14117,84,1,2021-05-25,47728,18052,2077868,981087,2021-05-25,1621897200.0
14118,84,1,2021-05-26,47841,15613,2125709,996700,2021-05-26,1621983600.0
14119,84,1,2021-05-27,52160,14379,2177869,1011079,2021-05-27,1622070000.0
14120,84,1,2021-05-28,48996,17731,2226865,1028810,2021-05-28,1622156400.0
14121,84,1,2021-05-29,35888,11023,2262753,1039833,2021-05-29,1622242800.0
14122,84,1,2021-05-30,15885,4699,2278638,1044532,2021-05-30,1622329200.0
14123,84,1,2021-05-31,42580,18150,2321218,1062682,2021-05-31,1622415600.0
14124,84,1,2021-06-01,43254,19628,2364472,1082310,2021-06-01,1622502000.0
14125,84,1,2021-06-02,43319,16556,2407791,1098866,2021-06-02,1622588400.0
14126,84,1,2021-06-03,48412,15764,2456203,1114630,2021-06-03,1622674800.0
14127,84,1,2021-06-04,44617,18822,2500820,1133452,2021-06-04,1622761200.0
14128,84,1,2021-06-05,34769,11747,2535589,1145199,2021-06-05,1622847600.0
14129,84,1,2021-06-06,15645,4089,2551234,1149288,2021-06-06,1622934000.0
14130,84,1,2021-06-07,37392,23842,2588626,1173130,2021-06-07,1623020400.0
14131,84,1,2021-06-08,38784,23012,2627410,1196142,2021-06-08,1623106800.0
14132,84,1,2021-06-09,35896,21301,2663306,1217443,2021-06-09,1623193200.0
14133,84,1,2021-06-10,35039,17625,2698345,1235068,2021-06-10,1623279600.0
14134,84,1,2021-06-11,35839,23905,2734184,1258973,2021-06-11,1623366000.0
14135,84,1,2021-06-12,25119,14672,2759303,1273645,2021-06-12,1623452400.0
14136,84,1,2021-06-13,8424,5397,2767727,1279042,2021-06-13,1623538800.0
14137,84,1,2021-06-14,22659,32336,2790386,1311378,2021-06-14,1623625200.0
14138,84,1,2021-06-15,26808,31180,2817194,1342558,2021-06-15,1623711600.0
14139,84,1,2021-06-16,29873,31069,2847067,1373627,2021-06-16,1623798000.0
14140,84,1,2021-06-17,26241,27184,2873308,1400811,2021-06-17,1623884400.0
14141,84,1,2021-06-18,29013,36948,2902321,1437759,2021-06-18,1623970800.0
14142,84,1,2021-06-19,20764,26777,2923085,1464536,2021-06-19,1624057200.0
14143,84,1,2021-06-20,8512,11433,2931597,1475969,2021-06-20,1624143600.0
14144,84,1,2021-06-21,17869,42209,2949466,1518178,2021-06-21,1624230000.0
14145,84,1,2021-06-22,17710,43679,2967176,1561857,2021-06-22,1624316400.0
14146,84,1,2021-06-23,19738,42514,2986914,1604371,2021-06-23,1624402800.0
14147,84,1,2021-06-24,19740,36566,3006654,1640937,2021-06-24,1624489200.0
14148,84,1,2021-06-25,19409,48217,3026063,1689154,2021-06-25,1624575600.0
14149,84,1,2021-06-26,12572,37800,3038635,1726954,2021-06-26,1624662000.0
14150,84,1,2021-06-27,6634,18634,3045269,1745588,2021-06-27,1624748400.0
14151,84,1,2021-06-28,14176,47619,3059445,1793207,2021-06-28,1624834800.0
14152,84,1,2021-06-29,16176,45991,3075621,1839198,2021-06-29,1624921200.0
14153,84,1,2021-06-30,19308,43149,3094929,1882347,2021-06-30,1625007600.0
14154,84,1,2021-07-01,19771,36798,3114700,1919145,2021-07-01,1625094000.0
14155,84,1,2021-07-02,19156,44846,3133856,1963991,2021-07-02,1625180400.0
14156,84,1,2021-07-03,14274,34132,3148130,1998123,2021-07-03,1625266800.0
14157,84,1,2021-07-04,7569,12982,3155699,2011105,2021-07-04,1625353200.0
14158,84,1,2021-07-05,17385,50473,3173084,2061578,2021-07-05,1625439600.0
14159,84,1,2021-07-06,18564,47082,3191648,2108660,2021-07-06,1625526000.0
14160,84,1,2021-07-07,22039,42533,3213687,2151193,2021-07-07,1625612400.0
14161,84,1,2021-07-08,24250,35929,3237937,2187122,2021-07-08,1625698800.0
14162,84,2,2020-12-27,0,0,0,0,2020-12-27,1609023600.0
14163,84,2,2020-12-28,0,0,0,0,2020-12-28,1609110000.0
14164,84,2,2020-12-29,0,0,0,0,2020-12-29,1609196400.0
14165,84,2,2020-12-30,0,0,0,0,2020-12-30,1609282800.0
14166,84,2,2020-12-31,0,0,0,0,2020-12-31,1609369200.0
14167,84,2,2021-01-01,0,0,0,0,2021-01-01,1609455600.0
14168,84,2,2021-01-02,0,0,0,0,2021-01-02,1609542000.0
14169,84,2,2021-01-03,0,0,0,0,2021-01-03,1609628400.0
14170,84,2,2021-01-04,0,0,0,0,2021-01-04,1609714800.0
14171,84,2,2021-01-05,0,0,0,0,2021-01-05,1609801200.0
14172,84,2,2021-01-06,0,0,0,0,2021-01-06,1609887600.0
14173,84,2,2021-01-07,0,0,0,0,2021-01-07,1609974000.0
14174,84,2,2021-01-08,0,0,0,0,2021-01-08,1610060400.0
14175,84,2,2021-01-09,0,0,0,0,2021-01-09,1610146800.0
14176,84,2,2021-01-10,0,0,0,0,2021-01-10,1610233200.0
14177,84,2,2021-01-11,0,0,0,0,2021-01-11,1610319600.0
14178,84,2,2021-01-12,0,0,0,0,2021-01-12,1610406000.0
14179,84,2,2021-01-13,0,0,0,0,2021-01-13,1610492400.0
14180,84,2,2021-01-14,12,0,12,0,2021-01-14,1610578800.0
14181,84,2,2021-01-15,38,0,50,0,2021-01-15,1610665200.0
14182,84,2,2021-01-16,0,0,50,0,2021-01-16,1610751600.0
14183,84,2,2021-01-17,3,0,53,0,2021-01-17,1610838000.0
14184,84,2,2021-01-18,664,0,717,0,2021-01-18,1610924400.0
14185,84,2,2021-01-19,869,0,1586,0,2021-01-19,1611010800.0
14186,84,2,2021-01-20,1027,0,2613,0,2021-01-20,1611097200.0
14187,84,2,2021-01-21,1014,0,3627,0,2021-01-21,1611183600.0
14188,84,2,2021-01-22,900,0,4527,0,2021-01-22,1611270000.0
14189,84,2,2021-01-23,458,0,4985,0,2021-01-23,1611356400.0
14190,84,2,2021-01-24,0,0,4985,0,2021-01-24,1611442800.0
14191,84,2,2021-01-25,123,0,5108,0,2021-01-25,1611529200.0
14192,84,2,2021-01-26,92,0,5200,0,2021-01-26,1611615600.0
14193,84,2,2021-01-27,60,0,5260,0,2021-01-27,1611702000.0
14194,84,2,2021-01-28,62,0,5322,0,2021-01-28,1611788400.0
14195,84,2,2021-01-29,61,0,5383,0,2021-01-29,1611874800.0
14196,84,2,2021-01-30,0,0,5383,0,2021-01-30,1611961200.0
14197,84,2,2021-01-31,0,0,5383,0,2021-01-31,1612047600.0
14198,84,2,2021-02-01,65,0,5448,0,2021-02-01,1612134000.0
14199,84,2,2021-02-02,294,0,5742,0,2021-02-02,1612220400.0
14200,84,2,2021-02-03,371,0,6113,0,2021-02-03,1612306800.0
14201,84,2,2021-02-04,229,0,6342,0,2021-02-04,1612393200.0
14202,84,2,2021-02-05,343,1,6685,1,2021-02-05,1612479600.0
14203,84,2,2021-02-06,66,0,6751,1,2021-02-06,1612566000.0
14204,84,2,2021-02-07,13,0,6764,1,2021-02-07,1612652400.0
14205,84,2,2021-02-08,271,0,7035,1,2021-02-08,1612738800.0
14206,84,2,2021-02-09,549,1,7584,2,2021-02-09,1612825200.0
14207,84,2,2021-02-10,697,18,8281,20,2021-02-10,1612911600.0
14208,84,2,2021-02-11,681,0,8962,20,2021-02-11,1612998000.0
14209,84,2,2021-02-12,618,36,9580,56,2021-02-12,1613084400.0
14210,84,2,2021-02-13,140,1,9720,57,2021-02-13,1613170800.0
14211,84,2,2021-02-14,0,0,9720,57,2021-02-14,1613257200.0
14212,84,2,2021-02-15,428,699,10148,756,2021-02-15,1613343600.0
14213,84,2,2021-02-16,537,883,10685,1639,2021-02-16,1613430000.0
14214,84,2,2021-02-17,579,1040,11264,2679,2021-02-17,1613516400.0
14215,84,2,2021-02-18,422,1096,11686,3775,2021-02-18,1613602800.0
14216,84,2,2021-02-19,617,706,12303,4481,2021-02-19,1613689200.0
14217,84,2,2021-02-20,85,168,12388,4649,2021-02-20,1613775600.0
14218,84,2,2021-02-21,0,0,12388,4649,2021-02-21,1613862000.0
14219,84,2,2021-02-22,362,105,12750,4754,2021-02-22,1613948400.0
14220,84,2,2021-02-23,494,136,13244,4890,2021-02-23,1614034800.0
14221,84,2,2021-02-24,526,141,13770,5031,2021-02-24,1614121200.0
14222,84,2,2021-02-25,851,36,14621,5067,2021-02-25,1614207600.0
14223,84,2,2021-02-26,411,1,15032,5068,2021-02-26,1614294000.0
14224,84,2,2021-02-27,65,42,15097,5110,2021-02-27,1614380400.0
14225,84,2,2021-02-28,0,0,15097,5110,2021-02-28,1614466800.0
14226,84,2,2021-03-01,748,168,15845,5278,2021-03-01,1614553200.0
14227,84,2,2021-03-02,980,258,16825,5536,2021-03-02,1614639600.0
14228,84,2,2021-03-03,886,384,17711,5920,2021-03-03,1614726000.0
14229,84,2,2021-03-04,915,187,18626,6107,2021-03-04,1614812400.0
14230,84,2,2021-03-05,1192,203,19818,6310,2021-03-05,1614898800.0
14231,84,2,2021-03-06,672,116,20490,6426,2021-03-06,1614985200.0
14232,84,2,2021-03-07,160,0,20650,6426,2021-03-07,1615071600.0
14233,84,2,2021-03-08,509,467,21159,6893,2021-03-08,1615158000.0
14234,84,2,2021-03-09,1148,522,22307,7415,2021-03-09,1615244400.0
14235,84,2,2021-03-10,1266,633,23573,8048,2021-03-10,1615330800.0
14236,84,2,2021-03-11,1498,558,25071,8606,2021-03-11,1615417200.0
14237,84,2,2021-03-12,1167,462,26238,9068,2021-03-12,1615503600.0
14238,84,2,2021-03-13,1342,113,27580,9181,2021-03-13,1615590000.0
14239,84,2,2021-03-14,272,2,27852,9183,2021-03-14,1615676400.0
14240,84,2,2021-03-15,2007,329,29859,9512,2021-03-15,1615762800.0
14241,84,2,2021-03-16,3170,439,33029,9951,2021-03-16,1615849200.0
14242,84,2,2021-03-17,3334,532,36363,10483,2021-03-17,1615935600.0
14243,84,2,2021-03-18,4619,399,40982,10882,2021-03-18,1616022000.0
14244,84,2,2021-03-19,4718,543,45700,11425,2021-03-19,1616108400.0
14245,84,2,2021-03-20,1765,31,47465,11456,2021-03-20,1616194800.0
14246,84,2,2021-03-21,3,0,47468,11456,2021-03-21,1616281200.0
14247,84,2,2021-03-22,3054,598,50522,12054,2021-03-22,1616367600.0
14248,84,2,2021-03-23,3894,346,54416,12400,2021-03-23,1616454000.0
14249,84,2,2021-03-24,3878,550,58294,12950,2021-03-24,1616540400.0
14250,84,2,2021-03-25,4350,571,62644,13521,2021-03-25,1616626800.0
14251,84,2,2021-03-26,3931,500,66575,14021,2021-03-26,1616713200.0
14252,84,2,2021-03-27,2322,64,68897,14085,2021-03-27,1616799600.0
14253,84,2,2021-03-28,1858,0,70755,14085,2021-03-28,1616886000.0
14254,84,2,2021-03-29,2712,266,73467,14351,2021-03-29,1616972400.0
14255,84,2,2021-03-30,4519,691,77986,15042,2021-03-30,1617058800.0
14256,84,2,2021-03-31,4567,683,82553,15725,2021-03-31,1617145200.0
14257,84,2,2021-04-01,5239,1220,87792,16945,2021-04-01,1617231600.0
14258,84,2,2021-04-02,4449,1295,92241,18240,2021-04-02,1617318000.0
14259,84,2,2021-04-03,4359,483,96600,18723,2021-04-03,1617404400.0
14260,84,2,2021-04-04,4890,4,101490,18727,2021-04-04,1617490800.0
14261,84,2,2021-04-05,5304,9,106794,18736,2021-04-05,1617577200.0
14262,84,2,2021-04-06,3297,1101,110091,19837,2021-04-06,1617663600.0
14263,84,2,2021-04-07,4043,1441,114134,21278,2021-04-07,1617750000.0
14264,84,2,2021-04-08,4102,1577,118236,22855,2021-04-08,1617836400.0
14265,84,2,2021-04-09,3817,1274,122053,24129,2021-04-09,1617922800.0
14266,84,2,2021-04-10,1742,1029,123795,25158,2021-04-10,1618009200.0
14267,84,2,2021-04-11,710,22,124505,25180,2021-04-11,1618095600.0
14268,84,2,2021-04-12,2399,1994,126904,27174,2021-04-12,1618185600.0
14269,84,2,2021-04-13,1973,3568,128877,30742,2021-04-13,1618272000.0
14270,84,2,2021-04-14,2154,2925,131031,33667,2021-04-14,1618358400.0
14271,84,2,2021-04-15,2261,3784,133292,37451,2021-04-15,1618444800.0
14272,84,2,2021-04-16,2229,4003,135521,41454,2021-04-16,1618531200.0
14273,84,2,2021-04-17,1231,1635,136752,43089,2021-04-17,1618617600.0
14274,84,2,2021-04-18,670,16,137422,43105,2021-04-18,1618704000.0
14275,84,2,2021-04-19,2055,2685,139477,45790,2021-04-19,1618790400.0
14276,84,2,2021-04-20,1628,3570,141105,49360,2021-04-20,1618876800.0
14277,84,2,2021-04-21,1573,3141,142678,52501,2021-04-21,1618963200.0
14278,84,2,2021-04-22,1797,3418,144475,55919,2021-04-22,1619049600.0
14279,84,2,2021-04-23,1724,3493,146199,59412,2021-04-23,1619136000.0
14280,84,2,2021-04-24,675,2177,146874,61589,2021-04-24,1619222400.0
14281,84,2,2021-04-25,159,1080,147033,62669,2021-04-25,1619308800.0
14282,84,2,2021-04-26,1110,2458,148143,65127,2021-04-26,1619395200.0
14283,84,2,2021-04-27,1356,4382,149499,69509,2021-04-27,1619481600.0
14284,84,2,2021-04-28,2025,4745,151524,74254,2021-04-28,1619568000.0
14285,84,2,2021-04-29,3276,4367,154800,78621,2021-04-29,1619654400.0
14286,84,2,2021-04-30,3127,4529,157927,83150,2021-04-30,1619740800.0
14287,84,2,2021-05-01,1096,825,159023,83975,2021-05-01,1619827200.0
14288,84,2,2021-05-02,382,4120,159405,88095,2021-05-02,1619913600.0
14289,84,2,2021-05-03,2866,5825,162271,93920,2021-05-03,1620000000.0
14290,84,2,2021-05-04,3240,5609,165511,99529,2021-05-04,1620086400.0
14291,84,2,2021-05-05,3176,3659,168687,103188,2021-05-05,1620172800.0
14292,84,2,2021-05-06,2957,3455,171644,106643,2021-05-06,1620259200.0
14293,84,2,2021-05-07,2706,3608,174350,110251,2021-05-07,1620345600.0
14294,84,2,2021-05-08,1420,608,175770,110859,2021-05-08,1620432000.0
14295,84,2,2021-05-09,1293,703,177063,111562,2021-05-09,1620518400.0
14296,84,2,2021-05-10,4098,3303,181161,114865,2021-05-10,1620604800.0
14297,84,2,2021-05-11,5546,2375,186707,117240,2021-05-11,1620691200.0
14298,84,2,2021-05-12,5543,2464,192250,119704,2021-05-12,1620777600.0
14299,84,2,2021-05-13,7790,442,200040,120146,2021-05-13,1620864000.0
14300,84,2,2021-05-14,6643,1639,206683,121785,2021-05-14,1620950400.0
14301,84,2,2021-05-15,2666,823,209349,122608,2021-05-15,1621036800.0
14302,84,2,2021-05-16,3208,149,212557,122757,2021-05-16,1621123200.0
14303,84,2,2021-05-17,7909,1579,220466,124336,2021-05-17,1621206000.0
14304,84,2,2021-05-18,11155,1792,231621,126128,2021-05-18,1621292400.0
14305,84,2,2021-05-19,11307,1573,242928,127701,2021-05-19,1621378800.0
14306,84,2,2021-05-20,10090,1074,253018,128775,2021-05-20,1621465200.0
14307,84,2,2021-05-21,10674,1288,263692,130063,2021-05-21,1621551600.0
14308,84,2,2021-05-22,8248,520,271940,130583,2021-05-22,1621638000.0
14309,84,2,2021-05-23,7109,92,279049,130675,2021-05-23,1621724400.0
14310,84,2,2021-05-24,4215,355,283264,131030,2021-05-24,1621810800.0
14311,84,2,2021-05-25,1626,1795,284890,132825,2021-05-25,1621897200.0
14312,84,2,2021-05-26,1364,1841,286254,134666,2021-05-26,1621983600.0
14313,84,2,2021-05-27,2004,1408,288258,136074,2021-05-27,1622070000.0
14314,84,2,2021-05-28,2641,1525,290899,137599,2021-05-28,1622156400.0
14315,84,2,2021-05-29,808,772,291707,138371,2021-05-29,1622242800.0
14316,84,2,2021-05-30,189,295,291896,138666,2021-05-30,1622329200.0
14317,84,2,2021-05-31,318,1530,292214,140196,2021-05-31,1622415600.0
14318,84,2,2021-06-01,2561,1523,294775,141719,2021-06-01,1622502000.0
14319,84,2,2021-06-02,2953,1463,297728,143182,2021-06-02,1622588400.0
14320,84,2,2021-06-03,5365,1641,303093,144823,2021-06-03,1622674800.0
14321,84,2,2021-06-04,7516,1926,310609,146749,2021-06-04,1622761200.0
14322,84,2,2021-06-05,2637,1085,313246,147834,2021-06-05,1622847600.0
14323,84,2,2021-06-06,238,297,313484,148131,2021-06-06,1622934000.0
14324,84,2,2021-06-07,3003,1917,316487,150048,2021-06-07,1623020400.0
14325,84,2,2021-06-08,4662,1948,321149,151996,2021-06-08,1623106800.0
14326,84,2,2021-06-09,3443,1742,324592,153738,2021-06-09,1623193200.0
14327,84,2,2021-06-10,4664,1943,329256,155681,2021-06-10,1623279600.0
14328,84,2,2021-06-11,5833,3190,335089,158871,2021-06-11,1623366000.0
14329,84,2,2021-06-12,2466,1394,337555,160265,2021-06-12,1623452400.0
14330,84,2,2021-06-13,171,487,337726,160752,2021-06-13,1623538800.0
14331,84,2,2021-06-14,2284,3714,340010,164466,2021-06-14,1623625200.0
14332,84,2,2021-06-15,3717,3492,343727,167958,2021-06-15,1623711600.0
14333,84,2,2021-06-16,2659,2639,346386,170597,2021-06-16,1623798000.0
14334,84,2,2021-06-17,3108,2709,349494,173306,2021-06-17,1623884400.0
14335,84,2,2021-06-18,4514,3223,354008,176529,2021-06-18,1623970800.0
14336,84,2,2021-06-19,1540,2131,355548,178660,2021-06-19,1624057200.0
14337,84,2,2021-06-20,129,1464,355677,180124,2021-06-20,1624143600.0
14338,84,2,2021-06-21,1566,5934,357243,186058,2021-06-21,1624230000.0
14339,84,2,2021-06-22,2459,6216,359702,192274,2021-06-22,1624316400.0
14340,84,2,2021-06-23,1772,5314,361474,197588,2021-06-23,1624402800.0
14341,84,2,2021-06-24,2508,4464,363982,202052,2021-06-24,1624489200.0
14342,84,2,2021-06-25,2923,6020,366905,208072,2021-06-25,1624575600.0
14343,84,2,2021-06-26,1112,3323,368017,211395,2021-06-26,1624662000.0
14344,84,2,2021-06-27,179,3390,368196,214785,2021-06-27,1624748400.0
14345,84,2,2021-06-28,1035,10733,369231,225518,2021-06-28,1624834800.0
14346,84,2,2021-06-29,1887,10877,371118,236395,2021-06-29,1624921200.0
14347,84,2,2021-06-30,1630,10467,372748,246862,2021-06-30,1625007600.0
14348,84,2,2021-07-01,1924,8727,374672,255589,2021-07-01,1625094000.0
14349,84,2,2021-07-02,2298,8589,376970,264178,2021-07-02,1625180400.0
14350,84,2,2021-07-03,886,5383,377856,269561,2021-07-03,1625266800.0
14351,84,2,2021-07-04,112,2562,377968,272123,2021-07-04,1625353200.0
14352,84,2,2021-07-05,712,4091,378680,276214,2021-07-05,1625439600.0
14353,84,2,2021-07-06,1378,3790,380058,280004,2021-07-06,1625526000.0
14354,84,2,2021-07-07,1228,2687,381286,282691,2021-07-07,1625612400.0
14355,84,2,2021-07-08,1707,3560,382993,286251,2021-07-08,1625698800.0
14356,84,3,2020-12-27,0,0,0,0,2020-12-27,1609023600.0
14357,84,3,2020-12-28,0,0,0,0,2020-12-28,1609110000.0
14358,84,3,2020-12-29,0,0,0,0,2020-12-29,1609196400.0
14359,84,3,2020-12-30,0,0,0,0,2020-12-30,1609282800.0
14360,84,3,2020-12-31,0,0,0,0,2020-12-31,1609369200.0
14361,84,3,2021-01-01,0,0,0,0,2021-01-01,1609455600.0
14362,84,3,2021-01-02,0,0,0,0,2021-01-02,1609542000.0
14363,84,3,2021-01-03,0,0,0,0,2021-01-03,1609628400.0
14364,84,3,2021-01-04,0,0,0,0,2021-01-04,1609714800.0
14365,84,3,2021-01-05,0,0,0,0,2021-01-05,1609801200.0
14366,84,3,2021-01-06,0,0,0,0,2021-01-06,1609887600.0
14367,84,3,2021-01-07,0,0,0,0,2021-01-07,1609974000.0
14368,84,3,2021-01-08,0,0,0,0,2021-01-08,1610060400.0
14369,84,3,2021-01-09,0,0,0,0,2021-01-09,1610146800.0
14370,84,3,2021-01-10,0,0,0,0,2021-01-10,1610233200.0
14371,84,3,2021-01-11,0,0,0,0,2021-01-11,1610319600.0
14372,84,3,2021-01-12,0,0,0,0,2021-01-12,1610406000.0
14373,84,3,2021-01-13,0,0,0,0,2021-01-13,1610492400.0
14374,84,3,2021-01-14,0,0,0,0,2021-01-14,1610578800.0
14375,84,3,2021-01-15,0,0,0,0,2021-01-15,1610665200.0
14376,84,3,2021-01-16,0,0,0,0,2021-01-16,1610751600.0
14377,84,3,2021-01-17,0,0,0,0,2021-01-17,1610838000.0
14378,84,3,2021-01-18,0,0,0,0,2021-01-18,1610924400.0
14379,84,3,2021-01-19,0,0,0,0,2021-01-19,1611010800.0
14380,84,3,2021-01-20,0,0,0,0,2021-01-20,1611097200.0
14381,84,3,2021-01-21,0,0,0,0,2021-01-21,1611183600.0
14382,84,3,2021-01-22,0,0,0,0,2021-01-22,1611270000.0
14383,84,3,2021-01-23,0,0,0,0,2021-01-23,1611356400.0
14384,84,3,2021-01-24,0,0,0,0,2021-01-24,1611442800.0
14385,84,3,2021-01-25,0,0,0,0,2021-01-25,1611529200.0
14386,84,3,2021-01-26,0,0,0,0,2021-01-26,1611615600.0
14387,84,3,2021-01-27,0,0,0,0,2021-01-27,1611702000.0
14388,84,3,2021-01-28,0,0,0,0,2021-01-28,1611788400.0
14389,84,3,2021-01-29,0,0,0,0,2021-01-29,1611874800.0
14390,84,3,2021-01-30,0,0,0,0,2021-01-30,1611961200.0
14391,84,3,2021-01-31,0,0,0,0,2021-01-31,1612047600.0
14392,84,3,2021-02-01,0,0,0,0,2021-02-01,1612134000.0
14393,84,3,2021-02-02,0,0,0,0,2021-02-02,1612220400.0
14394,84,3,2021-02-03,0,0,0,0,2021-02-03,1612306800.0
14395,84,3,2021-02-04,0,0,0,0,2021-02-04,1612393200.0
14396,84,3,2021-02-05,0,0,0,0,2021-02-05,1612479600.0
14397,84,3,2021-02-06,157,0,157,0,2021-02-06,1612566000.0
14398,84,3,2021-02-07,169,0,326,0,2021-02-07,1612652400.0
14399,84,3,2021-02-08,747,0,1073,0,2021-02-08,1612738800.0
14400,84,3,2021-02-09,1696,0,2769,0,2021-02-09,1612825200.0
14401,84,3,2021-02-10,1798,0,4567,0,2021-02-10,1612911600.0
14402,84,3,2021-02-11,2393,0,6960,0,2021-02-11,1612998000.0
14403,84,3,2021-02-12,2103,0,9063,0,2021-02-12,1613084400.0
14404,84,3,2021-02-13,1475,0,10538,0,2021-02-13,1613170800.0
14405,84,3,2021-02-14,320,0,10858,0,2021-02-14,1613257200.0
14406,84,3,2021-02-15,1594,0,12452,0,2021-02-15,1613343600.0
14407,84,3,2021-02-16,1649,0,14101,0,2021-02-16,1613430000.0
14408,84,3,2021-02-17,1517,0,15618,0,2021-02-17,1613516400.0
14409,84,3,2021-02-18,1675,0,17293,0,2021-02-18,1613602800.0
14410,84,3,2021-02-19,1696,0,18989,0,2021-02-19,1613689200.0
14411,84,3,2021-02-20,568,0,19557,0,2021-02-20,1613775600.0
14412,84,3,2021-02-21,29,0,19586,0,2021-02-21,1613862000.0
14413,84,3,2021-02-22,1207,0,20793,0,2021-02-22,1613948400.0
14414,84,3,2021-02-23,1908,0,22701,0,2021-02-23,1614034800.0
14415,84,3,2021-02-24,1678,0,24379,0,2021-02-24,1614121200.0
14416,84,3,2021-02-25,4782,0,29161,0,2021-02-25,1614207600.0
14417,84,3,2021-02-26,8178,0,37339,0,2021-02-26,1614294000.0
14418,84,3,2021-02-27,3814,0,41153,0,2021-02-27,1614380400.0
14419,84,3,2021-02-28,259,0,41412,0,2021-02-28,1614466800.0
14420,84,3,2021-03-01,2928,2,44340,2,2021-03-01,1614553200.0
14421,84,3,2021-03-02,6029,1,50369,3,2021-03-02,1614639600.0
14422,84,3,2021-03-03,6188,1,56557,4,2021-03-03,1614726000.0
14423,84,3,2021-03-04,10561,3,67118,7,2021-03-04,1614812400.0
14424,84,3,2021-03-05,15969,6,83087,13,2021-03-05,1614898800.0
14425,84,3,2021-03-06,13087,6,96174,19,2021-03-06,1614985200.0
14426,84,3,2021-03-07,5236,0,101410,19,2021-03-07,1615071600.0
14427,84,3,2021-03-08,4370,2,105780,21,2021-03-08,1615158000.0
14428,84,3,2021-03-09,9989,3,115769,24,2021-03-09,1615244400.0
14429,84,3,2021-03-10,9282,8,125051,32,2021-03-10,1615330800.0
14430,84,3,2021-03-11,16399,5,141450,37,2021-03-11,1615417200.0
14431,84,3,2021-03-12,24378,6,165828,43,2021-03-12,1615503600.0
14432,84,3,2021-03-13,13800,13,179628,56,2021-03-13,1615590000.0
14433,84,3,2021-03-14,1711,0,181339,56,2021-03-14,1615676400.0
14434,84,3,2021-03-15,6041,7,187380,63,2021-03-15,1615762800.0
14435,84,3,2021-03-16,110,2,187490,65,2021-03-16,1615849200.0
14436,84,3,2021-03-17,92,0,187582,65,2021-03-17,1615935600.0
14437,84,3,2021-03-18,171,1,187753,66,2021-03-18,1616022000.0
14438,84,3,2021-03-19,9010,6,196763,72,2021-03-19,1616108400.0
14439,84,3,2021-03-20,5946,10,202709,82,2021-03-20,1616194800.0
14440,84,3,2021-03-21,455,1,203164,83,2021-03-21,1616281200.0
14441,84,3,2021-03-22,3985,3,207149,86,2021-03-22,1616367600.0
14442,84,3,2021-03-23,10789,7,217938,93,2021-03-23,1616454000.0
14443,84,3,2021-03-24,10191,4,228129,97,2021-03-24,1616540400.0
14444,84,3,2021-03-25,17995,21,246124,118,2021-03-25,1616626800.0
14445,84,3,2021-03-26,20179,19,266303,137,2021-03-26,1616713200.0
14446,84,3,2021-03-27,6171,12,272474,149,2021-03-27,1616799600.0
14447,84,3,2021-03-28,353,14,272827,163,2021-03-28,1616886000.0
14448,84,3,2021-03-29,6777,1,279604,164,2021-03-29,1616972400.0
14449,84,3,2021-03-30,13223,19,292827,183,2021-03-30,1617058800.0
14450,84,3,2021-03-31,7977,11,300804,194,2021-03-31,1617145200.0
14451,84,3,2021-04-01,11703,15,312507,209,2021-04-01,1617231600.0
14452,84,3,2021-04-02,12392,9,324899,218,2021-04-02,1617318000.0
14453,84,3,2021-04-03,3315,13,328214,231,2021-04-03,1617404400.0
14454,84,3,2021-04-04,76,10,328290,241,2021-04-04,1617490800.0
14455,84,3,2021-04-05,253,2,328543,243,2021-04-05,1617577200.0
14456,84,3,2021-04-06,4181,3,332724,246,2021-04-06,1617663600.0
14457,84,3,2021-04-07,3942,3,336666,249,2021-04-07,1617750000.0
14458,84,3,2021-04-08,10689,51,347355,300,2021-04-08,1617836400.0
14459,84,3,2021-04-09,20905,59,368260,359,2021-04-09,1617922800.0
14460,84,3,2021-04-10,6580,61,374840,420,2021-04-10,1618009200.0
14461,84,3,2021-04-11,397,18,375237,438,2021-04-11,1618095600.0
14462,84,3,2021-04-12,5600,23,380837,461,2021-04-12,1618185600.0
14463,84,3,2021-04-13,10097,70,390934,531,2021-04-13,1618272000.0
14464,84,3,2021-04-14,7380,24,398314,555,2021-04-14,1618358400.0
14465,84,3,2021-04-15,10684,29,408998,584,2021-04-15,1618444800.0
14466,84,3,2021-04-16,12334,83,421332,667,2021-04-16,1618531200.0
14467,84,3,2021-04-17,4213,78,425545,745,2021-04-17,1618617600.0
14468,84,3,2021-04-18,337,1,425882,746,2021-04-18,1618704000.0
14469,84,3,2021-04-19,3070,34,428952,780,2021-04-19,1618790400.0
14470,84,3,2021-04-20,5447,71,434399,851,2021-04-20,1618876800.0
14471,84,3,2021-04-21,4039,35,438438,886,2021-04-21,1618963200.0
14472,84,3,2021-04-22,5736,115,444174,1001,2021-04-22,1619049600.0
14473,84,3,2021-04-23,7571,148,451745,1149,2021-04-23,1619136000.0
14474,84,3,2021-04-24,2904,107,454649,1256,2021-04-24,1619222400.0
14475,84,3,2021-04-25,106,8,454755,1264,2021-04-25,1619308800.0
14476,84,3,2021-04-26,1924,118,456679,1382,2021-04-26,1619395200.0
14477,84,3,2021-04-27,4296,169,460975,1551,2021-04-27,1619481600.0
14478,84,3,2021-04-28,2890,161,463865,1712,2021-04-28,1619568000.0
14479,84,3,2021-04-29,4893,744,468758,2456,2021-04-29,1619654400.0
14480,84,3,2021-04-30,6238,1203,474996,3659,2021-04-30,1619740800.0
14481,84,3,2021-05-01,722,192,475718,3851,2021-05-01,1619827200.0
14482,84,3,2021-05-02,94,34,475812,3885,2021-05-02,1619913600.0
14483,84,3,2021-05-03,1337,533,477149,4418,2021-05-03,1620000000.0
14484,84,3,2021-05-04,2738,1308,479887,5726,2021-05-04,1620086400.0
14485,84,3,2021-05-05,2143,1266,482030,6992,2021-05-05,1620172800.0
14486,84,3,2021-05-06,3212,2526,485242,9518,2021-05-06,1620259200.0
14487,84,3,2021-05-07,4648,3871,489890,13389,2021-05-07,1620345600.0
14488,84,3,2021-05-08,520,804,490410,14193,2021-05-08,1620432000.0
14489,84,3,2021-05-09,103,137,490513,14330,2021-05-09,1620518400.0
14490,84,3,2021-05-10,1354,1829,491867,16159,2021-05-10,1620604800.0
14491,84,3,2021-05-11,2580,3399,494447,19558,2021-05-11,1620691200.0
14492,84,3,2021-05-12,1686,3507,496133,23065,2021-05-12,1620777600.0
14493,84,3,2021-05-13,154,182,496287,23247,2021-05-13,1620864000.0
14494,84,3,2021-05-14,1067,2583,497354,25830,2021-05-14,1620950400.0
14495,84,3,2021-05-15,485,1699,497839,27529,2021-05-15,1621036800.0
14496,84,3,2021-05-16,53,195,497892,27724,2021-05-16,1621123200.0
14497,84,3,2021-05-17,811,2760,498703,30484,2021-05-17,1621206000.0
14498,84,3,2021-05-18,1224,4107,499927,34591,2021-05-18,1621292400.0
14499,84,3,2021-05-19,734,3688,500661,38279,2021-05-19,1621378800.0
14500,84,3,2021-05-20,1157,6647,501818,44926,2021-05-20,1621465200.0
14501,84,3,2021-05-21,993,8433,502811,53359,2021-05-21,1621551600.0
14502,84,3,2021-05-22,346,3223,503157,56582,2021-05-22,1621638000.0
14503,84,3,2021-05-23,7,62,503164,56644,2021-05-23,1621724400.0
14504,84,3,2021-05-24,31,323,503195,56967,2021-05-24,1621810800.0
14505,84,3,2021-05-25,478,6333,503673,63300,2021-05-25,1621897200.0
14506,84,3,2021-05-26,406,6067,504079,69367,2021-05-26,1621983600.0
14507,84,3,2021-05-27,560,9585,504639,78952,2021-05-27,1622070000.0
14508,84,3,2021-05-28,706,13367,505345,92319,2021-05-28,1622156400.0
14509,84,3,2021-05-29,284,6401,505629,98720,2021-05-29,1622242800.0
14510,84,3,2021-05-30,30,677,505659,99397,2021-05-30,1622329200.0
14511,84,3,2021-05-31,195,4177,505854,103574,2021-05-31,1622415600.0
14512,84,3,2021-06-01,344,8419,506198,111993,2021-06-01,1622502000.0
14513,84,3,2021-06-02,210,6881,506408,118874,2021-06-02,1622588400.0
14514,84,3,2021-06-03,310,11330,506718,130204,2021-06-03,1622674800.0
14515,84,3,2021-06-04,413,13729,507131,143933,2021-06-04,1622761200.0
14516,84,3,2021-06-05,158,4289,507289,148222,2021-06-05,1622847600.0
14517,84,3,2021-06-06,7,277,507296,148499,2021-06-06,1622934000.0
14518,84,3,2021-06-07,92,3819,507388,152318,2021-06-07,1623020400.0
14519,84,3,2021-06-08,199,6498,507587,158816,2021-06-08,1623106800.0
14520,84,3,2021-06-09,152,5240,507739,164056,2021-06-09,1623193200.0
14521,84,3,2021-06-10,180,8168,507919,172224,2021-06-10,1623279600.0
14522,84,3,2021-06-11,225,12517,508144,184741,2021-06-11,1623366000.0
14523,84,3,2021-06-12,57,3295,508201,188036,2021-06-12,1623452400.0
14524,84,3,2021-06-13,3,247,508204,188283,2021-06-13,1623538800.0
14525,84,3,2021-06-14,75,4681,508279,192964,2021-06-14,1623625200.0
14526,84,3,2021-06-15,122,9777,508401,202741,2021-06-15,1623711600.0
14527,84,3,2021-06-16,103,6969,508504,209710,2021-06-16,1623798000.0
14528,84,3,2021-06-17,133,12274,508637,221984,2021-06-17,1623884400.0
14529,84,3,2021-06-18,192,14128,508829,236112,2021-06-18,1623970800.0
14530,84,3,2021-06-19,89,3645,508918,239757,2021-06-19,1624057200.0
14531,84,3,2021-06-20,3,179,508921,239936,2021-06-20,1624143600.0
14532,84,3,2021-06-21,50,4694,508971,244630,2021-06-21,1624230000.0
14533,84,3,2021-06-22,87,9055,509058,253685,2021-06-22,1624316400.0
14534,84,3,2021-06-23,76,5618,509134,259303,2021-06-23,1624402800.0
14535,84,3,2021-06-24,120,9823,509254,269126,2021-06-24,1624489200.0
14536,84,3,2021-06-25,123,11018,509377,280144,2021-06-25,1624575600.0
14537,84,3,2021-06-26,42,2601,509419,282745,2021-06-26,1624662000.0
14538,84,3,2021-06-27,4,251,509423,282996,2021-06-27,1624748400.0
14539,84,3,2021-06-28,35,3257,509458,286253,2021-06-28,1624834800.0
14540,84,3,2021-06-29,81,6426,509539,292679,2021-06-29,1624921200.0
14541,84,3,2021-06-30,64,4795,509603,297474,2021-06-30,1625007600.0
14542,84,3,2021-07-01,91,7968,509694,305442,2021-07-01,1625094000.0
14543,84,3,2021-07-02,137,10324,509831,315766,2021-07-02,1625180400.0
14544,84,3,2021-07-03,37,2305,509868,318071,2021-07-03,1625266800.0
14545,84,3,2021-07-04,4,257,509872,318328,2021-07-04,1625353200.0
14546,84,3,2021-07-05,39,3549,509911,321877,2021-07-05,1625439600.0
14547,84,3,2021-07-06,100,6467,510011,328344,2021-07-06,1625526000.0
14548,84,3,2021-07-07,76,4525,510087,332869,2021-07-07,1625612400.0
14549,84,3,2021-07-08,112,6666,510199,339535,2021-07-08,1625698800.0
14550,84,4,2020-12-27,0,0,0,0,2020-12-27,1609023600.0
14551,84,4,2020-12-28,0,0,0,0,2020-12-28,1609110000.0
14552,84,4,2020-12-29,0,0,0,0,2020-12-29,1609196400.0
14553,84,4,2020-12-30,0,0,0,0,2020-12-30,1609282800.0
14554,84,4,2020-12-31,0,0,0,0,2020-12-31,1609369200.0
14555,84,4,2021-01-01,0,0,0,0,2021-01-01,1609455600.0
14556,84,4,2021-01-02,0,0,0,0,2021-01-02,1609542000.0
14557,84,4,2021-01-03,0,0,0,0,2021-01-03,1609628400.0
14558,84,4,2021-01-04,0,0,0,0,2021-01-04,1609714800.0
14559,84,4,2021-01-05,0,0,0,0,2021-01-05,1609801200.0
14560,84,4,2021-01-06,0,0,0,0,2021-01-06,1609887600.0
14561,84,4,2021-01-07,0,0,0,0,2021-01-07,1609974000.0
14562,84,4,2021-01-08,0,0,0,0,2021-01-08,1610060400.0
14563,84,4,2021-01-09,0,0,0,0,2021-01-09,1610146800.0
14564,84,4,2021-01-10,0,0,0,0,2021-01-10,1610233200.0
14565,84,4,2021-01-11,0,0,0,0,2021-01-11,1610319600.0
14566,84,4,2021-01-12,0,0,0,0,2021-01-12,1610406000.0
14567,84,4,2021-01-13,0,0,0,0,2021-01-13,1610492400.0
14568,84,4,2021-01-14,0,0,0,0,2021-01-14,1610578800.0
14569,84,4,2021-01-15,0,0,0,0,2021-01-15,1610665200.0
14570,84,4,2021-01-16,0,0,0,0,2021-01-16,1610751600.0
14571,84,4,2021-01-17,0,0,0,0,2021-01-17,1610838000.0
14572,84,4,2021-01-18,0,0,0,0,2021-01-18,1610924400.0
14573,84,4,2021-01-19,0,0,0,0,2021-01-19,1611010800.0
14574,84,4,2021-01-20,0,0,0,0,2021-01-20,1611097200.0
14575,84,4,2021-01-21,0,0,0,0,2021-01-21,1611183600.0
14576,84,4,2021-01-22,0,0,0,0,2021-01-22,1611270000.0
14577,84,4,2021-01-23,0,0,0,0,2021-01-23,1611356400.0
14578,84,4,2021-01-24,0,0,0,0,2021-01-24,1611442800.0
14579,84,4,2021-01-25,0,0,0,0,2021-01-25,1611529200.0
14580,84,4,2021-01-26,0,0,0,0,2021-01-26,1611615600.0
14581,84,4,2021-01-27,0,0,0,0,2021-01-27,1611702000.0
14582,84,4,2021-01-28,0,0,0,0,2021-01-28,1611788400.0
14583,84,4,2021-01-29,0,0,0,0,2021-01-29,1611874800.0
14584,84,4,2021-01-30,0,0,0,0,2021-01-30,1611961200.0
14585,84,4,2021-01-31,0,0,0,0,2021-01-31,1612047600.0
14586,84,4,2021-02-01,0,0,0,0,2021-02-01,1612134000.0
14587,84,4,2021-02-02,0,0,0,0,2021-02-02,1612220400.0
14588,84,4,2021-02-03,0,0,0,0,2021-02-03,1612306800.0
14589,84,4,2021-02-04,0,0,0,0,2021-02-04,1612393200.0
14590,84,4,2021-02-05,0,0,0,0,2021-02-05,1612479600.0
14591,84,4,2021-02-06,0,0,0,0,2021-02-06,1612566000.0
14592,84,4,2021-02-07,0,0,0,0,2021-02-07,1612652400.0
14593,84,4,2021-02-08,0,0,0,0,2021-02-08,1612738800.0
14594,84,4,2021-02-09,0,0,0,0,2021-02-09,1612825200.0
14595,84,4,2021-02-10,0,0,0,0,2021-02-10,1612911600.0
14596,84,4,2021-02-11,0,0,0,0,2021-02-11,1612998000.0
14597,84,4,2021-02-12,0,0,0,0,2021-02-12,1613084400.0
14598,84,4,2021-02-13,0,0,0,0,2021-02-13,1613170800.0
14599,84,4,2021-02-14,0,0,0,0,2021-02-14,1613257200.0
14600,84,4,2021-02-15,0,0,0,0,2021-02-15,1613343600.0
14601,84,4,2021-02-16,0,0,0,0,2021-02-16,1613430000.0
14602,84,4,2021-02-17,0,0,0,0,2021-02-17,1613516400.0
14603,84,4,2021-02-18,0,0,0,0,2021-02-18,1613602800.0
14604,84,4,2021-02-19,0,0,0,0,2021-02-19,1613689200.0
14605,84,4,2021-02-20,0,0,0,0,2021-02-20,1613775600.0
14606,84,4,2021-02-21,0,0,0,0,2021-02-21,1613862000.0
14607,84,4,2021-02-22,0,0,0,0,2021-02-22,1613948400.0
14608,84,4,2021-02-23,0,0,0,0,2021-02-23,1614034800.0
14609,84,4,2021-02-24,0,0,0,0,2021-02-24,1614121200.0
14610,84,4,2021-02-25,0,0,0,0,2021-02-25,1614207600.0
14611,84,4,2021-02-26,0,0,0,0,2021-02-26,1614294000.0
14612,84,4,2021-02-27,0,0,0,0,2021-02-27,1614380400.0
14613,84,4,2021-02-28,0,0,0,0,2021-02-28,1614466800.0
14614,84,4,2021-03-01,0,0,0,0,2021-03-01,1614553200.0
14615,84,4,2021-03-02,0,0,0,0,2021-03-02,1614639600.0
14616,84,4,2021-03-03,0,0,0,0,2021-03-03,1614726000.0
14617,84,4,2021-03-04,0,0,0,0,2021-03-04,1614812400.0
14618,84,4,2021-03-05,0,0,0,0,2021-03-05,1614898800.0
14619,84,4,2021-03-06,0,0,0,0,2021-03-06,1614985200.0
14620,84,4,2021-03-07,0,0,0,0,2021-03-07,1615071600.0
14621,84,4,2021-03-08,0,0,0,0,2021-03-08,1615158000.0
14622,84,4,2021-03-09,0,0,0,0,2021-03-09,1615244400.0
14623,84,4,2021-03-10,0,0,0,0,2021-03-10,1615330800.0
14624,84,4,2021-03-11,0,0,0,0,2021-03-11,1615417200.0
14625,84,4,2021-03-12,0,0,0,0,2021-03-12,1615503600.0
14626,84,4,2021-03-13,0,0,0,0,2021-03-13,1615590000.0
14627,84,4,2021-03-14,0,0,0,0,2021-03-14,1615676400.0
14628,84,4,2021-03-15,0,0,0,0,2021-03-15,1615762800.0
14629,84,4,2021-03-16,0,0,0,0,2021-03-16,1615849200.0
14630,84,4,2021-03-17,0,0,0,0,2021-03-17,1615935600.0
14631,84,4,2021-03-18,0,0,0,0,2021-03-18,1616022000.0
14632,84,4,2021-03-19,0,0,0,0,2021-03-19,1616108400.0
14633,84,4,2021-03-20,0,0,0,0,2021-03-20,1616194800.0
14634,84,4,2021-03-21,0,0,0,0,2021-03-21,1616281200.0
14635,84,4,2021-03-22,0,0,0,0,2021-03-22,1616367600.0
14636,84,4,2021-03-23,0,0,0,0,2021-03-23,1616454000.0
14637,84,4,2021-03-24,0,0,0,0,2021-03-24,1616540400.0
14638,84,4,2021-03-25,0,0,0,0,2021-03-25,1616626800.0
14639,84,4,2021-03-26,0,0,0,0,2021-03-26,1616713200.0
14640,84,4,2021-03-27,0,0,0,0,2021-03-27,1616799600.0
14641,84,4,2021-03-28,0,0,0,0,2021-03-28,1616886000.0
14642,84,4,2021-03-29,0,0,0,0,2021-03-29,1616972400.0
14643,84,4,2021-03-30,0,0,0,0,2021-03-30,1617058800.0
14644,84,4,2021-03-31,0,0,0,0,2021-03-31,1617145200.0
14645,84,4,2021-04-01,0,0,0,0,2021-04-01,1617231600.0
14646,84,4,2021-04-02,0,0,0,0,2021-04-02,1617318000.0
14647,84,4,2021-04-03,0,0,0,0,2021-04-03,1617404400.0
14648,84,4,2021-04-04,0,0,0,0,2021-04-04,1617490800.0
14649,84,4,2021-04-05,0,0,0,0,2021-04-05,1617577200.0
14650,84,4,2021-04-06,0,0,0,0,2021-04-06,1617663600.0
14651,84,4,2021-04-07,0,0,0,0,2021-04-07,1617750000.0
14652,84,4,2021-04-08,0,0,0,0,2021-04-08,1617836400.0
14653,84,4,2021-04-09,0,0,0,0,2021-04-09,1617922800.0
14654,84,4,2021-04-10,0,0,0,0,2021-04-10,1618009200.0
14655,84,4,2021-04-11,0,0,0,0,2021-04-11,1618095600.0
14656,84,4,2021-04-12,0,0,0,0,2021-04-12,1618185600.0
14657,84,4,2021-04-13,0,0,0,0,2021-04-13,1618272000.0
14658,84,4,2021-04-14,0,0,0,0,2021-04-14,1618358400.0
14659,84,4,2021-04-15,0,0,0,0,2021-04-15,1618444800.0
14660,84,4,2021-04-16,0,0,0,0,2021-04-16,1618531200.0
14661,84,4,2021-04-17,0,0,0,0,2021-04-17,1618617600.0
14662,84,4,2021-04-18,0,0,0,0,2021-04-18,1618704000.0
14663,84,4,2021-04-19,0,0,0,0,2021-04-19,1618790400.0
14664,84,4,2021-04-20,0,0,0,0,2021-04-20,1618876800.0
14665,84,4,2021-04-21,0,0,0,0,2021-04-21,1618963200.0
14666,84,4,2021-04-22,0,0,0,0,2021-04-22,1619049600.0
14667,84,4,2021-04-23,93,0,93,0,2021-04-23,1619136000.0
14668,84,4,2021-04-24,80,0,173,0,2021-04-24,1619222400.0
14669,84,4,2021-04-25,0,0,173,0,2021-04-25,1619308800.0
14670,84,4,2021-04-26,245,0,418,0,2021-04-26,1619395200.0
14671,84,4,2021-04-27,1042,0,1460,0,2021-04-27,1619481600.0
14672,84,4,2021-04-28,1053,0,2513,0,2021-04-28,1619568000.0
14673,84,4,2021-04-29,1777,2,4290,2,2021-04-29,1619654400.0
14674,84,4,2021-04-30,2492,2,6782,4,2021-04-30,1619740800.0
14675,84,4,2021-05-01,112,0,6894,4,2021-05-01,1619827200.0
14676,84,4,2021-05-02,28,0,6922,4,2021-05-02,1619913600.0
14677,84,4,2021-05-03,606,1,7528,5,2021-05-03,1620000000.0
14678,84,4,2021-05-04,1181,3,8709,8,2021-05-04,1620086400.0
14679,84,4,2021-05-05,678,0,9387,8,2021-05-05,1620172800.0
14680,84,4,2021-05-06,1425,1,10812,9,2021-05-06,1620259200.0
14681,84,4,2021-05-07,2181,1,12993,10,2021-05-07,1620345600.0
14682,84,4,2021-05-08,237,1,13230,11,2021-05-08,1620432000.0
14683,84,4,2021-05-09,56,0,13286,11,2021-05-09,1620518400.0
14684,84,4,2021-05-10,833,1,14119,12,2021-05-10,1620604800.0
14685,84,4,2021-05-11,1773,1,15892,13,2021-05-11,1620691200.0
14686,84,4,2021-05-12,997,1,16889,14,2021-05-12,1620777600.0
14687,84,4,2021-05-13,120,0,17009,14,2021-05-13,1620864000.0
14688,84,4,2021-05-14,741,1,17750,15,2021-05-14,1620950400.0
14689,84,4,2021-05-15,182,0,17932,15,2021-05-15,1621036800.0
14690,84,4,2021-05-16,24,0,17956,15,2021-05-16,1621123200.0
14691,84,4,2021-05-17,398,0,18354,15,2021-05-17,1621206000.0
14692,84,4,2021-05-18,871,1,19225,16,2021-05-18,1621292400.0
14693,84,4,2021-05-19,571,0,19796,16,2021-05-19,1621378800.0
14694,84,4,2021-05-20,873,0,20669,16,2021-05-20,1621465200.0
14695,84,4,2021-05-21,1186,7,21855,23,2021-05-21,1621551600.0
14696,84,4,2021-05-22,363,3,22218,26,2021-05-22,1621638000.0
14697,84,4,2021-05-23,20,0,22238,26,2021-05-23,1621724400.0
14698,84,4,2021-05-24,69,0,22307,26,2021-05-24,1621810800.0
14699,84,4,2021-05-25,770,1,23077,27,2021-05-25,1621897200.0
14700,84,4,2021-05-26,790,1,23867,28,2021-05-26,1621983600.0
14701,84,4,2021-05-27,1267,3,25134,31,2021-05-27,1622070000.0
14702,84,4,2021-05-28,2703,10,27837,41,2021-05-28,1622156400.0
14703,84,4,2021-05-29,823,1,28660,42,2021-05-29,1622242800.0
14704,84,4,2021-05-30,66,0,28726,42,2021-05-30,1622329200.0
14705,84,4,2021-05-31,1332,7,30058,49,2021-05-31,1622415600.0
14706,84,4,2021-06-01,2400,4,32458,53,2021-06-01,1622502000.0
14707,84,4,2021-06-02,1495,0,33953,53,2021-06-02,1622588400.0
14708,84,4,2021-06-03,2174,7,36127,60,2021-06-03,1622674800.0
14709,84,4,2021-06-04,2300,11,38427,71,2021-06-04,1622761200.0
14710,84,4,2021-06-05,672,4,39099,75,2021-06-05,1622847600.0
14711,84,4,2021-06-06,52,0,39151,75,2021-06-06,1622934000.0
14712,84,4,2021-06-07,910,1,40061,76,2021-06-07,1623020400.0
14713,84,4,2021-06-08,1485,1,41546,77,2021-06-08,1623106800.0
14714,84,4,2021-06-09,1149,2,42695,79,2021-06-09,1623193200.0
14715,84,4,2021-06-10,1457,3,44152,82,2021-06-10,1623279600.0
14716,84,4,2021-06-11,1519,6,45671,88,2021-06-11,1623366000.0
14717,84,4,2021-06-12,536,4,46207,92,2021-06-12,1623452400.0
14718,84,4,2021-06-13,40,0,46247,92,2021-06-13,1623538800.0
14719,84,4,2021-06-14,511,4,46758,96,2021-06-14,1623625200.0
14720,84,4,2021-06-15,963,3,47721,99,2021-06-15,1623711600.0
14721,84,4,2021-06-16,748,2,48469,101,2021-06-16,1623798000.0
14722,84,4,2021-06-17,1013,2,49482,103,2021-06-17,1623884400.0
14723,84,4,2021-06-18,1154,12,50636,115,2021-06-18,1623970800.0
14724,84,4,2021-06-19,364,2,51000,117,2021-06-19,1624057200.0
14725,84,4,2021-06-20,31,0,51031,117,2021-06-20,1624143600.0
14726,84,4,2021-06-21,451,1,51482,118,2021-06-21,1624230000.0
14727,84,4,2021-06-22,736,1,52218,119,2021-06-22,1624316400.0
14728,84,4,2021-06-23,675,3,52893,122,2021-06-23,1624402800.0
14729,84,4,2021-06-24,766,0,53659,122,2021-06-24,1624489200.0
14730,84,4,2021-06-25,1074,10,54733,132,2021-06-25,1624575600.0
14731,84,4,2021-06-26,317,3,55050,135,2021-06-26,1624662000.0
14732,84,4,2021-06-27,27,0,55077,135,2021-06-27,1624748400.0
14733,84,4,2021-06-28,396,1,55473,136,2021-06-28,1624834800.0
14734,84,4,2021-06-29,645,0,56118,136,2021-06-29,1624921200.0
14735,84,4,2021-06-30,498,2,56616,138,2021-06-30,1625007600.0
14736,84,4,2021-07-01,740,0,57356,138,2021-07-01,1625094000.0
14737,84,4,2021-07-02,881,1,58237,139,2021-07-02,1625180400.0
14738,84,4,2021-07-03,327,2,58564,141,2021-07-03,1625266800.0
14739,84,4,2021-07-04,16,0,58580,141,2021-07-04,1625353200.0
14740,84,4,2021-07-05,421,0,59001,141,2021-07-05,1625439600.0
14741,84,4,2021-07-06,685,3,59686,144,2021-07-06,1625526000.0
14742,84,4,2021-07-07,654,3,60340,147,2021-07-07,1625612400.0
14743,84,4,2021-07-08,836,12,61176,159,2021-07-08,1625698800.0
14744,93,1,2020-12-27,1,0,1,0,2020-12-27,1609023600.0
14745,93,1,2020-12-28,2,0,3,0,2020-12-28,1609110000.0
14746,93,1,2020-12-29,1,0,4,0,2020-12-29,1609196400.0
14747,93,1,2020-12-30,3,0,7,0,2020-12-30,1609282800.0
14748,93,1,2020-12-31,19,0,26,0,2020-12-31,1609369200.0
14749,93,1,2021-01-01,13,0,39,0,2021-01-01,1609455600.0
14750,93,1,2021-01-02,5,0,44,0,2021-01-02,1609542000.0
14751,93,1,2021-01-03,3,0,47,0,2021-01-03,1609628400.0
14752,93,1,2021-01-04,133,0,180,0,2021-01-04,1609714800.0
14753,93,1,2021-01-05,252,0,432,0,2021-01-05,1609801200.0
14754,93,1,2021-01-06,412,0,844,0,2021-01-06,1609887600.0
14755,93,1,2021-01-07,1245,0,2089,0,2021-01-07,1609974000.0
14756,93,1,2021-01-08,1566,0,3655,0,2021-01-08,1610060400.0
14757,93,1,2021-01-09,543,0,4198,0,2021-01-09,1610146800.0
14758,93,1,2021-01-10,74,0,4272,0,2021-01-10,1610233200.0
14759,93,1,2021-01-11,2414,0,6686,0,2021-01-11,1610319600.0
14760,93,1,2021-01-12,5097,0,11783,0,2021-01-12,1610406000.0
14761,93,1,2021-01-13,4476,0,16259,0,2021-01-13,1610492400.0
14762,93,1,2021-01-14,5566,0,21825,0,2021-01-14,1610578800.0
14763,93,1,2021-01-15,4939,0,26764,0,2021-01-15,1610665200.0
14764,93,1,2021-01-16,1660,2,28424,2,2021-01-16,1610751600.0
14765,93,1,2021-01-17,303,1,28727,3,2021-01-17,1610838000.0
14766,93,1,2021-01-18,6732,22,35459,25,2021-01-18,1610924400.0
14767,93,1,2021-01-19,12313,14,47772,39,2021-01-19,1611010800.0
14768,93,1,2021-01-20,11124,13,58896,52,2021-01-20,1611097200.0
14769,93,1,2021-01-21,11144,19,70040,71,2021-01-21,1611183600.0
14770,93,1,2021-01-22,9136,8,79176,79,2021-01-22,1611270000.0
14771,93,1,2021-01-23,3046,1,82222,80,2021-01-23,1611356400.0
14772,93,1,2021-01-24,489,0,82711,80,2021-01-24,1611442800.0
14773,93,1,2021-01-25,6454,17,89165,97,2021-01-25,1611529200.0
14774,93,1,2021-01-26,9158,114,98323,211,2021-01-26,1611615600.0
14775,93,1,2021-01-27,9055,267,107378,478,2021-01-27,1611702000.0
14776,93,1,2021-01-28,13126,776,120504,1254,2021-01-28,1611788400.0
14777,93,1,2021-01-29,9404,942,129908,2196,2021-01-29,1611874800.0
14778,93,1,2021-01-30,2165,151,132073,2347,2021-01-30,1611961200.0
14779,93,1,2021-01-31,304,5,132377,2352,2021-01-31,1612047600.0
14780,93,1,2021-02-01,4655,1505,137032,3857,2021-02-01,1612134000.0
14781,93,1,2021-02-02,5868,2356,142900,6213,2021-02-02,1612220400.0
14782,93,1,2021-02-03,4190,1803,147090,8016,2021-02-03,1612306800.0
14783,93,1,2021-02-04,4699,3150,151789,11166,2021-02-04,1612393200.0
14784,93,1,2021-02-05,5403,4105,157192,15271,2021-02-05,1612479600.0
14785,93,1,2021-02-06,1031,968,158223,16239,2021-02-06,1612566000.0
14786,93,1,2021-02-07,279,81,158502,16320,2021-02-07,1612652400.0
14787,93,1,2021-02-08,3486,3727,161988,20047,2021-02-08,1612738800.0
14788,93,1,2021-02-09,5074,7078,167062,27125,2021-02-09,1612825200.0
14789,93,1,2021-02-10,5119,5836,172181,32961,2021-02-10,1612911600.0
14790,93,1,2021-02-11,5676,6674,177857,39635,2021-02-11,1612998000.0
14791,93,1,2021-02-12,4773,6436,182630,46071,2021-02-12,1613084400.0
14792,93,1,2021-02-13,901,1424,183531,47495,2021-02-13,1613170800.0
14793,93,1,2021-02-14,73,384,183604,47879,2021-02-14,1613257200.0
14794,93,1,2021-02-15,1617,5186,185221,53065,2021-02-15,1613343600.0
14795,93,1,2021-02-16,2470,6859,187691,59924,2021-02-16,1613430000.0
14796,93,1,2021-02-17,2641,7651,190332,67575,2021-02-17,1613516400.0
14797,93,1,2021-02-18,4570,10269,194902,77844,2021-02-18,1613602800.0
14798,93,1,2021-02-19,4194,7604,199096,85448,2021-02-19,1613689200.0
14799,93,1,2021-02-20,581,1444,199677,86892,2021-02-20,1613775600.0
14800,93,1,2021-02-21,68,416,199745,87308,2021-02-21,1613862000.0
14801,93,1,2021-02-22,1768,6113,201513,93421,2021-02-22,1613948400.0
14802,93,1,2021-02-23,2787,6397,204300,99818,2021-02-23,1614034800.0
14803,93,1,2021-02-24,3394,6115,207694,105933,2021-02-24,1614121200.0
14804,93,1,2021-02-25,5444,6014,213138,111947,2021-02-25,1614207600.0
14805,93,1,2021-02-26,4640,5580,217778,117527,2021-02-26,1614294000.0
14806,93,1,2021-02-27,1046,1385,218824,118912,2021-02-27,1614380400.0
14807,93,1,2021-02-28,134,236,218958,119148,2021-02-28,1614466800.0
14808,93,1,2021-03-01,3510,3761,222468,122909,2021-03-01,1614553200.0
14809,93,1,2021-03-02,4579,5068,227047,127977,2021-03-02,1614639600.0
14810,93,1,2021-03-03,5516,5598,232563,133575,2021-03-03,1614726000.0
14811,93,1,2021-03-04,6977,5495,239540,139070,2021-03-04,1614812400.0
14812,93,1,2021-03-05,6010,5173,245550,144243,2021-03-05,1614898800.0
14813,93,1,2021-03-06,8558,873,254108,145116,2021-03-06,1614985200.0
14814,93,1,2021-03-07,7283,430,261391,145546,2021-03-07,1615071600.0
14815,93,1,2021-03-08,6086,4385,267477,149931,2021-03-08,1615158000.0
14816,93,1,2021-03-09,7583,4681,275060,154612,2021-03-09,1615244400.0
14817,93,1,2021-03-10,7538,4346,282598,158958,2021-03-10,1615330800.0
14818,93,1,2021-03-11,9380,5034,291978,163992,2021-03-11,1615417200.0
14819,93,1,2021-03-12,9863,4216,301841,168208,2021-03-12,1615503600.0
14820,93,1,2021-03-13,15302,790,317143,168998,2021-03-13,1615590000.0
14821,93,1,2021-03-14,4874,204,322017,169202,2021-03-14,1615676400.0
14822,93,1,2021-03-15,9916,2382,331933,171584,2021-03-15,1615762800.0
14823,93,1,2021-03-16,10896,2981,342829,174565,2021-03-16,1615849200.0
14824,93,1,2021-03-17,12358,3674,355187,178239,2021-03-17,1615935600.0
14825,93,1,2021-03-18,15031,3561,370218,181800,2021-03-18,1616022000.0
14826,93,1,2021-03-19,13866,3320,384084,185120,2021-03-19,1616108400.0
14827,93,1,2021-03-20,6228,934,390312,186054,2021-03-20,1616194800.0
14828,93,1,2021-03-21,2323,81,392635,186135,2021-03-21,1616281200.0
14829,93,1,2021-03-22,11256,2881,403891,189016,2021-03-22,1616367600.0
14830,93,1,2021-03-23,14066,3001,417957,192017,2021-03-23,1616454000.0
14831,93,1,2021-03-24,13722,4711,431679,196728,2021-03-24,1616540400.0
14832,93,1,2021-03-25,16926,5308,448605,202036,2021-03-25,1616626800.0
14833,93,1,2021-03-26,16725,4000,465330,206036,2021-03-26,1616713200.0
14834,93,1,2021-03-27,7128,1199,472458,207235,2021-03-27,1616799600.0
14835,93,1,2021-03-28,2731,49,475189,207284,2021-03-28,1616886000.0
14836,93,1,2021-03-29,12672,4210,487861,211494,2021-03-29,1616972400.0
14837,93,1,2021-03-30,19846,5582,507707,217076,2021-03-30,1617058800.0
14838,93,1,2021-03-31,20348,5511,528055,222587,2021-03-31,1617145200.0
14839,93,1,2021-04-01,20377,6150,548432,228737,2021-04-01,1617231600.0
14840,93,1,2021-04-02,16526,7323,564958,236060,2021-04-02,1617318000.0
14841,93,1,2021-04-03,6651,4650,571609,240710,2021-04-03,1617404400.0
14842,93,1,2021-04-04,1619,1206,573228,241916,2021-04-04,1617490800.0
14843,93,1,2021-04-05,4321,1329,577549,243245,2021-04-05,1617577200.0
14844,93,1,2021-04-06,18074,8946,595623,252191,2021-04-06,1617663600.0
14845,93,1,2021-04-07,22119,10563,617742,262754,2021-04-07,1617750000.0
14846,93,1,2021-04-08,22402,13566,640144,276320,2021-04-08,1617836400.0
14847,93,1,2021-04-09,24330,12352,664474,288672,2021-04-09,1617922800.0
14848,93,1,2021-04-10,11187,7448,675661,296120,2021-04-10,1618009200.0
14849,93,1,2021-04-11,3147,2762,678808,298882,2021-04-11,1618095600.0
14850,93,1,2021-04-12,15989,10679,694797,309561,2021-04-12,1618185600.0
14851,93,1,2021-04-13,19182,12408,713979,321969,2021-04-13,1618272000.0
14852,93,1,2021-04-14,20004,13443,733983,335412,2021-04-14,1618358400.0
14853,93,1,2021-04-15,20080,13139,754063,348551,2021-04-15,1618444800.0
14854,93,1,2021-04-16,20670,13595,774733,362146,2021-04-16,1618531200.0
14855,93,1,2021-04-17,9901,6380,784634,368526,2021-04-17,1618617600.0
14856,93,1,2021-04-18,4640,2400,789274,370926,2021-04-18,1618704000.0
14857,93,1,2021-04-19,16283,13602,805557,384528,2021-04-19,1618790400.0
14858,93,1,2021-04-20,17729,16290,823286,400818,2021-04-20,1618876800.0
14859,93,1,2021-04-21,18601,16045,841887,416863,2021-04-21,1618963200.0
14860,93,1,2021-04-22,21897,16665,863784,433528,2021-04-22,1619049600.0
14861,93,1,2021-04-23,21629,15116,885413,448644,2021-04-23,1619136000.0
14862,93,1,2021-04-24,9952,6922,895365,455566,2021-04-24,1619222400.0
14863,93,1,2021-04-25,2845,1785,898210,457351,2021-04-25,1619308800.0
14864,93,1,2021-04-26,14334,13611,912544,470962,2021-04-26,1619395200.0
14865,93,1,2021-04-27,16248,16582,928792,487544,2021-04-27,1619481600.0
14866,93,1,2021-04-28,17185,15982,945977,503526,2021-04-28,1619568000.0
14867,93,1,2021-04-29,22093,16162,968070,519688,2021-04-29,1619654400.0
14868,93,1,2021-04-30,21928,14048,989998,533736,2021-04-30,1619740800.0
14869,93,1,2021-05-01,10600,3836,1000598,537572,2021-05-01,1619827200.0
14870,93,1,2021-05-02,3734,1499,1004332,539071,2021-05-02,1619913600.0
14871,93,1,2021-05-03,16664,14733,1020996,553804,2021-05-03,1620000000.0
14872,93,1,2021-05-04,17341,17781,1038337,571585,2021-05-04,1620086400.0
14873,93,1,2021-05-05,16353,17719,1054690,589304,2021-05-05,1620172800.0
14874,93,1,2021-05-06,20615,16432,1075305,605736,2021-05-06,1620259200.0
14875,93,1,2021-05-07,16432,18457,1091737,624193,2021-05-07,1620345600.0
14876,93,1,2021-05-08,12105,5093,1103842,629286,2021-05-08,1620432000.0
14877,93,1,2021-05-09,3075,1692,1106917,630978,2021-05-09,1620518400.0
14878,93,1,2021-05-10,15339,17582,1122256,648560,2021-05-10,1620604800.0
14879,93,1,2021-05-11,18551,18919,1140807,667479,2021-05-11,1620691200.0
14880,93,1,2021-05-12,24741,16136,1165548,683615,2021-05-12,1620777600.0
14881,93,1,2021-05-13,24466,4629,1190014,688244,2021-05-13,1620864000.0
14882,93,1,2021-05-14,29479,10550,1219493,698794,2021-05-14,1620950400.0
14883,93,1,2021-05-15,25237,6106,1244730,704900,2021-05-15,1621036800.0
14884,93,1,2021-05-16,11231,1459,1255961,706359,2021-05-16,1621123200.0
14885,93,1,2021-05-17,21440,12135,1277401,718494,2021-05-17,1621206000.0
14886,93,1,2021-05-18,25277,11080,1302678,729574,2021-05-18,1621292400.0
14887,93,1,2021-05-19,25034,9131,1327712,738705,2021-05-19,1621378800.0
14888,93,1,2021-05-20,27194,9150,1354906,747855,2021-05-20,1621465200.0
14889,93,1,2021-05-21,27089,9040,1381995,756895,2021-05-21,1621551600.0
14890,93,1,2021-05-22,15330,3777,1397325,760672,2021-05-22,1621638000.0
14891,93,1,2021-05-23,5319,1283,1402644,761955,2021-05-23,1621724400.0
14892,93,1,2021-05-24,15967,2700,1418611,764655,2021-05-24,1621810800.0
14893,93,1,2021-05-25,20495,11658,1439106,776313,2021-05-25,1621897200.0
14894,93,1,2021-05-26,20868,13564,1459974,789877,2021-05-26,1621983600.0
14895,93,1,2021-05-27,23044,12892,1483018,802769,2021-05-27,1622070000.0
14896,93,1,2021-05-28,18974,14428,1501992,817197,2021-05-28,1622156400.0
14897,93,1,2021-05-29,10848,6522,1512840,823719,2021-05-29,1622242800.0
14898,93,1,2021-05-30,2477,1849,1515317,825568,2021-05-30,1622329200.0
14899,93,1,2021-05-31,18650,12800,1533967,838368,2021-05-31,1622415600.0
14900,93,1,2021-06-01,20813,14582,1554780,852950,2021-06-01,1622502000.0
14901,93,1,2021-06-02,19016,15022,1573796,867972,2021-06-02,1622588400.0
14902,93,1,2021-06-03,23061,14130,1596857,882102,2021-06-03,1622674800.0
14903,93,1,2021-06-04,22042,15294,1618899,897396,2021-06-04,1622761200.0
14904,93,1,2021-06-05,14017,8474,1632916,905870,2021-06-05,1622847600.0
14905,93,1,2021-06-06,4621,1890,1637537,907760,2021-06-06,1622934000.0
14906,93,1,2021-06-07,15101,16401,1652638,924161,2021-06-07,1623020400.0
14907,93,1,2021-06-08,16812,15142,1669450,939303,2021-06-08,1623106800.0
14908,93,1,2021-06-09,17194,16621,1686644,955924,2021-06-09,1623193200.0
14909,93,1,2021-06-10,17561,14071,1704205,969995,2021-06-10,1623279600.0
14910,93,1,2021-06-11,15148,18185,1719353,988180,2021-06-11,1623366000.0
14911,93,1,2021-06-12,10996,9385,1730349,997565,2021-06-12,1623452400.0
14912,93,1,2021-06-13,2308,2525,1732657,1000090,2021-06-13,1623538800.0
14913,93,1,2021-06-14,11711,19717,1744368,1019807,2021-06-14,1623625200.0
14914,93,1,2021-06-15,13279,18839,1757647,1038646,2021-06-15,1623711600.0
14915,93,1,2021-06-16,14541,15781,1772188,1054427,2021-06-16,1623798000.0
14916,93,1,2021-06-17,13967,15280,1786155,1069707,2021-06-17,1623884400.0
14917,93,1,2021-06-18,12358,15319,1798513,1085026,2021-06-18,1623970800.0
14918,93,1,2021-06-19,8485,10110,1806998,1095136,2021-06-19,1624057200.0
14919,93,1,2021-06-20,2241,2714,1809239,1097850,2021-06-20,1624143600.0
14920,93,1,2021-06-21,8448,21336,1817687,1119186,2021-06-21,1624230000.0
14921,93,1,2021-06-22,9194,23577,1826881,1142763,2021-06-22,1624316400.0
14922,93,1,2021-06-23,9328,21448,1836209,1164211,2021-06-23,1624402800.0
14923,93,1,2021-06-24,9533,22989,1845742,1187200,2021-06-24,1624489200.0
14924,93,1,2021-06-25,8696,26252,1854438,1213452,2021-06-25,1624575600.0
14925,93,1,2021-06-26,5631,15698,1860069,1229150,2021-06-26,1624662000.0
14926,93,1,2021-06-27,1831,4626,1861900,1233776,2021-06-27,1624748400.0
14927,93,1,2021-06-28,6844,24756,1868744,1258532,2021-06-28,1624834800.0
14928,93,1,2021-06-29,7845,24820,1876589,1283352,2021-06-29,1624921200.0
14929,93,1,2021-06-30,8774,23818,1885363,1307170,2021-06-30,1625007600.0
14930,93,1,2021-07-01,10315,21320,1895678,1328490,2021-07-01,1625094000.0
14931,93,1,2021-07-02,9938,23369,1905616,1351859,2021-07-02,1625180400.0
14932,93,1,2021-07-03,6328,17245,1911944,1369104,2021-07-03,1625266800.0
14933,93,1,2021-07-04,1712,3811,1913656,1372915,2021-07-04,1625353200.0
14934,93,1,2021-07-05,8054,21692,1921710,1394607,2021-07-05,1625439600.0
14935,93,1,2021-07-06,9997,21807,1931707,1416414,2021-07-06,1625526000.0
14936,93,1,2021-07-07,10627,18933,1942334,1435347,2021-07-07,1625612400.0
14937,93,1,2021-07-08,12410,18163,1954744,1453510,2021-07-08,1625698800.0
14938,93,2,2020-12-27,0,0,0,0,2020-12-27,1609023600.0
14939,93,2,2020-12-28,0,0,0,0,2020-12-28,1609110000.0
14940,93,2,2020-12-29,0,0,0,0,2020-12-29,1609196400.0
14941,93,2,2020-12-30,0,0,0,0,2020-12-30,1609282800.0
14942,93,2,2020-12-31,0,0,0,0,2020-12-31,1609369200.0
14943,93,2,2021-01-01,0,0,0,0,2021-01-01,1609455600.0
14944,93,2,2021-01-02,0,0,0,0,2021-01-02,1609542000.0
14945,93,2,2021-01-03,0,0,0,0,2021-01-03,1609628400.0
14946,93,2,2021-01-04,0,0,0,0,2021-01-04,1609714800.0
14947,93,2,2021-01-05,0,0,0,0,2021-01-05,1609801200.0
14948,93,2,2021-01-06,0,0,0,0,2021-01-06,1609887600.0
14949,93,2,2021-01-07,0,0,0,0,2021-01-07,1609974000.0
14950,93,2,2021-01-08,0,0,0,0,2021-01-08,1610060400.0
14951,93,2,2021-01-09,0,0,0,0,2021-01-09,1610146800.0
14952,93,2,2021-01-10,0,0,0,0,2021-01-10,1610233200.0
14953,93,2,2021-01-11,0,0,0,0,2021-01-11,1610319600.0
14954,93,2,2021-01-12,0,0,0,0,2021-01-12,1610406000.0
14955,93,2,2021-01-13,0,0,0,0,2021-01-13,1610492400.0
14956,93,2,2021-01-14,17,0,17,0,2021-01-14,1610578800.0
14957,93,2,2021-01-15,3,0,20,0,2021-01-15,1610665200.0
14958,93,2,2021-01-16,22,0,42,0,2021-01-16,1610751600.0
14959,93,2,2021-01-17,0,0,42,0,2021-01-17,1610838000.0
14960,93,2,2021-01-18,433,0,475,0,2021-01-18,1610924400.0
14961,93,2,2021-01-19,1229,0,1704,0,2021-01-19,1611010800.0
14962,93,2,2021-01-20,1163,0,2867,0,2021-01-20,1611097200.0
14963,93,2,2021-01-21,1178,0,4045,0,2021-01-21,1611183600.0
14964,93,2,2021-01-22,1103,0,5148,0,2021-01-22,1611270000.0
14965,93,2,2021-01-23,284,0,5432,0,2021-01-23,1611356400.0
14966,93,2,2021-01-24,48,0,5480,0,2021-01-24,1611442800.0
14967,93,2,2021-01-25,809,0,6289,0,2021-01-25,1611529200.0
14968,93,2,2021-01-26,922,0,7211,0,2021-01-26,1611615600.0
14969,93,2,2021-01-27,641,0,7852,0,2021-01-27,1611702000.0
14970,93,2,2021-01-28,557,0,8409,0,2021-01-28,1611788400.0
14971,93,2,2021-01-29,446,0,8855,0,2021-01-29,1611874800.0
14972,93,2,2021-01-30,75,0,8930,0,2021-01-30,1611961200.0
14973,93,2,2021-01-31,0,0,8930,0,2021-01-31,1612047600.0
14974,93,2,2021-02-01,518,0,9448,0,2021-02-01,1612134000.0
14975,93,2,2021-02-02,782,0,10230,0,2021-02-02,1612220400.0
14976,93,2,2021-02-03,837,0,11067,0,2021-02-03,1612306800.0
14977,93,2,2021-02-04,836,0,11903,0,2021-02-04,1612393200.0
14978,93,2,2021-02-05,713,2,12616,2,2021-02-05,1612479600.0
14979,93,2,2021-02-06,208,1,12824,3,2021-02-06,1612566000.0
14980,93,2,2021-02-07,1,0,12825,3,2021-02-07,1612652400.0
14981,93,2,2021-02-08,807,0,13632,3,2021-02-08,1612738800.0
14982,93,2,2021-02-09,780,1,14412,4,2021-02-09,1612825200.0
14983,93,2,2021-02-10,787,22,15199,26,2021-02-10,1612911600.0
14984,93,2,2021-02-11,801,0,16000,26,2021-02-11,1612998000.0
14985,93,2,2021-02-12,797,12,16797,38,2021-02-12,1613084400.0
14986,93,2,2021-02-13,212,20,17009,58,2021-02-13,1613170800.0
14987,93,2,2021-02-14,0,0,17009,58,2021-02-14,1613257200.0
14988,93,2,2021-02-15,588,436,17597,494,2021-02-15,1613343600.0
14989,93,2,2021-02-16,491,806,18088,1300,2021-02-16,1613430000.0
14990,93,2,2021-02-17,751,824,18839,2124,2021-02-17,1613516400.0
14991,93,2,2021-02-18,1085,1078,19924,3202,2021-02-18,1613602800.0
14992,93,2,2021-02-19,1075,1001,20999,4203,2021-02-19,1613689200.0
14993,93,2,2021-02-20,261,346,21260,4549,2021-02-20,1613775600.0
14994,93,2,2021-02-21,2,0,21262,4549,2021-02-21,1613862000.0
14995,93,2,2021-02-22,886,854,22148,5403,2021-02-22,1613948400.0
14996,93,2,2021-02-23,845,807,22993,6210,2021-02-23,1614034800.0
14997,93,2,2021-02-24,962,649,23955,6859,2021-02-24,1614121200.0
14998,93,2,2021-02-25,566,528,24521,7387,2021-02-25,1614207600.0
14999,93,2,2021-02-26,507,504,25028,7891,2021-02-26,1614294000.0
15000,93,2,2021-02-27,385,66,25413,7957,2021-02-27,1614380400.0
15001,93,2,2021-02-28,0,0,25413,7957,2021-02-28,1614466800.0
15002,93,2,2021-03-01,799,665,26212,8622,2021-03-01,1614553200.0
15003,93,2,2021-03-02,298,764,26510,9386,2021-03-02,1614639600.0
15004,93,2,2021-03-03,369,811,26879,10197,2021-03-03,1614726000.0
15005,93,2,2021-03-04,329,786,27208,10983,2021-03-04,1614812400.0
15006,93,2,2021-03-05,368,788,27576,11771,2021-03-05,1614898800.0
15007,93,2,2021-03-06,157,224,27733,11995,2021-03-06,1614985200.0
15008,93,2,2021-03-07,2,0,27735,11995,2021-03-07,1615071600.0
15009,93,2,2021-03-08,193,738,27928,12733,2021-03-08,1615158000.0
15010,93,2,2021-03-09,334,691,28262,13424,2021-03-09,1615244400.0
15011,93,2,2021-03-10,420,765,28682,14189,2021-03-10,1615330800.0
15012,93,2,2021-03-11,746,807,29428,14996,2021-03-11,1615417200.0
15013,93,2,2021-03-12,665,749,30093,15745,2021-03-12,1615503600.0
15014,93,2,2021-03-13,178,213,30271,15958,2021-03-13,1615590000.0
15015,93,2,2021-03-14,108,0,30379,15958,2021-03-14,1615676400.0
15016,93,2,2021-03-15,676,508,31055,16466,2021-03-15,1615762800.0
15017,93,2,2021-03-16,1723,499,32778,16965,2021-03-16,1615849200.0
15018,93,2,2021-03-17,3578,771,36356,17736,2021-03-17,1615935600.0
15019,93,2,2021-03-18,1902,1012,38258,18748,2021-03-18,1616022000.0
15020,93,2,2021-03-19,2729,997,40987,19745,2021-03-19,1616108400.0
15021,93,2,2021-03-20,967,213,41954,19958,2021-03-20,1616194800.0
15022,93,2,2021-03-21,379,0,42333,19958,2021-03-21,1616281200.0
15023,93,2,2021-03-22,1576,361,43909,20319,2021-03-22,1616367600.0
15024,93,2,2021-03-23,1462,475,45371,20794,2021-03-23,1616454000.0
15025,93,2,2021-03-24,1067,1471,46438,22265,2021-03-24,1616540400.0
15026,93,2,2021-03-25,1141,643,47579,22908,2021-03-25,1616626800.0
15027,93,2,2021-03-26,1872,461,49451,23369,2021-03-26,1616713200.0
15028,93,2,2021-03-27,886,183,50337,23552,2021-03-27,1616799600.0
15029,93,2,2021-03-28,240,0,50577,23552,2021-03-28,1616886000.0
15030,93,2,2021-03-29,1325,712,51902,24264,2021-03-29,1616972400.0
15031,93,2,2021-03-30,1491,400,53393,24664,2021-03-30,1617058800.0
15032,93,2,2021-03-31,3271,458,56664,25122,2021-03-31,1617145200.0
15033,93,2,2021-04-01,3869,478,60533,25600,2021-04-01,1617231600.0
15034,93,2,2021-04-02,4254,402,64787,26002,2021-04-02,1617318000.0
15035,93,2,2021-04-03,1050,84,65837,26086,2021-04-03,1617404400.0
15036,93,2,2021-04-04,139,0,65976,26086,2021-04-04,1617490800.0
15037,93,2,2021-04-05,1448,2,67424,26088,2021-04-05,1617577200.0
15038,93,2,2021-04-06,3324,396,70748,26484,2021-04-06,1617663600.0
15039,93,2,2021-04-07,1572,383,72320,26867,2021-04-07,1617750000.0
15040,93,2,2021-04-08,1653,344,73973,27211,2021-04-08,1617836400.0
15041,93,2,2021-04-09,1922,1106,75895,28317,2021-04-09,1617922800.0
15042,93,2,2021-04-10,733,207,76628,28524,2021-04-10,1618009200.0
15043,93,2,2021-04-11,129,96,76757,28620,2021-04-11,1618095600.0
15044,93,2,2021-04-12,1652,818,78409,29438,2021-04-12,1618185600.0
15045,93,2,2021-04-13,2192,1892,80601,31330,2021-04-13,1618272000.0
15046,93,2,2021-04-14,1531,846,82132,32176,2021-04-14,1618358400.0
15047,93,2,2021-04-15,2663,1457,84795,33633,2021-04-15,1618444800.0
15048,93,2,2021-04-16,2426,1824,87221,35457,2021-04-16,1618531200.0
15049,93,2,2021-04-17,858,882,88079,36339,2021-04-17,1618617600.0
15050,93,2,2021-04-18,203,332,88282,36671,2021-04-18,1618704000.0
15051,93,2,2021-04-19,1634,1546,89916,38217,2021-04-19,1618790400.0
15052,93,2,2021-04-20,1820,1383,91736,39600,2021-04-20,1618876800.0
15053,93,2,2021-04-21,3706,1273,95442,40873,2021-04-21,1618963200.0
15054,93,2,2021-04-22,1601,1446,97043,42319,2021-04-22,1619049600.0
15055,93,2,2021-04-23,1329,1859,98372,44178,2021-04-23,1619136000.0
15056,93,2,2021-04-24,360,1112,98732,45290,2021-04-24,1619222400.0
15057,93,2,2021-04-25,118,237,98850,45527,2021-04-25,1619308800.0
15058,93,2,2021-04-26,1290,1373,100140,46900,2021-04-26,1619395200.0
15059,93,2,2021-04-27,1356,1971,101496,48871,2021-04-27,1619481600.0
15060,93,2,2021-04-28,2734,2329,104230,51200,2021-04-28,1619568000.0
15061,93,2,2021-04-29,2887,2734,107117,53934,2021-04-29,1619654400.0
15062,93,2,2021-04-30,2363,3159,109480,57093,2021-04-30,1619740800.0
15063,93,2,2021-05-01,908,684,110388,57777,2021-05-01,1619827200.0
15064,93,2,2021-05-02,181,114,110569,57891,2021-05-02,1619913600.0
15065,93,2,2021-05-03,2948,1655,113517,59546,2021-05-03,1620000000.0
15066,93,2,2021-05-04,2074,2790,115591,62336,2021-05-04,1620086400.0
15067,93,2,2021-05-05,1955,1479,117546,63815,2021-05-05,1620172800.0
15068,93,2,2021-05-06,2101,1536,119647,65351,2021-05-06,1620259200.0
15069,93,2,2021-05-07,3187,1990,122834,67341,2021-05-07,1620345600.0
15070,93,2,2021-05-08,1343,497,124177,67838,2021-05-08,1620432000.0
15071,93,2,2021-05-09,310,266,124487,68104,2021-05-09,1620518400.0
15072,93,2,2021-05-10,2155,2272,126642,70376,2021-05-10,1620604800.0
15073,93,2,2021-05-11,4613,2072,131255,72448,2021-05-11,1620691200.0
15074,93,2,2021-05-12,6453,1492,137708,73940,2021-05-12,1620777600.0
15075,93,2,2021-05-13,3767,1410,141475,75350,2021-05-13,1620864000.0
15076,93,2,2021-05-14,4937,916,146412,76266,2021-05-14,1620950400.0
15077,93,2,2021-05-15,4202,412,150614,76678,2021-05-15,1621036800.0
15078,93,2,2021-05-16,1430,81,152044,76759,2021-05-16,1621123200.0
15079,93,2,2021-05-17,3509,1121,155553,77880,2021-05-17,1621206000.0
15080,93,2,2021-05-18,4138,625,159691,78505,2021-05-18,1621292400.0
15081,93,2,2021-05-19,4567,885,164258,79390,2021-05-19,1621378800.0
15082,93,2,2021-05-20,4688,623,168946,80013,2021-05-20,1621465200.0
15083,93,2,2021-05-21,5799,669,174745,80682,2021-05-21,1621551600.0
15084,93,2,2021-05-22,2928,224,177673,80906,2021-05-22,1621638000.0
15085,93,2,2021-05-23,534,107,178207,81013,2021-05-23,1621724400.0
15086,93,2,2021-05-24,1902,174,180109,81187,2021-05-24,1621810800.0
15087,93,2,2021-05-25,2204,747,182313,81934,2021-05-25,1621897200.0
15088,93,2,2021-05-26,3224,1180,185537,83114,2021-05-26,1621983600.0
15089,93,2,2021-05-27,2225,912,187762,84026,2021-05-27,1622070000.0
15090,93,2,2021-05-28,2266,1148,190028,85174,2021-05-28,1622156400.0
15091,93,2,2021-05-29,1496,503,191524,85677,2021-05-29,1622242800.0
15092,93,2,2021-05-30,73,68,191597,85745,2021-05-30,1622329200.0
15093,93,2,2021-05-31,1227,1687,192824,87432,2021-05-31,1622415600.0
15094,93,2,2021-06-01,2000,2279,194824,89711,2021-06-01,1622502000.0
15095,93,2,2021-06-02,1880,2521,196704,92232,2021-06-02,1622588400.0
15096,93,2,2021-06-03,2987,2291,199691,94523,2021-06-03,1622674800.0
15097,93,2,2021-06-04,3894,1643,203585,96166,2021-06-04,1622761200.0
15098,93,2,2021-06-05,1644,630,205229,96796,2021-06-05,1622847600.0
15099,93,2,2021-06-06,158,61,205387,96857,2021-06-06,1622934000.0
15100,93,2,2021-06-07,1727,2686,207114,99543,2021-06-07,1623020400.0
15101,93,2,2021-06-08,3056,2053,210170,101596,2021-06-08,1623106800.0
15102,93,2,2021-06-09,2300,2351,212470,103947,2021-06-09,1623193200.0
15103,93,2,2021-06-10,2884,2270,215354,106217,2021-06-10,1623279600.0
15104,93,2,2021-06-11,3177,2706,218531,108923,2021-06-11,1623366000.0
15105,93,2,2021-06-12,1374,1266,219905,110189,2021-06-12,1623452400.0
15106,93,2,2021-06-13,183,201,220088,110390,2021-06-13,1623538800.0
15107,93,2,2021-06-14,1479,3048,221567,113438,2021-06-14,1623625200.0
15108,93,2,2021-06-15,2199,3085,223766,116523,2021-06-15,1623711600.0
15109,93,2,2021-06-16,1721,2690,225487,119213,2021-06-16,1623798000.0
15110,93,2,2021-06-17,2180,3230,227667,122443,2021-06-17,1623884400.0
15111,93,2,2021-06-18,2667,2747,230334,125190,2021-06-18,1623970800.0
15112,93,2,2021-06-19,790,1904,231124,127094,2021-06-19,1624057200.0
15113,93,2,2021-06-20,93,357,231217,127451,2021-06-20,1624143600.0
15114,93,2,2021-06-21,1049,4661,232266,132112,2021-06-21,1624230000.0
15115,93,2,2021-06-22,1606,4541,233872,136653,2021-06-22,1624316400.0
15116,93,2,2021-06-23,1440,5657,235312,142310,2021-06-23,1624402800.0
15117,93,2,2021-06-24,1834,4009,237146,146319,2021-06-24,1624489200.0
15118,93,2,2021-06-25,1860,4384,239006,150703,2021-06-25,1624575600.0
15119,93,2,2021-06-26,666,3327,239672,154030,2021-06-26,1624662000.0
15120,93,2,2021-06-27,108,532,239780,154562,2021-06-27,1624748400.0
15121,93,2,2021-06-28,855,4340,240635,158902,2021-06-28,1624834800.0
15122,93,2,2021-06-29,1407,4107,242042,163009,2021-06-29,1624921200.0
15123,93,2,2021-06-30,1119,4668,243161,167677,2021-06-30,1625007600.0
15124,93,2,2021-07-01,1374,3527,244535,171204,2021-07-01,1625094000.0
15125,93,2,2021-07-02,1759,3835,246294,175039,2021-07-02,1625180400.0
15126,93,2,2021-07-03,679,2158,246973,177197,2021-07-03,1625266800.0
15127,93,2,2021-07-04,89,242,247062,177439,2021-07-04,1625353200.0
15128,93,2,2021-07-05,696,2968,247758,180407,2021-07-05,1625439600.0
15129,93,2,2021-07-06,1231,2742,248989,183149,2021-07-06,1625526000.0
15130,93,2,2021-07-07,1506,2813,250495,185962,2021-07-07,1625612400.0
15131,93,2,2021-07-08,1614,2755,252109,188717,2021-07-08,1625698800.0
15132,93,3,2020-12-27,0,0,0,0,2020-12-27,1609023600.0
15133,93,3,2020-12-28,0,0,0,0,2020-12-28,1609110000.0
15134,93,3,2020-12-29,0,0,0,0,2020-12-29,1609196400.0
15135,93,3,2020-12-30,0,0,0,0,2020-12-30,1609282800.0
15136,93,3,2020-12-31,0,0,0,0,2020-12-31,1609369200.0
15137,93,3,2021-01-01,0,0,0,0,2021-01-01,1609455600.0
15138,93,3,2021-01-02,0,0,0,0,2021-01-02,1609542000.0
15139,93,3,2021-01-03,0,0,0,0,2021-01-03,1609628400.0
15140,93,3,2021-01-04,0,0,0,0,2021-01-04,1609714800.0
15141,93,3,2021-01-05,0,0,0,0,2021-01-05,1609801200.0
15142,93,3,2021-01-06,0,0,0,0,2021-01-06,1609887600.0
15143,93,3,2021-01-07,0,0,0,0,2021-01-07,1609974000.0
15144,93,3,2021-01-08,0,0,0,0,2021-01-08,1610060400.0
15145,93,3,2021-01-09,0,0,0,0,2021-01-09,1610146800.0
15146,93,3,2021-01-10,0,0,0,0,2021-01-10,1610233200.0
15147,93,3,2021-01-11,0,0,0,0,2021-01-11,1610319600.0
15148,93,3,2021-01-12,0,0,0,0,2021-01-12,1610406000.0
15149,93,3,2021-01-13,0,0,0,0,2021-01-13,1610492400.0
15150,93,3,2021-01-14,0,0,0,0,2021-01-14,1610578800.0
15151,93,3,2021-01-15,0,0,0,0,2021-01-15,1610665200.0
15152,93,3,2021-01-16,0,0,0,0,2021-01-16,1610751600.0
15153,93,3,2021-01-17,0,0,0,0,2021-01-17,1610838000.0
15154,93,3,2021-01-18,0,0,0,0,2021-01-18,1610924400.0
15155,93,3,2021-01-19,0,0,0,0,2021-01-19,1611010800.0
15156,93,3,2021-01-20,0,0,0,0,2021-01-20,1611097200.0
15157,93,3,2021-01-21,0,0,0,0,2021-01-21,1611183600.0
15158,93,3,2021-01-22,0,0,0,0,2021-01-22,1611270000.0
15159,93,3,2021-01-23,0,0,0,0,2021-01-23,1611356400.0
15160,93,3,2021-01-24,0,0,0,0,2021-01-24,1611442800.0
15161,93,3,2021-01-25,0,0,0,0,2021-01-25,1611529200.0
15162,93,3,2021-01-26,0,0,0,0,2021-01-26,1611615600.0
15163,93,3,2021-01-27,0,0,0,0,2021-01-27,1611702000.0
15164,93,3,2021-01-28,0,0,0,0,2021-01-28,1611788400.0
15165,93,3,2021-01-29,0,0,0,0,2021-01-29,1611874800.0
15166,93,3,2021-01-30,0,0,0,0,2021-01-30,1611961200.0
15167,93,3,2021-01-31,0,0,0,0,2021-01-31,1612047600.0
15168,93,3,2021-02-01,0,0,0,0,2021-02-01,1612134000.0
15169,93,3,2021-02-02,0,0,0,0,2021-02-02,1612220400.0
15170,93,3,2021-02-03,0,0,0,0,2021-02-03,1612306800.0
15171,93,3,2021-02-04,0,0,0,0,2021-02-04,1612393200.0
15172,93,3,2021-02-05,0,0,0,0,2021-02-05,1612479600.0
15173,93,3,2021-02-06,10,0,10,0,2021-02-06,1612566000.0
15174,93,3,2021-02-07,0,0,10,0,2021-02-07,1612652400.0
15175,93,3,2021-02-08,17,0,27,0,2021-02-08,1612738800.0
15176,93,3,2021-02-09,34,0,61,0,2021-02-09,1612825200.0
15177,93,3,2021-02-10,52,0,113,0,2021-02-10,1612911600.0
15178,93,3,2021-02-11,127,0,240,0,2021-02-11,1612998000.0
15179,93,3,2021-02-12,161,0,401,0,2021-02-12,1613084400.0
15180,93,3,2021-02-13,16,0,417,0,2021-02-13,1613170800.0
15181,93,3,2021-02-14,0,0,417,0,2021-02-14,1613257200.0
15182,93,3,2021-02-15,212,0,629,0,2021-02-15,1613343600.0
15183,93,3,2021-02-16,234,0,863,0,2021-02-16,1613430000.0
15184,93,3,2021-02-17,213,0,1076,0,2021-02-17,1613516400.0
15185,93,3,2021-02-18,353,0,1429,0,2021-02-18,1613602800.0
15186,93,3,2021-02-19,383,0,1812,0,2021-02-19,1613689200.0
15187,93,3,2021-02-20,40,0,1852,0,2021-02-20,1613775600.0
15188,93,3,2021-02-21,0,0,1852,0,2021-02-21,1613862000.0
15189,93,3,2021-02-22,376,0,2228,0,2021-02-22,1613948400.0
15190,93,3,2021-02-23,337,0,2565,0,2021-02-23,1614034800.0
15191,93,3,2021-02-24,395,0,2960,0,2021-02-24,1614121200.0
15192,93,3,2021-02-25,2249,0,5209,0,2021-02-25,1614207600.0
15193,93,3,2021-02-26,3137,0,8346,0,2021-02-26,1614294000.0
15194,93,3,2021-02-27,1865,2,10211,2,2021-02-27,1614380400.0
15195,93,3,2021-02-28,172,0,10383,2,2021-02-28,1614466800.0
15196,93,3,2021-03-01,1352,0,11735,2,2021-03-01,1614553200.0
15197,93,3,2021-03-02,2364,1,14099,3,2021-03-02,1614639600.0
15198,93,3,2021-03-03,3109,0,17208,3,2021-03-03,1614726000.0
15199,93,3,2021-03-04,4802,0,22010,3,2021-03-04,1614812400.0
15200,93,3,2021-03-05,5838,3,27848,6,2021-03-05,1614898800.0
15201,93,3,2021-03-06,14261,2,42109,8,2021-03-06,1614985200.0
15202,93,3,2021-03-07,10756,4,52865,12,2021-03-07,1615071600.0
15203,93,3,2021-03-08,3976,2,56841,14,2021-03-08,1615158000.0
15204,93,3,2021-03-09,6059,2,62900,16,2021-03-09,1615244400.0
15205,93,3,2021-03-10,6543,5,69443,21,2021-03-10,1615330800.0
15206,93,3,2021-03-11,10312,4,79755,25,2021-03-11,1615417200.0
15207,93,3,2021-03-12,11413,5,91168,30,2021-03-12,1615503600.0
15208,93,3,2021-03-13,9166,7,100334,37,2021-03-13,1615590000.0
15209,93,3,2021-03-14,1495,0,101829,37,2021-03-14,1615676400.0
15210,93,3,2021-03-15,5366,2,107195,39,2021-03-15,1615762800.0
15211,93,3,2021-03-16,108,1,107303,40,2021-03-16,1615849200.0
15212,93,3,2021-03-17,66,1,107369,41,2021-03-17,1615935600.0
15213,93,3,2021-03-18,117,0,107486,41,2021-03-18,1616022000.0
15214,93,3,2021-03-19,4441,8,111927,49,2021-03-19,1616108400.0
15215,93,3,2021-03-20,3798,2,115725,51,2021-03-20,1616194800.0
15216,93,3,2021-03-21,556,0,116281,51,2021-03-21,1616281200.0
15217,93,3,2021-03-22,4284,2,120565,53,2021-03-22,1616367600.0
15218,93,3,2021-03-23,7154,4,127719,57,2021-03-23,1616454000.0
15219,93,3,2021-03-24,7204,8,134923,65,2021-03-24,1616540400.0
15220,93,3,2021-03-25,10987,13,145910,78,2021-03-25,1616626800.0
15221,93,3,2021-03-26,11337,18,157247,96,2021-03-26,1616713200.0
15222,93,3,2021-03-27,4448,2,161695,98,2021-03-27,1616799600.0
15223,93,3,2021-03-28,607,0,162302,98,2021-03-28,1616886000.0
15224,93,3,2021-03-29,4547,8,166849,106,2021-03-29,1616972400.0
15225,93,3,2021-03-30,7200,3,174049,109,2021-03-30,1617058800.0
15226,93,3,2021-03-31,5197,11,179246,120,2021-03-31,1617145200.0
15227,93,3,2021-04-01,6539,13,185785,133,2021-04-01,1617231600.0
15228,93,3,2021-04-02,6177,13,191962,146,2021-04-02,1617318000.0
15229,93,3,2021-04-03,2079,12,194041,158,2021-04-03,1617404400.0
15230,93,3,2021-04-04,368,0,194409,158,2021-04-04,1617490800.0
15231,93,3,2021-04-05,299,0,194708,158,2021-04-05,1617577200.0
15232,93,3,2021-04-06,2062,10,196770,168,2021-04-06,1617663600.0
15233,93,3,2021-04-07,2409,7,199179,175,2021-04-07,1617750000.0
15234,93,3,2021-04-08,4833,23,204012,198,2021-04-08,1617836400.0
15235,93,3,2021-04-09,7433,42,211445,240,2021-04-09,1617922800.0
15236,93,3,2021-04-10,2921,19,214366,259,2021-04-10,1618009200.0
15237,93,3,2021-04-11,361,6,214727,265,2021-04-11,1618095600.0
15238,93,3,2021-04-12,2989,28,217716,293,2021-04-12,1618185600.0
15239,93,3,2021-04-13,4292,46,222008,339,2021-04-13,1618272000.0
15240,93,3,2021-04-14,3701,50,225709,389,2021-04-14,1618358400.0
15241,93,3,2021-04-15,4295,29,230004,418,2021-04-15,1618444800.0
15242,93,3,2021-04-16,4855,30,234859,448,2021-04-16,1618531200.0
15243,93,3,2021-04-17,2094,17,236953,465,2021-04-17,1618617600.0
15244,93,3,2021-04-18,421,5,237374,470,2021-04-18,1618704000.0
15245,93,3,2021-04-19,1206,28,238580,498,2021-04-19,1618790400.0
15246,93,3,2021-04-20,1829,44,240409,542,2021-04-20,1618876800.0
15247,93,3,2021-04-21,1679,32,242088,574,2021-04-21,1618963200.0
15248,93,3,2021-04-22,2427,49,244515,623,2021-04-22,1619049600.0
15249,93,3,2021-04-23,2546,74,247061,697,2021-04-23,1619136000.0
15250,93,3,2021-04-24,1210,100,248271,797,2021-04-24,1619222400.0
15251,93,3,2021-04-25,249,10,248520,807,2021-04-25,1619308800.0
15252,93,3,2021-04-26,772,29,249292,836,2021-04-26,1619395200.0
15253,93,3,2021-04-27,1278,83,250570,919,2021-04-27,1619481600.0
15254,93,3,2021-04-28,1047,93,251617,1012,2021-04-28,1619568000.0
15255,93,3,2021-04-29,1838,361,253455,1373,2021-04-29,1619654400.0
15256,93,3,2021-04-30,1845,710,255300,2083,2021-04-30,1619740800.0
15257,93,3,2021-05-01,177,97,255477,2180,2021-05-01,1619827200.0
15258,93,3,2021-05-02,120,34,255597,2214,2021-05-02,1619913600.0
15259,93,3,2021-05-03,510,279,256107,2493,2021-05-03,1620000000.0
15260,93,3,2021-05-04,873,518,256980,3011,2021-05-04,1620086400.0
15261,93,3,2021-05-05,831,792,257811,3803,2021-05-05,1620172800.0
15262,93,3,2021-05-06,1432,1476,259243,5279,2021-05-06,1620259200.0
15263,93,3,2021-05-07,1624,1994,260867,7273,2021-05-07,1620345600.0
15264,93,3,2021-05-08,151,461,261018,7734,2021-05-08,1620432000.0
15265,93,3,2021-05-09,79,169,261097,7903,2021-05-09,1620518400.0
15266,93,3,2021-05-10,668,1008,261765,8911,2021-05-10,1620604800.0
15267,93,3,2021-05-11,1129,1975,262894,10886,2021-05-11,1620691200.0
15268,93,3,2021-05-12,844,2308,263738,13194,2021-05-12,1620777600.0
15269,93,3,2021-05-13,127,295,263865,13489,2021-05-13,1620864000.0
15270,93,3,2021-05-14,507,2073,264372,15562,2021-05-14,1620950400.0
15271,93,3,2021-05-15,249,1565,264621,17127,2021-05-15,1621036800.0
15272,93,3,2021-05-16,71,189,264692,17316,2021-05-16,1621123200.0
15273,93,3,2021-05-17,492,1874,265184,19190,2021-05-17,1621206000.0
15274,93,3,2021-05-18,532,2147,265716,21337,2021-05-18,1621292400.0
15275,93,3,2021-05-19,475,2437,266191,23774,2021-05-19,1621378800.0
15276,93,3,2021-05-20,668,3814,266859,27588,2021-05-20,1621465200.0
15277,93,3,2021-05-21,603,4777,267462,32365,2021-05-21,1621551600.0
15278,93,3,2021-05-22,314,1980,267776,34345,2021-05-22,1621638000.0
15279,93,3,2021-05-23,50,201,267826,34546,2021-05-23,1621724400.0
15280,93,3,2021-05-24,27,627,267853,35173,2021-05-24,1621810800.0
15281,93,3,2021-05-25,509,5436,268362,40609,2021-05-25,1621897200.0
15282,93,3,2021-05-26,297,4407,268659,45016,2021-05-26,1621983600.0
15283,93,3,2021-05-27,445,6158,269104,51174,2021-05-27,1622070000.0
15284,93,3,2021-05-28,368,7563,269472,58737,2021-05-28,1622156400.0
15285,93,3,2021-05-29,228,5612,269700,64349,2021-05-29,1622242800.0
15286,93,3,2021-05-30,19,1014,269719,65363,2021-05-30,1622329200.0
15287,93,3,2021-05-31,217,4236,269936,69599,2021-05-31,1622415600.0
15288,93,3,2021-06-01,264,5532,270200,75131,2021-06-01,1622502000.0
15289,93,3,2021-06-02,214,5278,270414,80409,2021-06-02,1622588400.0
15290,93,3,2021-06-03,238,6701,270652,87110,2021-06-03,1622674800.0
15291,93,3,2021-06-04,275,7052,270927,94162,2021-06-04,1622761200.0
15292,93,3,2021-06-05,117,3136,271044,97298,2021-06-05,1622847600.0
15293,93,3,2021-06-06,31,393,271075,97691,2021-06-06,1622934000.0
15294,93,3,2021-06-07,113,2646,271188,100337,2021-06-07,1623020400.0
15295,93,3,2021-06-08,165,3776,271353,104113,2021-06-08,1623106800.0
15296,93,3,2021-06-09,129,3547,271482,107660,2021-06-09,1623193200.0
15297,93,3,2021-06-10,141,4941,271623,112601,2021-06-10,1623279600.0
15298,93,3,2021-06-11,154,6403,271777,119004,2021-06-11,1623366000.0
15299,93,3,2021-06-12,74,2775,271851,121779,2021-06-12,1623452400.0
15300,93,3,2021-06-13,15,277,271866,122056,2021-06-13,1623538800.0
15301,93,3,2021-06-14,69,4465,271935,126521,2021-06-14,1623625200.0
15302,93,3,2021-06-15,140,6165,272075,132686,2021-06-15,1623711600.0
15303,93,3,2021-06-16,96,4544,272171,137230,2021-06-16,1623798000.0
15304,93,3,2021-06-17,145,6740,272316,143970,2021-06-17,1623884400.0
15305,93,3,2021-06-18,138,6838,272454,150808,2021-06-18,1623970800.0
15306,93,3,2021-06-19,54,1964,272508,152772,2021-06-19,1624057200.0
15307,93,3,2021-06-20,10,316,272518,153088,2021-06-20,1624143600.0
15308,93,3,2021-06-21,44,2686,272562,155774,2021-06-21,1624230000.0
15309,93,3,2021-06-22,71,4007,272633,159781,2021-06-22,1624316400.0
15310,93,3,2021-06-23,86,2917,272719,162698,2021-06-23,1624402800.0
15311,93,3,2021-06-24,80,4500,272799,167198,2021-06-24,1624489200.0
15312,93,3,2021-06-25,112,4591,272911,171789,2021-06-25,1624575600.0
15313,93,3,2021-06-26,70,1376,272981,173165,2021-06-26,1624662000.0
15314,93,3,2021-06-27,8,316,272989,173481,2021-06-27,1624748400.0
15315,93,3,2021-06-28,56,1804,273045,175285,2021-06-28,1624834800.0
15316,93,3,2021-06-29,79,2719,273124,178004,2021-06-29,1624921200.0
15317,93,3,2021-06-30,66,2441,273190,180445,2021-06-30,1625007600.0
15318,93,3,2021-07-01,104,3419,273294,183864,2021-07-01,1625094000.0
15319,93,3,2021-07-02,97,3618,273391,187482,2021-07-02,1625180400.0
15320,93,3,2021-07-03,34,1074,273425,188556,2021-07-03,1625266800.0
15321,93,3,2021-07-04,11,165,273436,188721,2021-07-04,1625353200.0
15322,93,3,2021-07-05,46,1727,273482,190448,2021-07-05,1625439600.0
15323,93,3,2021-07-06,67,2371,273549,192819,2021-07-06,1625526000.0
15324,93,3,2021-07-07,53,1768,273602,194587,2021-07-07,1625612400.0
15325,93,3,2021-07-08,83,2445,273685,197032,2021-07-08,1625698800.0
15326,93,4,2020-12-27,0,0,0,0,2020-12-27,1609023600.0
15327,93,4,2020-12-28,0,0,0,0,2020-12-28,1609110000.0
15328,93,4,2020-12-29,0,0,0,0,2020-12-29,1609196400.0
15329,93,4,2020-12-30,0,0,0,0,2020-12-30,1609282800.0
15330,93,4,2020-12-31,0,0,0,0,2020-12-31,1609369200.0
15331,93,4,2021-01-01,0,0,0,0,2021-01-01,1609455600.0
15332,93,4,2021-01-02,0,0,0,0,2021-01-02,1609542000.0
15333,93,4,2021-01-03,0,0,0,0,2021-01-03,1609628400.0
15334,93,4,2021-01-04,0,0,0,0,2021-01-04,1609714800.0
15335,93,4,2021-01-05,0,0,0,0,2021-01-05,1609801200.0
15336,93,4,2021-01-06,0,0,0,0,2021-01-06,1609887600.0
15337,93,4,2021-01-07,0,0,0,0,2021-01-07,1609974000.0
15338,93,4,2021-01-08,0,0,0,0,2021-01-08,1610060400.0
15339,93,4,2021-01-09,0,0,0,0,2021-01-09,1610146800.0
15340,93,4,2021-01-10,0,0,0,0,2021-01-10,1610233200.0
15341,93,4,2021-01-11,0,0,0,0,2021-01-11,1610319600.0
15342,93,4,2021-01-12,0,0,0,0,2021-01-12,1610406000.0
15343,93,4,2021-01-13,0,0,0,0,2021-01-13,1610492400.0
15344,93,4,2021-01-14,0,0,0,0,2021-01-14,1610578800.0
15345,93,4,2021-01-15,0,0,0,0,2021-01-15,1610665200.0
15346,93,4,2021-01-16,0,0,0,0,2021-01-16,1610751600.0
15347,93,4,2021-01-17,0,0,0,0,2021-01-17,1610838000.0
15348,93,4,2021-01-18,0,0,0,0,2021-01-18,1610924400.0
15349,93,4,2021-01-19,0,0,0,0,2021-01-19,1611010800.0
15350,93,4,2021-01-20,0,0,0,0,2021-01-20,1611097200.0
15351,93,4,2021-01-21,0,0,0,0,2021-01-21,1611183600.0
15352,93,4,2021-01-22,0,0,0,0,2021-01-22,1611270000.0
15353,93,4,2021-01-23,0,0,0,0,2021-01-23,1611356400.0
15354,93,4,2021-01-24,0,0,0,0,2021-01-24,1611442800.0
15355,93,4,2021-01-25,0,0,0,0,2021-01-25,1611529200.0
15356,93,4,2021-01-26,0,0,0,0,2021-01-26,1611615600.0
15357,93,4,2021-01-27,0,0,0,0,2021-01-27,1611702000.0
15358,93,4,2021-01-28,0,0,0,0,2021-01-28,1611788400.0
15359,93,4,2021-01-29,0,0,0,0,2021-01-29,1611874800.0
15360,93,4,2021-01-30,0,0,0,0,2021-01-30,1611961200.0
15361,93,4,2021-01-31,0,0,0,0,2021-01-31,1612047600.0
15362,93,4,2021-02-01,0,0,0,0,2021-02-01,1612134000.0
15363,93,4,2021-02-02,0,0,0,0,2021-02-02,1612220400.0
15364,93,4,2021-02-03,0,0,0,0,2021-02-03,1612306800.0
15365,93,4,2021-02-04,0,0,0,0,2021-02-04,1612393200.0
15366,93,4,2021-02-05,0,0,0,0,2021-02-05,1612479600.0
15367,93,4,2021-02-06,0,0,0,0,2021-02-06,1612566000.0
15368,93,4,2021-02-07,0,0,0,0,2021-02-07,1612652400.0
15369,93,4,2021-02-08,0,0,0,0,2021-02-08,1612738800.0
15370,93,4,2021-02-09,0,0,0,0,2021-02-09,1612825200.0
15371,93,4,2021-02-10,0,0,0,0,2021-02-10,1612911600.0
15372,93,4,2021-02-11,0,0,0,0,2021-02-11,1612998000.0
15373,93,4,2021-02-12,0,0,0,0,2021-02-12,1613084400.0
15374,93,4,2021-02-13,0,0,0,0,2021-02-13,1613170800.0
15375,93,4,2021-02-14,0,0,0,0,2021-02-14,1613257200.0
15376,93,4,2021-02-15,0,0,0,0,2021-02-15,1613343600.0
15377,93,4,2021-02-16,0,0,0,0,2021-02-16,1613430000.0
15378,93,4,2021-02-17,0,0,0,0,2021-02-17,1613516400.0
15379,93,4,2021-02-18,0,0,0,0,2021-02-18,1613602800.0
15380,93,4,2021-02-19,0,0,0,0,2021-02-19,1613689200.0
15381,93,4,2021-02-20,0,0,0,0,2021-02-20,1613775600.0
15382,93,4,2021-02-21,0,0,0,0,2021-02-21,1613862000.0
15383,93,4,2021-02-22,0,0,0,0,2021-02-22,1613948400.0
15384,93,4,2021-02-23,0,0,0,0,2021-02-23,1614034800.0
15385,93,4,2021-02-24,0,0,0,0,2021-02-24,1614121200.0
15386,93,4,2021-02-25,0,0,0,0,2021-02-25,1614207600.0
15387,93,4,2021-02-26,0,0,0,0,2021-02-26,1614294000.0
15388,93,4,2021-02-27,0,0,0,0,2021-02-27,1614380400.0
15389,93,4,2021-02-28,0,0,0,0,2021-02-28,1614466800.0
15390,93,4,2021-03-01,0,0,0,0,2021-03-01,1614553200.0
15391,93,4,2021-03-02,0,0,0,0,2021-03-02,1614639600.0
15392,93,4,2021-03-03,0,0,0,0,2021-03-03,1614726000.0
15393,93,4,2021-03-04,0,0,0,0,2021-03-04,1614812400.0
15394,93,4,2021-03-05,0,0,0,0,2021-03-05,1614898800.0
15395,93,4,2021-03-06,0,0,0,0,2021-03-06,1614985200.0
15396,93,4,2021-03-07,0,0,0,0,2021-03-07,1615071600.0
15397,93,4,2021-03-08,0,0,0,0,2021-03-08,1615158000.0
15398,93,4,2021-03-09,0,0,0,0,2021-03-09,1615244400.0
15399,93,4,2021-03-10,0,0,0,0,2021-03-10,1615330800.0
15400,93,4,2021-03-11,0,0,0,0,2021-03-11,1615417200.0
15401,93,4,2021-03-12,0,0,0,0,2021-03-12,1615503600.0
15402,93,4,2021-03-13,0,0,0,0,2021-03-13,1615590000.0
15403,93,4,2021-03-14,0,0,0,0,2021-03-14,1615676400.0
15404,93,4,2021-03-15,0,0,0,0,2021-03-15,1615762800.0
15405,93,4,2021-03-16,0,0,0,0,2021-03-16,1615849200.0
15406,93,4,2021-03-17,0,0,0,0,2021-03-17,1615935600.0
15407,93,4,2021-03-18,0,0,0,0,2021-03-18,1616022000.0
15408,93,4,2021-03-19,0,0,0,0,2021-03-19,1616108400.0
15409,93,4,2021-03-20,0,0,0,0,2021-03-20,1616194800.0
15410,93,4,2021-03-21,0,0,0,0,2021-03-21,1616281200.0
15411,93,4,2021-03-22,0,0,0,0,2021-03-22,1616367600.0
15412,93,4,2021-03-23,0,0,0,0,2021-03-23,1616454000.0
15413,93,4,2021-03-24,0,0,0,0,2021-03-24,1616540400.0
15414,93,4,2021-03-25,0,0,0,0,2021-03-25,1616626800.0
15415,93,4,2021-03-26,0,0,0,0,2021-03-26,1616713200.0
15416,93,4,2021-03-27,0,0,0,0,2021-03-27,1616799600.0
15417,93,4,2021-03-28,0,0,0,0,2021-03-28,1616886000.0
15418,93,4,2021-03-29,0,0,0,0,2021-03-29,1616972400.0
15419,93,4,2021-03-30,0,0,0,0,2021-03-30,1617058800.0
15420,93,4,2021-03-31,0,0,0,0,2021-03-31,1617145200.0
15421,93,4,2021-04-01,0,0,0,0,2021-04-01,1617231600.0
15422,93,4,2021-04-02,0,0,0,0,2021-04-02,1617318000.0
15423,93,4,2021-04-03,0,0,0,0,2021-04-03,1617404400.0
15424,93,4,2021-04-04,0,0,0,0,2021-04-04,1617490800.0
15425,93,4,2021-04-05,0,0,0,0,2021-04-05,1617577200.0
15426,93,4,2021-04-06,0,0,0,0,2021-04-06,1617663600.0
15427,93,4,2021-04-07,0,0,0,0,2021-04-07,1617750000.0
15428,93,4,2021-04-08,0,0,0,0,2021-04-08,1617836400.0
15429,93,4,2021-04-09,0,0,0,0,2021-04-09,1617922800.0
15430,93,4,2021-04-10,0,0,0,0,2021-04-10,1618009200.0
15431,93,4,2021-04-11,0,0,0,0,2021-04-11,1618095600.0
15432,93,4,2021-04-12,0,0,0,0,2021-04-12,1618185600.0
15433,93,4,2021-04-13,0,0,0,0,2021-04-13,1618272000.0
15434,93,4,2021-04-14,0,0,0,0,2021-04-14,1618358400.0
15435,93,4,2021-04-15,0,0,0,0,2021-04-15,1618444800.0
15436,93,4,2021-04-16,0,0,0,0,2021-04-16,1618531200.0
15437,93,4,2021-04-17,0,0,0,0,2021-04-17,1618617600.0
15438,93,4,2021-04-18,0,0,0,0,2021-04-18,1618704000.0
15439,93,4,2021-04-19,0,0,0,0,2021-04-19,1618790400.0
15440,93,4,2021-04-20,0,0,0,0,2021-04-20,1618876800.0
15441,93,4,2021-04-21,0,0,0,0,2021-04-21,1618963200.0
15442,93,4,2021-04-22,0,0,0,0,2021-04-22,1619049600.0
15443,93,4,2021-04-23,11,0,11,0,2021-04-23,1619136000.0
15444,93,4,2021-04-24,37,0,48,0,2021-04-24,1619222400.0
15445,93,4,2021-04-25,0,0,48,0,2021-04-25,1619308800.0
15446,93,4,2021-04-26,88,0,136,0,2021-04-26,1619395200.0
15447,93,4,2021-04-27,594,0,730,0,2021-04-27,1619481600.0
15448,93,4,2021-04-28,561,0,1291,0,2021-04-28,1619568000.0
15449,93,4,2021-04-29,1117,0,2408,0,2021-04-29,1619654400.0
15450,93,4,2021-04-30,1228,1,3636,1,2021-04-30,1619740800.0
15451,93,4,2021-05-01,103,1,3739,2,2021-05-01,1619827200.0
15452,93,4,2021-05-02,41,0,3780,2,2021-05-02,1619913600.0
15453,93,4,2021-05-03,435,0,4215,2,2021-05-03,1620000000.0
15454,93,4,2021-05-04,552,1,4767,3,2021-05-04,1620086400.0
15455,93,4,2021-05-05,443,0,5210,3,2021-05-05,1620172800.0
15456,93,4,2021-05-06,731,0,5941,3,2021-05-06,1620259200.0
15457,93,4,2021-05-07,1231,0,7172,3,2021-05-07,1620345600.0
15458,93,4,2021-05-08,116,2,7288,5,2021-05-08,1620432000.0
15459,93,4,2021-05-09,9,0,7297,5,2021-05-09,1620518400.0
15460,93,4,2021-05-10,556,1,7853,6,2021-05-10,1620604800.0
15461,93,4,2021-05-11,1162,3,9015,9,2021-05-11,1620691200.0
15462,93,4,2021-05-12,666,5,9681,14,2021-05-12,1620777600.0
15463,93,4,2021-05-13,60,2,9741,16,2021-05-13,1620864000.0
15464,93,4,2021-05-14,641,0,10382,16,2021-05-14,1620950400.0
15465,93,4,2021-05-15,279,1,10661,17,2021-05-15,1621036800.0
15466,93,4,2021-05-16,62,0,10723,17,2021-05-16,1621123200.0
15467,93,4,2021-05-17,465,0,11188,17,2021-05-17,1621206000.0
15468,93,4,2021-05-18,689,1,11877,18,2021-05-18,1621292400.0
15469,93,4,2021-05-19,417,0,12294,18,2021-05-19,1621378800.0
15470,93,4,2021-05-20,623,0,12917,18,2021-05-20,1621465200.0
15471,93,4,2021-05-21,818,3,13735,21,2021-05-21,1621551600.0
15472,93,4,2021-05-22,297,5,14032,26,2021-05-22,1621638000.0
15473,93,4,2021-05-23,30,2,14062,28,2021-05-23,1621724400.0
15474,93,4,2021-05-24,40,0,14102,28,2021-05-24,1621810800.0
15475,93,4,2021-05-25,610,0,14712,28,2021-05-25,1621897200.0
15476,93,4,2021-05-26,676,3,15388,31,2021-05-26,1621983600.0
15477,93,4,2021-05-27,1025,3,16413,34,2021-05-27,1622070000.0
15478,93,4,2021-05-28,1485,5,17898,39,2021-05-28,1622156400.0
15479,93,4,2021-05-29,622,0,18520,39,2021-05-29,1622242800.0
15480,93,4,2021-05-30,36,0,18556,39,2021-05-30,1622329200.0
15481,93,4,2021-05-31,909,3,19465,42,2021-05-31,1622415600.0
15482,93,4,2021-06-01,1568,6,21033,48,2021-06-01,1622502000.0
15483,93,4,2021-06-02,1291,6,22324,54,2021-06-02,1622588400.0
15484,93,4,2021-06-03,1519,1,23843,55,2021-06-03,1622674800.0
15485,93,4,2021-06-04,1876,9,25719,64,2021-06-04,1622761200.0
15486,93,4,2021-06-05,622,1,26341,65,2021-06-05,1622847600.0
15487,93,4,2021-06-06,94,0,26435,65,2021-06-06,1622934000.0
15488,93,4,2021-06-07,885,8,27320,73,2021-06-07,1623020400.0
15489,93,4,2021-06-08,1118,6,28438,79,2021-06-08,1623106800.0
15490,93,4,2021-06-09,1139,3,29577,82,2021-06-09,1623193200.0
15491,93,4,2021-06-10,1195,5,30772,87,2021-06-10,1623279600.0
15492,93,4,2021-06-11,1329,14,32101,101,2021-06-11,1623366000.0
15493,93,4,2021-06-12,547,0,32648,101,2021-06-12,1623452400.0
15494,93,4,2021-06-13,52,0,32700,101,2021-06-13,1623538800.0
15495,93,4,2021-06-14,625,0,33325,101,2021-06-14,1623625200.0
15496,93,4,2021-06-15,986,6,34311,107,2021-06-15,1623711600.0
15497,93,4,2021-06-16,766,0,35077,107,2021-06-16,1623798000.0
15498,93,4,2021-06-17,894,2,35971,109,2021-06-17,1623884400.0
15499,93,4,2021-06-18,1088,6,37059,115,2021-06-18,1623970800.0
15500,93,4,2021-06-19,365,1,37424,116,2021-06-19,1624057200.0
15501,93,4,2021-06-20,47,0,37471,116,2021-06-20,1624143600.0
15502,93,4,2021-06-21,416,0,37887,116,2021-06-21,1624230000.0
15503,93,4,2021-06-22,701,3,38588,119,2021-06-22,1624316400.0
15504,93,4,2021-06-23,628,11,39216,130,2021-06-23,1624402800.0
15505,93,4,2021-06-24,788,6,40004,136,2021-06-24,1624489200.0
15506,93,4,2021-06-25,868,2,40872,138,2021-06-25,1624575600.0
15507,93,4,2021-06-26,330,3,41202,141,2021-06-26,1624662000.0
15508,93,4,2021-06-27,46,0,41248,141,2021-06-27,1624748400.0
15509,93,4,2021-06-28,486,0,41734,141,2021-06-28,1624834800.0
15510,93,4,2021-06-29,603,0,42337,141,2021-06-29,1624921200.0
15511,93,4,2021-06-30,697,4,43034,145,2021-06-30,1625007600.0
15512,93,4,2021-07-01,699,1,43733,146,2021-07-01,1625094000.0
15513,93,4,2021-07-02,811,5,44544,151,2021-07-02,1625180400.0
15514,93,4,2021-07-03,387,3,44931,154,2021-07-03,1625266800.0
15515,93,4,2021-07-04,33,2,44964,156,2021-07-04,1625353200.0
15516,93,4,2021-07-05,585,5,45549,161,2021-07-05,1625439600.0
15517,93,4,2021-07-06,758,1,46307,162,2021-07-06,1625526000.0
15518,93,4,2021-07-07,609,0,46916,162,2021-07-07,1625612400.0
15519,93,4,2021-07-08,781,5,47697,167,2021-07-08,1625698800.0
15520,94,1,2020-12-27,0,0,0,0,2020-12-27,1609023600.0
15521,94,1,2020-12-28,0,0,0,0,2020-12-28,1609110000.0
15522,94,1,2020-12-29,0,0,0,0,2020-12-29,1609196400.0
15523,94,1,2020-12-30,0,0,0,0,2020-12-30,1609282800.0
15524,94,1,2020-12-31,0,0,0,0,2020-12-31,1609369200.0
15525,94,1,2021-01-01,0,0,0,0,2021-01-01,1609455600.0
15526,94,1,2021-01-02,0,0,0,0,2021-01-02,1609542000.0
15527,94,1,2021-01-03,0,0,0,0,2021-01-03,1609628400.0
15528,94,1,2021-01-04,2,0,2,0,2021-01-04,1609714800.0
15529,94,1,2021-01-05,0,0,2,0,2021-01-05,1609801200.0
15530,94,1,2021-01-06,53,0,55,0,2021-01-06,1609887600.0
15531,94,1,2021-01-07,333,0,388,0,2021-01-07,1609974000.0
15532,94,1,2021-01-08,310,0,698,0,2021-01-08,1610060400.0
15533,94,1,2021-01-09,78,0,776,0,2021-01-09,1610146800.0
15534,94,1,2021-01-10,34,0,810,0,2021-01-10,1610233200.0
15535,94,1,2021-01-11,151,0,961,0,2021-01-11,1610319600.0
15536,94,1,2021-01-12,211,0,1172,0,2021-01-12,1610406000.0
15537,94,1,2021-01-13,203,0,1375,0,2021-01-13,1610492400.0
15538,94,1,2021-01-14,264,0,1639,0,2021-01-14,1610578800.0
15539,94,1,2021-01-15,405,0,2044,0,2021-01-15,1610665200.0
15540,94,1,2021-01-16,200,1,2244,1,2021-01-16,1610751600.0
15541,94,1,2021-01-17,91,1,2335,2,2021-01-17,1610838000.0
15542,94,1,2021-01-18,471,2,2806,4,2021-01-18,1610924400.0
15543,94,1,2021-01-19,982,0,3788,4,2021-01-19,1611010800.0
15544,94,1,2021-01-20,812,0,4600,4,2021-01-20,1611097200.0
15545,94,1,2021-01-21,808,1,5408,5,2021-01-21,1611183600.0
15546,94,1,2021-01-22,727,0,6135,5,2021-01-22,1611270000.0
15547,94,1,2021-01-23,243,0,6378,5,2021-01-23,1611356400.0
15548,94,1,2021-01-24,147,0,6525,5,2021-01-24,1611442800.0
15549,94,1,2021-01-25,422,2,6947,7,2021-01-25,1611529200.0
15550,94,1,2021-01-26,790,7,7737,14,2021-01-26,1611615600.0
15551,94,1,2021-01-27,663,55,8400,69,2021-01-27,1611702000.0
15552,94,1,2021-01-28,699,230,9099,299,2021-01-28,1611788400.0
15553,94,1,2021-01-29,626,229,9725,528,2021-01-29,1611874800.0
15554,94,1,2021-01-30,204,74,9929,602,2021-01-30,1611961200.0
15555,94,1,2021-01-31,150,11,10079,613,2021-01-31,1612047600.0
15556,94,1,2021-02-01,458,147,10537,760,2021-02-01,1612134000.0
15557,94,1,2021-02-02,643,195,11180,955,2021-02-02,1612220400.0
15558,94,1,2021-02-03,783,166,11963,1121,2021-02-03,1612306800.0
15559,94,1,2021-02-04,714,297,12677,1418,2021-02-04,1612393200.0
15560,94,1,2021-02-05,659,201,13336,1619,2021-02-05,1612479600.0
15561,94,1,2021-02-06,206,75,13542,1694,2021-02-06,1612566000.0
15562,94,1,2021-02-07,126,58,13668,1752,2021-02-07,1612652400.0
15563,94,1,2021-02-08,322,366,13990,2118,2021-02-08,1612738800.0
15564,94,1,2021-02-09,712,612,14702,2730,2021-02-09,1612825200.0
15565,94,1,2021-02-10,642,429,15344,3159,2021-02-10,1612911600.0
15566,94,1,2021-02-11,580,496,15924,3655,2021-02-11,1612998000.0
15567,94,1,2021-02-12,465,428,16389,4083,2021-02-12,1613084400.0
15568,94,1,2021-02-13,134,72,16523,4155,2021-02-13,1613170800.0
15569,94,1,2021-02-14,112,78,16635,4233,2021-02-14,1613257200.0
15570,94,1,2021-02-15,188,308,16823,4541,2021-02-15,1613343600.0
15571,94,1,2021-02-16,316,602,17139,5143,2021-02-16,1613430000.0
15572,94,1,2021-02-17,395,482,17534,5625,2021-02-17,1613516400.0
15573,94,1,2021-02-18,313,544,17847,6169,2021-02-18,1613602800.0
15574,94,1,2021-02-19,297,609,18144,6778,2021-02-19,1613689200.0
15575,94,1,2021-02-20,275,199,18419,6977,2021-02-20,1613775600.0
15576,94,1,2021-02-21,84,84,18503,7061,2021-02-21,1613862000.0
15577,94,1,2021-02-22,185,404,18688,7465,2021-02-22,1613948400.0
15578,94,1,2021-02-23,340,645,19028,8110,2021-02-23,1614034800.0
15579,94,1,2021-02-24,297,608,19325,8718,2021-02-24,1614121200.0
15580,94,1,2021-02-25,276,605,19601,9323,2021-02-25,1614207600.0
15581,94,1,2021-02-26,316,553,19917,9876,2021-02-26,1614294000.0
15582,94,1,2021-02-27,308,151,20225,10027,2021-02-27,1614380400.0
15583,94,1,2021-02-28,59,123,20284,10150,2021-02-28,1614466800.0
15584,94,1,2021-03-01,265,410,20549,10560,2021-03-01,1614553200.0
15585,94,1,2021-03-02,395,651,20944,11211,2021-03-02,1614639600.0
15586,94,1,2021-03-03,295,687,21239,11898,2021-03-03,1614726000.0
15587,94,1,2021-03-04,682,626,21921,12524,2021-03-04,1614812400.0
15588,94,1,2021-03-05,1192,663,23113,13187,2021-03-05,1614898800.0
15589,94,1,2021-03-06,1400,159,24513,13346,2021-03-06,1614985200.0
15590,94,1,2021-03-07,1143,97,25656,13443,2021-03-07,1615071600.0
15591,94,1,2021-03-08,979,318,26635,13761,2021-03-08,1615158000.0
15592,94,1,2021-03-09,816,649,27451,14410,2021-03-09,1615244400.0
15593,94,1,2021-03-10,848,566,28299,14976,2021-03-10,1615330800.0
15594,94,1,2021-03-11,677,520,28976,15496,2021-03-11,1615417200.0
15595,94,1,2021-03-12,856,341,29832,15837,2021-03-12,1615503600.0
15596,94,1,2021-03-13,673,138,30505,15975,2021-03-13,1615590000.0
15597,94,1,2021-03-14,389,97,30894,16072,2021-03-14,1615676400.0
15598,94,1,2021-03-15,678,228,31572,16300,2021-03-15,1615762800.0
15599,94,1,2021-03-16,1057,386,32629,16686,2021-03-16,1615849200.0
15600,94,1,2021-03-17,1225,340,33854,17026,2021-03-17,1615935600.0
15601,94,1,2021-03-18,962,306,34816,17332,2021-03-18,1616022000.0
15602,94,1,2021-03-19,1133,326,35949,17658,2021-03-19,1616108400.0
15603,94,1,2021-03-20,1379,283,37328,17941,2021-03-20,1616194800.0
15604,94,1,2021-03-21,470,73,37798,18014,2021-03-21,1616281200.0
15605,94,1,2021-03-22,772,181,38570,18195,2021-03-22,1616367600.0
15606,94,1,2021-03-23,1117,310,39687,18505,2021-03-23,1616454000.0
15607,94,1,2021-03-24,1133,292,40820,18797,2021-03-24,1616540400.0
15608,94,1,2021-03-25,1022,263,41842,19060,2021-03-25,1616626800.0
15609,94,1,2021-03-26,1224,320,43066,19380,2021-03-26,1616713200.0
15610,94,1,2021-03-27,1379,206,44445,19586,2021-03-27,1616799600.0
15611,94,1,2021-03-28,737,207,45182,19793,2021-03-28,1616886000.0
15612,94,1,2021-03-29,773,295,45955,20088,2021-03-29,1616972400.0
15613,94,1,2021-03-30,1125,542,47080,20630,2021-03-30,1617058800.0
15614,94,1,2021-03-31,1106,463,48186,21093,2021-03-31,1617145200.0
15615,94,1,2021-04-01,1141,652,49327,21745,2021-04-01,1617231600.0
15616,94,1,2021-04-02,1226,1171,50553,22916,2021-04-02,1617318000.0
15617,94,1,2021-04-03,565,1108,51118,24024,2021-04-03,1617404400.0
15618,94,1,2021-04-04,346,832,51464,24856,2021-04-04,1617490800.0
15619,94,1,2021-04-05,324,797,51788,25653,2021-04-05,1617577200.0
15620,94,1,2021-04-06,1414,874,53202,26527,2021-04-06,1617663600.0
15621,94,1,2021-04-07,1892,817,55094,27344,2021-04-07,1617750000.0
15622,94,1,2021-04-08,1923,722,57017,28066,2021-04-08,1617836400.0
15623,94,1,2021-04-09,1931,900,58948,28966,2021-04-09,1617922800.0
15624,94,1,2021-04-10,1603,552,60551,29518,2021-04-10,1618009200.0
15625,94,1,2021-04-11,600,297,61151,29815,2021-04-11,1618095600.0
15626,94,1,2021-04-12,1458,865,62609,30680,2021-04-12,1618185600.0
15627,94,1,2021-04-13,1315,985,63924,31665,2021-04-13,1618272000.0
15628,94,1,2021-04-14,2029,1041,65953,32706,2021-04-14,1618358400.0
15629,94,1,2021-04-15,1818,988,67771,33694,2021-04-15,1618444800.0
15630,94,1,2021-04-16,1752,992,69523,34686,2021-04-16,1618531200.0
15631,94,1,2021-04-17,1724,1098,71247,35784,2021-04-17,1618617600.0
15632,94,1,2021-04-18,1225,645,72472,36429,2021-04-18,1618704000.0
15633,94,1,2021-04-19,1077,743,73549,37172,2021-04-19,1618790400.0
15634,94,1,2021-04-20,1235,1150,74784,38322,2021-04-20,1618876800.0
15635,94,1,2021-04-21,1739,1106,76523,39428,2021-04-21,1618963200.0
15636,94,1,2021-04-22,1753,1107,78276,40535,2021-04-22,1619049600.0
15637,94,1,2021-04-23,1575,1052,79851,41587,2021-04-23,1619136000.0
15638,94,1,2021-04-24,1998,1018,81849,42605,2021-04-24,1619222400.0
15639,94,1,2021-04-25,1230,452,83079,43057,2021-04-25,1619308800.0
15640,94,1,2021-04-26,1002,1101,84081,44158,2021-04-26,1619395200.0
15641,94,1,2021-04-27,1295,1184,85376,45342,2021-04-27,1619481600.0
15642,94,1,2021-04-28,2551,1127,87927,46469,2021-04-28,1619568000.0
15643,94,1,2021-04-29,1913,1130,89840,47599,2021-04-29,1619654400.0
15644,94,1,2021-04-30,2189,1118,92029,48717,2021-04-30,1619740800.0
15645,94,1,2021-05-01,1234,361,93263,49078,2021-05-01,1619827200.0
15646,94,1,2021-05-02,1007,519,94270,49597,2021-05-02,1619913600.0
15647,94,1,2021-05-03,1567,754,95837,50351,2021-05-03,1620000000.0
15648,94,1,2021-05-04,1510,1532,97347,51883,2021-05-04,1620086400.0
15649,94,1,2021-05-05,1704,2083,99051,53966,2021-05-05,1620172800.0
15650,94,1,2021-05-06,2156,1554,101207,55520,2021-05-06,1620259200.0
15651,94,1,2021-05-07,2159,1552,103366,57072,2021-05-07,1620345600.0
15652,94,1,2021-05-08,831,700,104197,57772,2021-05-08,1620432000.0
15653,94,1,2021-05-09,1096,809,105293,58581,2021-05-09,1620518400.0
15654,94,1,2021-05-10,1350,1298,106643,59879,2021-05-10,1620604800.0
15655,94,1,2021-05-11,1544,1303,108187,61182,2021-05-11,1620691200.0
15656,94,1,2021-05-12,1725,1127,109912,62309,2021-05-12,1620777600.0
15657,94,1,2021-05-13,1939,352,111851,62661,2021-05-13,1620864000.0
15658,94,1,2021-05-14,1483,1025,113334,63686,2021-05-14,1620950400.0
15659,94,1,2021-05-15,1438,749,114772,64435,2021-05-15,1621036800.0
15660,94,1,2021-05-16,1024,576,115796,65011,2021-05-16,1621123200.0
15661,94,1,2021-05-17,1566,751,117362,65762,2021-05-17,1621206000.0
15662,94,1,2021-05-18,1565,616,118927,66378,2021-05-18,1621292400.0
15663,94,1,2021-05-19,1532,688,120459,67066,2021-05-19,1621378800.0
15664,94,1,2021-05-20,1260,569,121719,67635,2021-05-20,1621465200.0
15665,94,1,2021-05-21,1160,645,122879,68280,2021-05-21,1621551600.0
15666,94,1,2021-05-22,863,529,123742,68809,2021-05-22,1621638000.0
15667,94,1,2021-05-23,600,272,124342,69081,2021-05-23,1621724400.0
15668,94,1,2021-05-24,133,47,124475,69128,2021-05-24,1621810800.0
15669,94,1,2021-05-25,842,697,125317,69825,2021-05-25,1621897200.0
15670,94,1,2021-05-26,856,1696,126173,71521,2021-05-26,1621983600.0
15671,94,1,2021-05-27,648,1800,126821,73321,2021-05-27,1622070000.0
15672,94,1,2021-05-28,720,1499,127541,74820,2021-05-28,1622156400.0
15673,94,1,2021-05-29,596,1094,128137,75914,2021-05-29,1622242800.0
15674,94,1,2021-05-30,210,534,128347,76448,2021-05-30,1622329200.0
15675,94,1,2021-05-31,449,1039,128796,77487,2021-05-31,1622415600.0
15676,94,1,2021-06-01,598,1453,129394,78940,2021-06-01,1622502000.0
15677,94,1,2021-06-02,489,1669,129883,80609,2021-06-02,1622588400.0
15678,94,1,2021-06-03,603,1327,130486,81936,2021-06-03,1622674800.0
15679,94,1,2021-06-04,488,1994,130974,83930,2021-06-04,1622761200.0
15680,94,1,2021-06-05,444,1665,131418,85595,2021-06-05,1622847600.0
15681,94,1,2021-06-06,160,1002,131578,86597,2021-06-06,1622934000.0
15682,94,1,2021-06-07,331,1457,131909,88054,2021-06-07,1623020400.0
15683,94,1,2021-06-08,566,1668,132475,89722,2021-06-08,1623106800.0
15684,94,1,2021-06-09,700,2237,133175,91959,2021-06-09,1623193200.0
15685,94,1,2021-06-10,560,1528,133735,93487,2021-06-10,1623279600.0
15686,94,1,2021-06-11,539,1931,134274,95418,2021-06-11,1623366000.0
15687,94,1,2021-06-12,205,900,134479,96318,2021-06-12,1623452400.0
15688,94,1,2021-06-13,131,837,134610,97155,2021-06-13,1623538800.0
15689,94,1,2021-06-14,288,1839,134898,98994,2021-06-14,1623625200.0
15690,94,1,2021-06-15,410,1471,135308,100465,2021-06-15,1623711600.0
15691,94,1,2021-06-16,490,1417,135798,101882,2021-06-16,1623798000.0
15692,94,1,2021-06-17,465,1269,136263,103151,2021-06-17,1623884400.0
15693,94,1,2021-06-18,504,1510,136767,104661,2021-06-18,1623970800.0
15694,94,1,2021-06-19,299,883,137066,105544,2021-06-19,1624057200.0
15695,94,1,2021-06-20,161,851,137227,106395,2021-06-20,1624143600.0
15696,94,1,2021-06-21,390,1659,137617,108054,2021-06-21,1624230000.0
15697,94,1,2021-06-22,456,1802,138073,109856,2021-06-22,1624316400.0
15698,94,1,2021-06-23,353,1313,138426,111169,2021-06-23,1624402800.0
15699,94,1,2021-06-24,395,928,138821,112097,2021-06-24,1624489200.0
15700,94,1,2021-06-25,278,1184,139099,113281,2021-06-25,1624575600.0
15701,94,1,2021-06-26,255,1291,139354,114572,2021-06-26,1624662000.0
15702,94,1,2021-06-27,194,954,139548,115526,2021-06-27,1624748400.0
15703,94,1,2021-06-28,459,1454,140007,116980,2021-06-28,1624834800.0
15704,94,1,2021-06-29,431,1473,140438,118453,2021-06-29,1624921200.0
15705,94,1,2021-06-30,542,1245,140980,119698,2021-06-30,1625007600.0
15706,94,1,2021-07-01,339,798,141319,120496,2021-07-01,1625094000.0
15707,94,1,2021-07-02,313,693,141632,121189,2021-07-02,1625180400.0
15708,94,1,2021-07-03,250,825,141882,122014,2021-07-03,1625266800.0
15709,94,1,2021-07-04,167,540,142049,122554,2021-07-04,1625353200.0
15710,94,1,2021-07-05,394,720,142443,123274,2021-07-05,1625439600.0
15711,94,1,2021-07-06,616,761,143059,124035,2021-07-06,1625526000.0
15712,94,1,2021-07-07,744,1226,143803,125261,2021-07-07,1625612400.0
15713,94,1,2021-07-08,647,755,144450,126016,2021-07-08,1625698800.0
15714,94,2,2020-12-27,0,0,0,0,2020-12-27,1609023600.0
15715,94,2,2020-12-28,0,0,0,0,2020-12-28,1609110000.0
15716,94,2,2020-12-29,0,0,0,0,2020-12-29,1609196400.0
15717,94,2,2020-12-30,0,0,0,0,2020-12-30,1609282800.0
15718,94,2,2020-12-31,0,0,0,0,2020-12-31,1609369200.0
15719,94,2,2021-01-01,0,0,0,0,2021-01-01,1609455600.0
15720,94,2,2021-01-02,0,0,0,0,2021-01-02,1609542000.0
15721,94,2,2021-01-03,0,0,0,0,2021-01-03,1609628400.0
15722,94,2,2021-01-04,0,0,0,0,2021-01-04,1609714800.0
15723,94,2,2021-01-05,0,0,0,0,2021-01-05,1609801200.0
15724,94,2,2021-01-06,0,0,0,0,2021-01-06,1609887600.0
15725,94,2,2021-01-07,0,0,0,0,2021-01-07,1609974000.0
15726,94,2,2021-01-08,0,0,0,0,2021-01-08,1610060400.0
15727,94,2,2021-01-09,0,0,0,0,2021-01-09,1610146800.0
15728,94,2,2021-01-10,0,0,0,0,2021-01-10,1610233200.0
15729,94,2,2021-01-11,0,0,0,0,2021-01-11,1610319600.0
15730,94,2,2021-01-12,0,0,0,0,2021-01-12,1610406000.0
15731,94,2,2021-01-13,0,0,0,0,2021-01-13,1610492400.0
15732,94,2,2021-01-14,0,0,0,0,2021-01-14,1610578800.0
15733,94,2,2021-01-15,1,0,1,0,2021-01-15,1610665200.0
15734,94,2,2021-01-16,0,0,1,0,2021-01-16,1610751600.0
15735,94,2,2021-01-17,0,0,1,0,2021-01-17,1610838000.0
15736,94,2,2021-01-18,0,0,1,0,2021-01-18,1610924400.0
15737,94,2,2021-01-19,0,0,1,0,2021-01-19,1611010800.0
15738,94,2,2021-01-20,0,0,1,0,2021-01-20,1611097200.0
15739,94,2,2021-01-21,0,0,1,0,2021-01-21,1611183600.0
15740,94,2,2021-01-22,1,0,2,0,2021-01-22,1611270000.0
15741,94,2,2021-01-23,0,0,2,0,2021-01-23,1611356400.0
15742,94,2,2021-01-24,0,0,2,0,2021-01-24,1611442800.0
15743,94,2,2021-01-25,0,0,2,0,2021-01-25,1611529200.0
15744,94,2,2021-01-26,0,0,2,0,2021-01-26,1611615600.0
15745,94,2,2021-01-27,0,0,2,0,2021-01-27,1611702000.0
15746,94,2,2021-01-28,0,0,2,0,2021-01-28,1611788400.0
15747,94,2,2021-01-29,1,0,3,0,2021-01-29,1611874800.0
15748,94,2,2021-01-30,0,0,3,0,2021-01-30,1611961200.0
15749,94,2,2021-01-31,0,0,3,0,2021-01-31,1612047600.0
15750,94,2,2021-02-01,0,0,3,0,2021-02-01,1612134000.0
15751,94,2,2021-02-02,0,0,3,0,2021-02-02,1612220400.0
15752,94,2,2021-02-03,0,0,3,0,2021-02-03,1612306800.0
15753,94,2,2021-02-04,0,1,3,1,2021-02-04,1612393200.0
15754,94,2,2021-02-05,0,0,3,1,2021-02-05,1612479600.0
15755,94,2,2021-02-06,0,0,3,1,2021-02-06,1612566000.0
15756,94,2,2021-02-07,0,0,3,1,2021-02-07,1612652400.0
15757,94,2,2021-02-08,0,0,3,1,2021-02-08,1612738800.0
15758,94,2,2021-02-09,0,0,3,1,2021-02-09,1612825200.0
15759,94,2,2021-02-10,1,0,4,1,2021-02-10,1612911600.0
15760,94,2,2021-02-11,98,0,102,1,2021-02-11,1612998000.0
15761,94,2,2021-02-12,176,0,278,1,2021-02-12,1613084400.0
15762,94,2,2021-02-13,167,0,445,1,2021-02-13,1613170800.0
15763,94,2,2021-02-14,83,0,528,1,2021-02-14,1613257200.0
15764,94,2,2021-02-15,166,0,694,1,2021-02-15,1613343600.0
15765,94,2,2021-02-16,251,0,945,1,2021-02-16,1613430000.0
15766,94,2,2021-02-17,183,0,1128,1,2021-02-17,1613516400.0
15767,94,2,2021-02-18,233,0,1361,1,2021-02-18,1613602800.0
15768,94,2,2021-02-19,0,0,1361,1,2021-02-19,1613689200.0
15769,94,2,2021-02-20,0,0,1361,1,2021-02-20,1613775600.0
15770,94,2,2021-02-21,0,0,1361,1,2021-02-21,1613862000.0
15771,94,2,2021-02-22,0,0,1361,1,2021-02-22,1613948400.0
15772,94,2,2021-02-23,0,1,1361,2,2021-02-23,1614034800.0
15773,94,2,2021-02-24,0,0,1361,2,2021-02-24,1614121200.0
15774,94,2,2021-02-25,0,0,1361,2,2021-02-25,1614207600.0
15775,94,2,2021-02-26,0,1,1361,3,2021-02-26,1614294000.0
15776,94,2,2021-02-27,0,0,1361,3,2021-02-27,1614380400.0
15777,94,2,2021-02-28,0,0,1361,3,2021-02-28,1614466800.0
15778,94,2,2021-03-01,0,0,1361,3,2021-03-01,1614553200.0
15779,94,2,2021-03-02,1,0,1362,3,2021-03-02,1614639600.0
15780,94,2,2021-03-03,0,0,1362,3,2021-03-03,1614726000.0
15781,94,2,2021-03-04,0,0,1362,3,2021-03-04,1614812400.0
15782,94,2,2021-03-05,0,0,1362,3,2021-03-05,1614898800.0
15783,94,2,2021-03-06,0,0,1362,3,2021-03-06,1614985200.0
15784,94,2,2021-03-07,0,0,1362,3,2021-03-07,1615071600.0
15785,94,2,2021-03-08,0,0,1362,3,2021-03-08,1615158000.0
15786,94,2,2021-03-09,0,0,1362,3,2021-03-09,1615244400.0
15787,94,2,2021-03-10,0,0,1362,3,2021-03-10,1615330800.0
15788,94,2,2021-03-11,1,103,1363,106,2021-03-11,1615417200.0
15789,94,2,2021-03-12,4,188,1367,294,2021-03-12,1615503600.0
15790,94,2,2021-03-13,24,158,1391,452,2021-03-13,1615590000.0
15791,94,2,2021-03-14,2,86,1393,538,2021-03-14,1615676400.0
15792,94,2,2021-03-15,0,164,1393,702,2021-03-15,1615762800.0
15793,94,2,2021-03-16,2,243,1395,945,2021-03-16,1615849200.0
15794,94,2,2021-03-17,0,176,1395,1121,2021-03-17,1615935600.0
15795,94,2,2021-03-18,28,216,1423,1337,2021-03-18,1616022000.0
15796,94,2,2021-03-19,0,0,1423,1337,2021-03-19,1616108400.0
15797,94,2,2021-03-20,240,0,1663,1337,2021-03-20,1616194800.0
15798,94,2,2021-03-21,644,1,2307,1338,2021-03-21,1616281200.0
15799,94,2,2021-03-22,5,0,2312,1338,2021-03-22,1616367600.0
15800,94,2,2021-03-23,13,0,2325,1338,2021-03-23,1616454000.0
15801,94,2,2021-03-24,187,0,2512,1338,2021-03-24,1616540400.0
15802,94,2,2021-03-25,249,0,2761,1338,2021-03-25,1616626800.0
15803,94,2,2021-03-26,365,1,3126,1339,2021-03-26,1616713200.0
15804,94,2,2021-03-27,674,0,3800,1339,2021-03-27,1616799600.0
15805,94,2,2021-03-28,322,1,4122,1340,2021-03-28,1616886000.0
15806,94,2,2021-03-29,0,0,4122,1340,2021-03-29,1616972400.0
15807,94,2,2021-03-30,0,1,4122,1341,2021-03-30,1617058800.0
15808,94,2,2021-03-31,119,1,4241,1342,2021-03-31,1617145200.0
15809,94,2,2021-04-01,239,0,4480,1342,2021-04-01,1617231600.0
15810,94,2,2021-04-02,383,1,4863,1343,2021-04-02,1617318000.0
15811,94,2,2021-04-03,1279,1,6142,1344,2021-04-03,1617404400.0
15812,94,2,2021-04-04,406,0,6548,1344,2021-04-04,1617490800.0
15813,94,2,2021-04-05,294,0,6842,1344,2021-04-05,1617577200.0
15814,94,2,2021-04-06,106,0,6948,1344,2021-04-06,1617663600.0
15815,94,2,2021-04-07,35,1,6983,1345,2021-04-07,1617750000.0
15816,94,2,2021-04-08,85,0,7068,1345,2021-04-08,1617836400.0
15817,94,2,2021-04-09,42,0,7110,1345,2021-04-09,1617922800.0
15818,94,2,2021-04-10,757,28,7867,1373,2021-04-10,1618009200.0
15819,94,2,2021-04-11,572,0,8439,1373,2021-04-11,1618095600.0
15820,94,2,2021-04-12,7,5,8446,1378,2021-04-12,1618185600.0
15821,94,2,2021-04-13,0,0,8446,1378,2021-04-13,1618272000.0
15822,94,2,2021-04-14,7,4,8453,1382,2021-04-14,1618358400.0
15823,94,2,2021-04-15,0,0,8453,1382,2021-04-15,1618444800.0
15824,94,2,2021-04-16,0,0,8453,1382,2021-04-16,1618531200.0
15825,94,2,2021-04-17,9,246,8462,1628,2021-04-17,1618617600.0
15826,94,2,2021-04-18,9,623,8471,2251,2021-04-18,1618704000.0
15827,94,2,2021-04-19,0,0,8471,2251,2021-04-19,1618790400.0
15828,94,2,2021-04-20,0,0,8471,2251,2021-04-20,1618876800.0
15829,94,2,2021-04-21,3,187,8474,2438,2021-04-21,1618963200.0
15830,94,2,2021-04-22,6,232,8480,2670,2021-04-22,1619049600.0
15831,94,2,2021-04-23,19,298,8499,2968,2021-04-23,1619136000.0
15832,94,2,2021-04-24,12,689,8511,3657,2021-04-24,1619222400.0
15833,94,2,2021-04-25,31,303,8542,3960,2021-04-25,1619308800.0
15834,94,2,2021-04-26,0,18,8542,3978,2021-04-26,1619395200.0
15835,94,2,2021-04-27,0,0,8542,3978,2021-04-27,1619481600.0
15836,94,2,2021-04-28,0,60,8542,4038,2021-04-28,1619568000.0
15837,94,2,2021-04-29,0,0,8542,4038,2021-04-29,1619654400.0
15838,94,2,2021-04-30,1,617,8543,4655,2021-04-30,1619740800.0
15839,94,2,2021-05-01,182,1288,8725,5943,2021-05-01,1619827200.0
15840,94,2,2021-05-02,2,402,8727,6345,2021-05-02,1619913600.0
15841,94,2,2021-05-03,0,251,8727,6596,2021-05-03,1620000000.0
15842,94,2,2021-05-04,0,45,8727,6641,2021-05-04,1620086400.0
15843,94,2,2021-05-05,46,110,8773,6751,2021-05-05,1620172800.0
15844,94,2,2021-05-06,3,88,8776,6839,2021-05-06,1620259200.0
15845,94,2,2021-05-07,0,42,8776,6881,2021-05-07,1620345600.0
15846,94,2,2021-05-08,39,569,8815,7450,2021-05-08,1620432000.0
15847,94,2,2021-05-09,72,475,8887,7925,2021-05-09,1620518400.0
15848,94,2,2021-05-10,0,115,8887,8040,2021-05-10,1620604800.0
15849,94,2,2021-05-11,0,85,8887,8125,2021-05-11,1620691200.0
15850,94,2,2021-05-12,0,22,8887,8147,2021-05-12,1620777600.0
15851,94,2,2021-05-13,0,0,8887,8147,2021-05-13,1620864000.0
15852,94,2,2021-05-14,0,0,8887,8147,2021-05-14,1620950400.0
15853,94,2,2021-05-15,26,34,8913,8181,2021-05-15,1621036800.0
15854,94,2,2021-05-16,0,0,8913,8181,2021-05-16,1621123200.0
15855,94,2,2021-05-17,8,2,8921,8183,2021-05-17,1621206000.0
15856,94,2,2021-05-18,13,1,8934,8184,2021-05-18,1621292400.0
15857,94,2,2021-05-19,11,1,8945,8185,2021-05-19,1621378800.0
15858,94,2,2021-05-20,55,25,9000,8210,2021-05-20,1621465200.0
15859,94,2,2021-05-21,38,32,9038,8242,2021-05-21,1621551600.0
15860,94,2,2021-05-22,133,24,9171,8266,2021-05-22,1621638000.0
15861,94,2,2021-05-23,93,1,9264,8267,2021-05-23,1621724400.0
15862,94,2,2021-05-24,22,1,9286,8268,2021-05-24,1621810800.0
15863,94,2,2021-05-25,99,10,9385,8278,2021-05-25,1621897200.0
15864,94,2,2021-05-26,78,19,9463,8297,2021-05-26,1621983600.0
15865,94,2,2021-05-27,167,6,9630,8303,2021-05-27,1622070000.0
15866,94,2,2021-05-28,73,16,9703,8319,2021-05-28,1622156400.0
15867,94,2,2021-05-29,40,22,9743,8341,2021-05-29,1622242800.0
15868,94,2,2021-05-30,17,6,9760,8347,2021-05-30,1622329200.0
15869,94,2,2021-05-31,84,5,9844,8352,2021-05-31,1622415600.0
15870,94,2,2021-06-01,109,9,9953,8361,2021-06-01,1622502000.0
15871,94,2,2021-06-02,116,6,10069,8367,2021-06-02,1622588400.0
15872,94,2,2021-06-03,159,14,10228,8381,2021-06-03,1622674800.0
15873,94,2,2021-06-04,82,11,10310,8392,2021-06-04,1622761200.0
15874,94,2,2021-06-05,71,78,10381,8470,2021-06-05,1622847600.0
15875,94,2,2021-06-06,56,5,10437,8475,2021-06-06,1622934000.0
15876,94,2,2021-06-07,78,18,10515,8493,2021-06-07,1623020400.0
15877,94,2,2021-06-08,108,12,10623,8505,2021-06-08,1623106800.0
15878,94,2,2021-06-09,78,3,10701,8508,2021-06-09,1623193200.0
15879,94,2,2021-06-10,78,7,10779,8515,2021-06-10,1623279600.0
15880,94,2,2021-06-11,102,41,10881,8556,2021-06-11,1623366000.0
15881,94,2,2021-06-12,120,170,11001,8726,2021-06-12,1623452400.0
15882,94,2,2021-06-13,71,0,11072,8726,2021-06-13,1623538800.0
15883,94,2,2021-06-14,101,9,11173,8735,2021-06-14,1623625200.0
15884,94,2,2021-06-15,89,8,11262,8743,2021-06-15,1623711600.0
15885,94,2,2021-06-16,37,40,11299,8783,2021-06-16,1623798000.0
15886,94,2,2021-06-17,107,17,11406,8800,2021-06-17,1623884400.0
15887,94,2,2021-06-18,45,66,11451,8866,2021-06-18,1623970800.0
15888,94,2,2021-06-19,22,13,11473,8879,2021-06-19,1624057200.0
15889,94,2,2021-06-20,27,7,11500,8886,2021-06-20,1624143600.0
15890,94,2,2021-06-21,33,16,11533,8902,2021-06-21,1624230000.0
15891,94,2,2021-06-22,65,21,11598,8923,2021-06-22,1624316400.0
15892,94,2,2021-06-23,33,6,11631,8929,2021-06-23,1624402800.0
15893,94,2,2021-06-24,45,14,11676,8943,2021-06-24,1624489200.0
15894,94,2,2021-06-25,55,117,11731,9060,2021-06-25,1624575600.0
15895,94,2,2021-06-26,26,67,11757,9127,2021-06-26,1624662000.0
15896,94,2,2021-06-27,6,26,11763,9153,2021-06-27,1624748400.0
15897,94,2,2021-06-28,33,79,11796,9232,2021-06-28,1624834800.0
15898,94,2,2021-06-29,25,90,11821,9322,2021-06-29,1624921200.0
15899,94,2,2021-06-30,31,85,11852,9407,2021-06-30,1625007600.0
15900,94,2,2021-07-01,45,83,11897,9490,2021-07-01,1625094000.0
15901,94,2,2021-07-02,23,96,11920,9586,2021-07-02,1625180400.0
15902,94,2,2021-07-03,27,137,11947,9723,2021-07-03,1625266800.0
15903,94,2,2021-07-04,1,116,11948,9839,2021-07-04,1625353200.0
15904,94,2,2021-07-05,7,95,11955,9934,2021-07-05,1625439600.0
15905,94,2,2021-07-06,36,204,11991,10138,2021-07-06,1625526000.0
15906,94,2,2021-07-07,15,145,12006,10283,2021-07-07,1625612400.0
15907,94,2,2021-07-08,46,132,12052,10415,2021-07-08,1625698800.0
15908,94,3,2020-12-27,0,0,0,0,2020-12-27,1609023600.0
15909,94,3,2020-12-28,0,0,0,0,2020-12-28,1609110000.0
15910,94,3,2020-12-29,0,0,0,0,2020-12-29,1609196400.0
15911,94,3,2020-12-30,0,0,0,0,2020-12-30,1609282800.0
15912,94,3,2020-12-31,0,0,0,0,2020-12-31,1609369200.0
15913,94,3,2021-01-01,0,0,0,0,2021-01-01,1609455600.0
15914,94,3,2021-01-02,0,0,0,0,2021-01-02,1609542000.0
15915,94,3,2021-01-03,0,0,0,0,2021-01-03,1609628400.0
15916,94,3,2021-01-04,0,0,0,0,2021-01-04,1609714800.0
15917,94,3,2021-01-05,0,0,0,0,2021-01-05,1609801200.0
15918,94,3,2021-01-06,0,0,0,0,2021-01-06,1609887600.0
15919,94,3,2021-01-07,0,0,0,0,2021-01-07,1609974000.0
15920,94,3,2021-01-08,0,0,0,0,2021-01-08,1610060400.0
15921,94,3,2021-01-09,0,0,0,0,2021-01-09,1610146800.0
15922,94,3,2021-01-10,0,0,0,0,2021-01-10,1610233200.0
15923,94,3,2021-01-11,0,0,0,0,2021-01-11,1610319600.0
15924,94,3,2021-01-12,0,0,0,0,2021-01-12,1610406000.0
15925,94,3,2021-01-13,0,0,0,0,2021-01-13,1610492400.0
15926,94,3,2021-01-14,0,0,0,0,2021-01-14,1610578800.0
15927,94,3,2021-01-15,0,0,0,0,2021-01-15,1610665200.0
15928,94,3,2021-01-16,0,0,0,0,2021-01-16,1610751600.0
15929,94,3,2021-01-17,0,0,0,0,2021-01-17,1610838000.0
15930,94,3,2021-01-18,0,0,0,0,2021-01-18,1610924400.0
15931,94,3,2021-01-19,0,0,0,0,2021-01-19,1611010800.0
15932,94,3,2021-01-20,0,0,0,0,2021-01-20,1611097200.0
15933,94,3,2021-01-21,0,0,0,0,2021-01-21,1611183600.0
15934,94,3,2021-01-22,0,0,0,0,2021-01-22,1611270000.0
15935,94,3,2021-01-23,0,0,0,0,2021-01-23,1611356400.0
15936,94,3,2021-01-24,0,0,0,0,2021-01-24,1611442800.0
15937,94,3,2021-01-25,0,0,0,0,2021-01-25,1611529200.0
15938,94,3,2021-01-26,0,0,0,0,2021-01-26,1611615600.0
15939,94,3,2021-01-27,0,0,0,0,2021-01-27,1611702000.0
15940,94,3,2021-01-28,0,0,0,0,2021-01-28,1611788400.0
15941,94,3,2021-01-29,0,0,0,0,2021-01-29,1611874800.0
15942,94,3,2021-01-30,0,0,0,0,2021-01-30,1611961200.0
15943,94,3,2021-01-31,0,0,0,0,2021-01-31,1612047600.0
15944,94,3,2021-02-01,0,0,0,0,2021-02-01,1612134000.0
15945,94,3,2021-02-02,0,0,0,0,2021-02-02,1612220400.0
15946,94,3,2021-02-03,0,0,0,0,2021-02-03,1612306800.0
15947,94,3,2021-02-04,0,0,0,0,2021-02-04,1612393200.0
15948,94,3,2021-02-05,0,0,0,0,2021-02-05,1612479600.0
15949,94,3,2021-02-06,1,0,1,0,2021-02-06,1612566000.0
15950,94,3,2021-02-07,0,0,1,0,2021-02-07,1612652400.0
15951,94,3,2021-02-08,0,0,1,0,2021-02-08,1612738800.0
15952,94,3,2021-02-09,0,0,1,0,2021-02-09,1612825200.0
15953,94,3,2021-02-10,0,0,1,0,2021-02-10,1612911600.0
15954,94,3,2021-02-11,0,0,1,0,2021-02-11,1612998000.0
15955,94,3,2021-02-12,0,0,1,0,2021-02-12,1613084400.0
15956,94,3,2021-02-13,0,0,1,0,2021-02-13,1613170800.0
15957,94,3,2021-02-14,0,0,1,0,2021-02-14,1613257200.0
15958,94,3,2021-02-15,26,0,27,0,2021-02-15,1613343600.0
15959,94,3,2021-02-16,67,0,94,0,2021-02-16,1613430000.0
15960,94,3,2021-02-17,14,0,108,0,2021-02-17,1613516400.0
15961,94,3,2021-02-18,4,0,112,0,2021-02-18,1613602800.0
15962,94,3,2021-02-19,12,0,124,0,2021-02-19,1613689200.0
15963,94,3,2021-02-20,0,0,124,0,2021-02-20,1613775600.0
15964,94,3,2021-02-21,0,0,124,0,2021-02-21,1613862000.0
15965,94,3,2021-02-22,26,0,150,0,2021-02-22,1613948400.0
15966,94,3,2021-02-23,12,0,162,0,2021-02-23,1614034800.0
15967,94,3,2021-02-24,2,0,164,0,2021-02-24,1614121200.0
15968,94,3,2021-02-25,72,0,236,0,2021-02-25,1614207600.0
15969,94,3,2021-02-26,104,0,340,0,2021-02-26,1614294000.0
15970,94,3,2021-02-27,60,0,400,0,2021-02-27,1614380400.0
15971,94,3,2021-02-28,11,0,411,0,2021-02-28,1614466800.0
15972,94,3,2021-03-01,96,0,507,0,2021-03-01,1614553200.0
15973,94,3,2021-03-02,153,0,660,0,2021-03-02,1614639600.0
15974,94,3,2021-03-03,237,0,897,0,2021-03-03,1614726000.0
15975,94,3,2021-03-04,270,0,1167,0,2021-03-04,1614812400.0
15976,94,3,2021-03-05,392,0,1559,0,2021-03-05,1614898800.0
15977,94,3,2021-03-06,444,0,2003,0,2021-03-06,1614985200.0
15978,94,3,2021-03-07,238,0,2241,0,2021-03-07,1615071600.0
15979,94,3,2021-03-08,249,0,2490,0,2021-03-08,1615158000.0
15980,94,3,2021-03-09,497,0,2987,0,2021-03-09,1615244400.0
15981,94,3,2021-03-10,411,0,3398,0,2021-03-10,1615330800.0
15982,94,3,2021-03-11,629,0,4027,0,2021-03-11,1615417200.0
15983,94,3,2021-03-12,658,0,4685,0,2021-03-12,1615503600.0
15984,94,3,2021-03-13,421,0,5106,0,2021-03-13,1615590000.0
15985,94,3,2021-03-14,146,0,5252,0,2021-03-14,1615676400.0
15986,94,3,2021-03-15,208,0,5460,0,2021-03-15,1615762800.0
15987,94,3,2021-03-16,6,0,5466,0,2021-03-16,1615849200.0
15988,94,3,2021-03-17,0,0,5466,0,2021-03-17,1615935600.0
15989,94,3,2021-03-18,5,0,5471,0,2021-03-18,1616022000.0
15990,94,3,2021-03-19,153,0,5624,0,2021-03-19,1616108400.0
15991,94,3,2021-03-20,113,0,5737,0,2021-03-20,1616194800.0
15992,94,3,2021-03-21,12,0,5749,0,2021-03-21,1616281200.0
15993,94,3,2021-03-22,112,0,5861,0,2021-03-22,1616367600.0
15994,94,3,2021-03-23,172,0,6033,0,2021-03-23,1616454000.0
15995,94,3,2021-03-24,368,0,6401,0,2021-03-24,1616540400.0
15996,94,3,2021-03-25,482,0,6883,0,2021-03-25,1616626800.0
15997,94,3,2021-03-26,442,0,7325,0,2021-03-26,1616713200.0
15998,94,3,2021-03-27,220,0,7545,0,2021-03-27,1616799600.0
15999,94,3,2021-03-28,11,0,7556,0,2021-03-28,1616886000.0
16000,94,3,2021-03-29,252,0,7808,0,2021-03-29,1616972400.0
16001,94,3,2021-03-30,227,0,8035,0,2021-03-30,1617058800.0
16002,94,3,2021-03-31,202,1,8237,1,2021-03-31,1617145200.0
16003,94,3,2021-04-01,258,9,8495,10,2021-04-01,1617231600.0
16004,94,3,2021-04-02,256,0,8751,10,2021-04-02,1617318000.0
16005,94,3,2021-04-03,46,0,8797,10,2021-04-03,1617404400.0
16006,94,3,2021-04-04,19,1,8816,11,2021-04-04,1617490800.0
16007,94,3,2021-04-05,11,0,8827,11,2021-04-05,1617577200.0
16008,94,3,2021-04-06,59,2,8886,13,2021-04-06,1617663600.0
16009,94,3,2021-04-07,83,9,8969,22,2021-04-07,1617750000.0
16010,94,3,2021-04-08,166,1,9135,23,2021-04-08,1617836400.0
16011,94,3,2021-04-09,129,0,9264,23,2021-04-09,1617922800.0
16012,94,3,2021-04-10,42,0,9306,23,2021-04-10,1618009200.0
16013,94,3,2021-04-11,1,0,9307,23,2021-04-11,1618095600.0
16014,94,3,2021-04-12,52,1,9359,24,2021-04-12,1618185600.0
16015,94,3,2021-04-13,69,0,9428,24,2021-04-13,1618272000.0
16016,94,3,2021-04-14,52,0,9480,24,2021-04-14,1618358400.0
16017,94,3,2021-04-15,104,2,9584,26,2021-04-15,1618444800.0
16018,94,3,2021-04-16,25,0,9609,26,2021-04-16,1618531200.0
16019,94,3,2021-04-17,17,0,9626,26,2021-04-17,1618617600.0
16020,94,3,2021-04-18,0,0,9626,26,2021-04-18,1618704000.0
16021,94,3,2021-04-19,14,1,9640,27,2021-04-19,1618790400.0
16022,94,3,2021-04-20,15,0,9655,27,2021-04-20,1618876800.0
16023,94,3,2021-04-21,39,0,9694,27,2021-04-21,1618963200.0
16024,94,3,2021-04-22,73,0,9767,27,2021-04-22,1619049600.0
16025,94,3,2021-04-23,53,11,9820,38,2021-04-23,1619136000.0
16026,94,3,2021-04-24,20,2,9840,40,2021-04-24,1619222400.0
16027,94,3,2021-04-25,0,4,9840,44,2021-04-25,1619308800.0
16028,94,3,2021-04-26,13,1,9853,45,2021-04-26,1619395200.0
16029,94,3,2021-04-27,8,2,9861,47,2021-04-27,1619481600.0
16030,94,3,2021-04-28,26,12,9887,59,2021-04-28,1619568000.0
16031,94,3,2021-04-29,9,12,9896,71,2021-04-29,1619654400.0
16032,94,3,2021-04-30,20,41,9916,112,2021-04-30,1619740800.0
16033,94,3,2021-05-01,7,9,9923,121,2021-05-01,1619827200.0
16034,94,3,2021-05-02,0,2,9923,123,2021-05-02,1619913600.0
16035,94,3,2021-05-03,17,12,9940,135,2021-05-03,1620000000.0
16036,94,3,2021-05-04,33,45,9973,180,2021-05-04,1620086400.0
16037,94,3,2021-05-05,17,82,9990,262,2021-05-05,1620172800.0
16038,94,3,2021-05-06,15,99,10005,361,2021-05-06,1620259200.0
16039,94,3,2021-05-07,29,134,10034,495,2021-05-07,1620345600.0
16040,94,3,2021-05-08,5,62,10039,557,2021-05-08,1620432000.0
16041,94,3,2021-05-09,2,5,10041,562,2021-05-09,1620518400.0
16042,94,3,2021-05-10,2,66,10043,628,2021-05-10,1620604800.0
16043,94,3,2021-05-11,4,93,10047,721,2021-05-11,1620691200.0
16044,94,3,2021-05-12,23,149,10070,870,2021-05-12,1620777600.0
16045,94,3,2021-05-13,1,84,10071,954,2021-05-13,1620864000.0
16046,94,3,2021-05-14,12,147,10083,1101,2021-05-14,1620950400.0
16047,94,3,2021-05-15,3,162,10086,1263,2021-05-15,1621036800.0
16048,94,3,2021-05-16,0,48,10086,1311,2021-05-16,1621123200.0
16049,94,3,2021-05-17,4,159,10090,1470,2021-05-17,1621206000.0
16050,94,3,2021-05-18,1,167,10091,1637,2021-05-18,1621292400.0
16051,94,3,2021-05-19,5,146,10096,1783,2021-05-19,1621378800.0
16052,94,3,2021-05-20,16,235,10112,2018,2021-05-20,1621465200.0
16053,94,3,2021-05-21,9,225,10121,2243,2021-05-21,1621551600.0
16054,94,3,2021-05-22,3,84,10124,2327,2021-05-22,1621638000.0
16055,94,3,2021-05-23,0,33,10124,2360,2021-05-23,1621724400.0
16056,94,3,2021-05-24,0,79,10124,2439,2021-05-24,1621810800.0
16057,94,3,2021-05-25,2,70,10126,2509,2021-05-25,1621897200.0
16058,94,3,2021-05-26,11,175,10137,2684,2021-05-26,1621983600.0
16059,94,3,2021-05-27,10,380,10147,3064,2021-05-27,1622070000.0
16060,94,3,2021-05-28,11,230,10158,3294,2021-05-28,1622156400.0
16061,94,3,2021-05-29,3,97,10161,3391,2021-05-29,1622242800.0
16062,94,3,2021-05-30,1,0,10162,3391,2021-05-30,1622329200.0
16063,94,3,2021-05-31,4,158,10166,3549,2021-05-31,1622415600.0
16064,94,3,2021-06-01,2,230,10168,3779,2021-06-01,1622502000.0
16065,94,3,2021-06-02,3,191,10171,3970,2021-06-02,1622588400.0
16066,94,3,2021-06-03,6,254,10177,4224,2021-06-03,1622674800.0
16067,94,3,2021-06-04,4,285,10181,4509,2021-06-04,1622761200.0
16068,94,3,2021-06-05,2,122,10183,4631,2021-06-05,1622847600.0
16069,94,3,2021-06-06,0,18,10183,4649,2021-06-06,1622934000.0
16070,94,3,2021-06-07,1,81,10184,4730,2021-06-07,1623020400.0
16071,94,3,2021-06-08,1,124,10185,4854,2021-06-08,1623106800.0
16072,94,3,2021-06-09,1,169,10186,5023,2021-06-09,1623193200.0
16073,94,3,2021-06-10,6,170,10192,5193,2021-06-10,1623279600.0
16074,94,3,2021-06-11,9,241,10201,5434,2021-06-11,1623366000.0
16075,94,3,2021-06-12,1,80,10202,5514,2021-06-12,1623452400.0
16076,94,3,2021-06-13,1,1,10203,5515,2021-06-13,1623538800.0
16077,94,3,2021-06-14,4,138,10207,5653,2021-06-14,1623625200.0
16078,94,3,2021-06-15,2,162,10209,5815,2021-06-15,1623711600.0
16079,94,3,2021-06-16,3,171,10212,5986,2021-06-16,1623798000.0
16080,94,3,2021-06-17,4,270,10216,6256,2021-06-17,1623884400.0
16081,94,3,2021-06-18,2,238,10218,6494,2021-06-18,1623970800.0
16082,94,3,2021-06-19,3,80,10221,6574,2021-06-19,1624057200.0
16083,94,3,2021-06-20,0,12,10221,6586,2021-06-20,1624143600.0
16084,94,3,2021-06-21,0,40,10221,6626,2021-06-21,1624230000.0
16085,94,3,2021-06-22,1,74,10222,6700,2021-06-22,1624316400.0
16086,94,3,2021-06-23,1,76,10223,6776,2021-06-23,1624402800.0
16087,94,3,2021-06-24,6,135,10229,6911,2021-06-24,1624489200.0
16088,94,3,2021-06-25,2,185,10231,7096,2021-06-25,1624575600.0
16089,94,3,2021-06-26,2,23,10233,7119,2021-06-26,1624662000.0
16090,94,3,2021-06-27,0,4,10233,7123,2021-06-27,1624748400.0
16091,94,3,2021-06-28,2,55,10235,7178,2021-06-28,1624834800.0
16092,94,3,2021-06-29,0,54,10235,7232,2021-06-29,1624921200.0
16093,94,3,2021-06-30,2,28,10237,7260,2021-06-30,1625007600.0
16094,94,3,2021-07-01,0,35,10237,7295,2021-07-01,1625094000.0
16095,94,3,2021-07-02,0,58,10237,7353,2021-07-02,1625180400.0
16096,94,3,2021-07-03,1,3,10238,7356,2021-07-03,1625266800.0
16097,94,3,2021-07-04,0,0,10238,7356,2021-07-04,1625353200.0
16098,94,3,2021-07-05,0,30,10238,7386,2021-07-05,1625439600.0
16099,94,3,2021-07-06,3,22,10241,7408,2021-07-06,1625526000.0
16100,94,3,2021-07-07,5,43,10246,7451,2021-07-07,1625612400.0
16101,94,3,2021-07-08,3,64,10249,7515,2021-07-08,1625698800.0
16102,94,4,2020-12-27,0,0,0,0,2020-12-27,1609023600.0
16103,94,4,2020-12-28,0,0,0,0,2020-12-28,1609110000.0
16104,94,4,2020-12-29,0,0,0,0,2020-12-29,1609196400.0
16105,94,4,2020-12-30,0,0,0,0,2020-12-30,1609282800.0
16106,94,4,2020-12-31,0,0,0,0,2020-12-31,1609369200.0
16107,94,4,2021-01-01,0,0,0,0,2021-01-01,1609455600.0
16108,94,4,2021-01-02,0,0,0,0,2021-01-02,1609542000.0
16109,94,4,2021-01-03,0,0,0,0,2021-01-03,1609628400.0
16110,94,4,2021-01-04,0,0,0,0,2021-01-04,1609714800.0
16111,94,4,2021-01-05,0,0,0,0,2021-01-05,1609801200.0
16112,94,4,2021-01-06,0,0,0,0,2021-01-06,1609887600.0
16113,94,4,2021-01-07,0,0,0,0,2021-01-07,1609974000.0
16114,94,4,2021-01-08,0,0,0,0,2021-01-08,1610060400.0
16115,94,4,2021-01-09,0,0,0,0,2021-01-09,1610146800.0
16116,94,4,2021-01-10,0,0,0,0,2021-01-10,1610233200.0
16117,94,4,2021-01-11,0,0,0,0,2021-01-11,1610319600.0
16118,94,4,2021-01-12,0,0,0,0,2021-01-12,1610406000.0
16119,94,4,2021-01-13,0,0,0,0,2021-01-13,1610492400.0
16120,94,4,2021-01-14,0,0,0,0,2021-01-14,1610578800.0
16121,94,4,2021-01-15,0,0,0,0,2021-01-15,1610665200.0
16122,94,4,2021-01-16,0,0,0,0,2021-01-16,1610751600.0
16123,94,4,2021-01-17,0,0,0,0,2021-01-17,1610838000.0
16124,94,4,2021-01-18,0,0,0,0,2021-01-18,1610924400.0
16125,94,4,2021-01-19,0,0,0,0,2021-01-19,1611010800.0
16126,94,4,2021-01-20,0,0,0,0,2021-01-20,1611097200.0
16127,94,4,2021-01-21,0,0,0,0,2021-01-21,1611183600.0
16128,94,4,2021-01-22,0,0,0,0,2021-01-22,1611270000.0
16129,94,4,2021-01-23,0,0,0,0,2021-01-23,1611356400.0
16130,94,4,2021-01-24,0,0,0,0,2021-01-24,1611442800.0
16131,94,4,2021-01-25,0,0,0,0,2021-01-25,1611529200.0
16132,94,4,2021-01-26,0,0,0,0,2021-01-26,1611615600.0
16133,94,4,2021-01-27,0,0,0,0,2021-01-27,1611702000.0
16134,94,4,2021-01-28,0,0,0,0,2021-01-28,1611788400.0
16135,94,4,2021-01-29,0,0,0,0,2021-01-29,1611874800.0
16136,94,4,2021-01-30,0,0,0,0,2021-01-30,1611961200.0
16137,94,4,2021-01-31,0,0,0,0,2021-01-31,1612047600.0
16138,94,4,2021-02-01,0,0,0,0,2021-02-01,1612134000.0
16139,94,4,2021-02-02,0,0,0,0,2021-02-02,1612220400.0
16140,94,4,2021-02-03,0,0,0,0,2021-02-03,1612306800.0
16141,94,4,2021-02-04,0,0,0,0,2021-02-04,1612393200.0
16142,94,4,2021-02-05,0,0,0,0,2021-02-05,1612479600.0
16143,94,4,2021-02-06,0,0,0,0,2021-02-06,1612566000.0
16144,94,4,2021-02-07,0,0,0,0,2021-02-07,1612652400.0
16145,94,4,2021-02-08,0,0,0,0,2021-02-08,1612738800.0
16146,94,4,2021-02-09,0,0,0,0,2021-02-09,1612825200.0
16147,94,4,2021-02-10,0,0,0,0,2021-02-10,1612911600.0
16148,94,4,2021-02-11,0,0,0,0,2021-02-11,1612998000.0
16149,94,4,2021-02-12,0,0,0,0,2021-02-12,1613084400.0
16150,94,4,2021-02-13,0,0,0,0,2021-02-13,1613170800.0
16151,94,4,2021-02-14,0,0,0,0,2021-02-14,1613257200.0
16152,94,4,2021-02-15,0,0,0,0,2021-02-15,1613343600.0
16153,94,4,2021-02-16,0,0,0,0,2021-02-16,1613430000.0
16154,94,4,2021-02-17,0,0,0,0,2021-02-17,1613516400.0
16155,94,4,2021-02-18,0,0,0,0,2021-02-18,1613602800.0
16156,94,4,2021-02-19,0,0,0,0,2021-02-19,1613689200.0
16157,94,4,2021-02-20,0,0,0,0,2021-02-20,1613775600.0
16158,94,4,2021-02-21,0,0,0,0,2021-02-21,1613862000.0
16159,94,4,2021-02-22,0,0,0,0,2021-02-22,1613948400.0
16160,94,4,2021-02-23,0,0,0,0,2021-02-23,1614034800.0
16161,94,4,2021-02-24,0,0,0,0,2021-02-24,1614121200.0
16162,94,4,2021-02-25,0,0,0,0,2021-02-25,1614207600.0
16163,94,4,2021-02-26,0,0,0,0,2021-02-26,1614294000.0
16164,94,4,2021-02-27,0,0,0,0,2021-02-27,1614380400.0
16165,94,4,2021-02-28,0,0,0,0,2021-02-28,1614466800.0
16166,94,4,2021-03-01,0,0,0,0,2021-03-01,1614553200.0
16167,94,4,2021-03-02,0,0,0,0,2021-03-02,1614639600.0
16168,94,4,2021-03-03,0,0,0,0,2021-03-03,1614726000.0
16169,94,4,2021-03-04,0,0,0,0,2021-03-04,1614812400.0
16170,94,4,2021-03-05,0,0,0,0,2021-03-05,1614898800.0
16171,94,4,2021-03-06,0,0,0,0,2021-03-06,1614985200.0
16172,94,4,2021-03-07,0,0,0,0,2021-03-07,1615071600.0
16173,94,4,2021-03-08,0,0,0,0,2021-03-08,1615158000.0
16174,94,4,2021-03-09,0,0,0,0,2021-03-09,1615244400.0
16175,94,4,2021-03-10,0,0,0,0,2021-03-10,1615330800.0
16176,94,4,2021-03-11,0,0,0,0,2021-03-11,1615417200.0
16177,94,4,2021-03-12,0,0,0,0,2021-03-12,1615503600.0
16178,94,4,2021-03-13,0,0,0,0,2021-03-13,1615590000.0
16179,94,4,2021-03-14,0,0,0,0,2021-03-14,1615676400.0
16180,94,4,2021-03-15,0,0,0,0,2021-03-15,1615762800.0
16181,94,4,2021-03-16,0,0,0,0,2021-03-16,1615849200.0
16182,94,4,2021-03-17,0,0,0,0,2021-03-17,1615935600.0
16183,94,4,2021-03-18,0,0,0,0,2021-03-18,1616022000.0
16184,94,4,2021-03-19,0,0,0,0,2021-03-19,1616108400.0
16185,94,4,2021-03-20,0,0,0,0,2021-03-20,1616194800.0
16186,94,4,2021-03-21,0,0,0,0,2021-03-21,1616281200.0
16187,94,4,2021-03-22,0,0,0,0,2021-03-22,1616367600.0
16188,94,4,2021-03-23,0,0,0,0,2021-03-23,1616454000.0
16189,94,4,2021-03-24,0,0,0,0,2021-03-24,1616540400.0
16190,94,4,2021-03-25,0,0,0,0,2021-03-25,1616626800.0
16191,94,4,2021-03-26,0,0,0,0,2021-03-26,1616713200.0
16192,94,4,2021-03-27,0,0,0,0,2021-03-27,1616799600.0
16193,94,4,2021-03-28,0,0,0,0,2021-03-28,1616886000.0
16194,94,4,2021-03-29,0,0,0,0,2021-03-29,1616972400.0
16195,94,4,2021-03-30,0,0,0,0,2021-03-30,1617058800.0
16196,94,4,2021-03-31,0,0,0,0,2021-03-31,1617145200.0
16197,94,4,2021-04-01,0,0,0,0,2021-04-01,1617231600.0
16198,94,4,2021-04-02,0,0,0,0,2021-04-02,1617318000.0
16199,94,4,2021-04-03,0,0,0,0,2021-04-03,1617404400.0
16200,94,4,2021-04-04,0,0,0,0,2021-04-04,1617490800.0
16201,94,4,2021-04-05,0,0,0,0,2021-04-05,1617577200.0
16202,94,4,2021-04-06,0,0,0,0,2021-04-06,1617663600.0
16203,94,4,2021-04-07,0,0,0,0,2021-04-07,1617750000.0
16204,94,4,2021-04-08,0,0,0,0,2021-04-08,1617836400.0
16205,94,4,2021-04-09,0,0,0,0,2021-04-09,1617922800.0
16206,94,4,2021-04-10,0,0,0,0,2021-04-10,1618009200.0
16207,94,4,2021-04-11,0,0,0,0,2021-04-11,1618095600.0
16208,94,4,2021-04-12,0,0,0,0,2021-04-12,1618185600.0
16209,94,4,2021-04-13,0,0,0,0,2021-04-13,1618272000.0
16210,94,4,2021-04-14,0,0,0,0,2021-04-14,1618358400.0
16211,94,4,2021-04-15,0,0,0,0,2021-04-15,1618444800.0
16212,94,4,2021-04-16,0,0,0,0,2021-04-16,1618531200.0
16213,94,4,2021-04-17,0,0,0,0,2021-04-17,1618617600.0
16214,94,4,2021-04-18,0,0,0,0,2021-04-18,1618704000.0
16215,94,4,2021-04-19,0,0,0,0,2021-04-19,1618790400.0
16216,94,4,2021-04-20,0,0,0,0,2021-04-20,1618876800.0
16217,94,4,2021-04-21,0,0,0,0,2021-04-21,1618963200.0
16218,94,4,2021-04-22,0,0,0,0,2021-04-22,1619049600.0
16219,94,4,2021-04-23,0,0,0,0,2021-04-23,1619136000.0
16220,94,4,2021-04-24,0,0,0,0,2021-04-24,1619222400.0
16221,94,4,2021-04-25,0,0,0,0,2021-04-25,1619308800.0
16222,94,4,2021-04-26,0,0,0,0,2021-04-26,1619395200.0
16223,94,4,2021-04-27,5,0,5,0,2021-04-27,1619481600.0
16224,94,4,2021-04-28,11,0,16,0,2021-04-28,1619568000.0
16225,94,4,2021-04-29,47,0,63,0,2021-04-29,1619654400.0
16226,94,4,2021-04-30,52,0,115,0,2021-04-30,1619740800.0
16227,94,4,2021-05-01,0,0,115,0,2021-05-01,1619827200.0
16228,94,4,2021-05-02,0,0,115,0,2021-05-02,1619913600.0
16229,94,4,2021-05-03,16,0,131,0,2021-05-03,1620000000.0
16230,94,4,2021-05-04,14,0,145,0,2021-05-04,1620086400.0
16231,94,4,2021-05-05,43,0,188,0,2021-05-05,1620172800.0
16232,94,4,2021-05-06,13,0,201,0,2021-05-06,1620259200.0
16233,94,4,2021-05-07,26,0,227,0,2021-05-07,1620345600.0
16234,94,4,2021-05-08,1,0,228,0,2021-05-08,1620432000.0
16235,94,4,2021-05-09,5,0,233,0,2021-05-09,1620518400.0
16236,94,4,2021-05-10,21,0,254,0,2021-05-10,1620604800.0
16237,94,4,2021-05-11,33,1,287,1,2021-05-11,1620691200.0
16238,94,4,2021-05-12,22,0,309,1,2021-05-12,1620777600.0
16239,94,4,2021-05-13,0,0,309,1,2021-05-13,1620864000.0
16240,94,4,2021-05-14,18,0,327,1,2021-05-14,1620950400.0
16241,94,4,2021-05-15,12,0,339,1,2021-05-15,1621036800.0
16242,94,4,2021-05-16,8,0,347,1,2021-05-16,1621123200.0
16243,94,4,2021-05-17,4,0,351,1,2021-05-17,1621206000.0
16244,94,4,2021-05-18,23,0,374,1,2021-05-18,1621292400.0
16245,94,4,2021-05-19,3,0,377,1,2021-05-19,1621378800.0
16246,94,4,2021-05-20,24,0,401,1,2021-05-20,1621465200.0
16247,94,4,2021-05-21,29,0,430,1,2021-05-21,1621551600.0
16248,94,4,2021-05-22,16,0,446,1,2021-05-22,1621638000.0
16249,94,4,2021-05-23,5,0,451,1,2021-05-23,1621724400.0
16250,94,4,2021-05-24,10,0,461,1,2021-05-24,1621810800.0
16251,94,4,2021-05-25,18,0,479,1,2021-05-25,1621897200.0
16252,94,4,2021-05-26,23,0,502,1,2021-05-26,1621983600.0
16253,94,4,2021-05-27,16,0,518,1,2021-05-27,1622070000.0
16254,94,4,2021-05-28,40,0,558,1,2021-05-28,1622156400.0
16255,94,4,2021-05-29,9,0,567,1,2021-05-29,1622242800.0
16256,94,4,2021-05-30,0,0,567,1,2021-05-30,1622329200.0
16257,94,4,2021-05-31,23,0,590,1,2021-05-31,1622415600.0
16258,94,4,2021-06-01,36,0,626,1,2021-06-01,1622502000.0
16259,94,4,2021-06-02,31,0,657,1,2021-06-02,1622588400.0
16260,94,4,2021-06-03,23,0,680,1,2021-06-03,1622674800.0
16261,94,4,2021-06-04,37,0,717,1,2021-06-04,1622761200.0
16262,94,4,2021-06-05,49,0,766,1,2021-06-05,1622847600.0
16263,94,4,2021-06-06,5,0,771,1,2021-06-06,1622934000.0
16264,94,4,2021-06-07,28,0,799,1,2021-06-07,1623020400.0
16265,94,4,2021-06-08,29,0,828,1,2021-06-08,1623106800.0
16266,94,4,2021-06-09,22,1,850,2,2021-06-09,1623193200.0
16267,94,4,2021-06-10,32,0,882,2,2021-06-10,1623279600.0
16268,94,4,2021-06-11,44,0,926,2,2021-06-11,1623366000.0
16269,94,4,2021-06-12,29,0,955,2,2021-06-12,1623452400.0
16270,94,4,2021-06-13,1,0,956,2,2021-06-13,1623538800.0
16271,94,4,2021-06-14,28,0,984,2,2021-06-14,1623625200.0
16272,94,4,2021-06-15,48,0,1032,2,2021-06-15,1623711600.0
16273,94,4,2021-06-16,47,0,1079,2,2021-06-16,1623798000.0
16274,94,4,2021-06-17,40,1,1119,3,2021-06-17,1623884400.0
16275,94,4,2021-06-18,24,0,1143,3,2021-06-18,1623970800.0
16276,94,4,2021-06-19,17,0,1160,3,2021-06-19,1624057200.0
16277,94,4,2021-06-20,0,0,1160,3,2021-06-20,1624143600.0
16278,94,4,2021-06-21,12,0,1172,3,2021-06-21,1624230000.0
16279,94,4,2021-06-22,20,0,1192,3,2021-06-22,1624316400.0
16280,94,4,2021-06-23,15,0,1207,3,2021-06-23,1624402800.0
16281,94,4,2021-06-24,17,0,1224,3,2021-06-24,1624489200.0
16282,94,4,2021-06-25,33,0,1257,3,2021-06-25,1624575600.0
16283,94,4,2021-06-26,17,0,1274,3,2021-06-26,1624662000.0
16284,94,4,2021-06-27,2,0,1276,3,2021-06-27,1624748400.0
16285,94,4,2021-06-28,17,0,1293,3,2021-06-28,1624834800.0
16286,94,4,2021-06-29,15,0,1308,3,2021-06-29,1624921200.0
16287,94,4,2021-06-30,29,0,1337,3,2021-06-30,1625007600.0
16288,94,4,2021-07-01,26,0,1363,3,2021-07-01,1625094000.0
16289,94,4,2021-07-02,23,0,1386,3,2021-07-02,1625180400.0
16290,94,4,2021-07-03,14,0,1400,3,2021-07-03,1625266800.0
16291,94,4,2021-07-04,0,0,1400,3,2021-07-04,1625353200.0
16292,94,4,2021-07-05,21,0,1421,3,2021-07-05,1625439600.0
16293,94,4,2021-07-06,34,0,1455,3,2021-07-06,1625526000.0
16294,94,4,2021-07-07,26,0,1481,3,2021-07-07,1625612400.0
16295,94,4,2021-07-08,37,0,1518,3,2021-07-08,1625698800.0
16296,1,0,2020-12-27,0,0,0,0,2020-12-27,1609023600.0
16297,1,0,2020-12-28,0,0,0,0,2020-12-28,1609110000.0
16298,1,0,2020-12-29,0,0,0,0,2020-12-29,1609196400.0
16299,1,0,2020-12-30,0,0,0,0,2020-12-30,1609282800.0
16300,1,0,2020-12-31,0,0,0,0,2020-12-31,1609369200.0
16301,1,0,2021-01-01,1,0,1,0,2021-01-01,1609455600.0
16302,1,0,2021-01-02,0,0,1,0,2021-01-02,1609542000.0
16303,1,0,2021-01-03,0,0,1,0,2021-01-03,1609628400.0
16304,1,0,2021-01-04,1,0,2,0,2021-01-04,1609714800.0
16305,1,0,2021-01-05,0,0,2,0,2021-01-05,1609801200.0
16306,1,0,2021-01-06,1,0,3,0,2021-01-06,1609887600.0
16307,1,0,2021-01-07,0,0,3,0,2021-01-07,1609974000.0
16308,1,0,2021-01-08,49,0,52,0,2021-01-08,1610060400.0
16309,1,0,2021-01-09,18,0,70,0,2021-01-09,1610146800.0
16310,1,0,2021-01-10,0,0,70,0,2021-01-10,1610233200.0
16311,1,0,2021-01-11,55,0,125,0,2021-01-11,1610319600.0
16312,1,0,2021-01-12,44,0,169,0,2021-01-12,1610406000.0
16313,1,0,2021-01-13,45,0,214,0,2021-01-13,1610492400.0
16314,1,0,2021-01-14,61,0,275,0,2021-01-14,1610578800.0
16315,1,0,2021-01-15,76,0,351,0,2021-01-15,1610665200.0
16316,1,0,2021-01-16,0,0,351,0,2021-01-16,1610751600.0
16317,1,0,2021-01-17,0,0,351,0,2021-01-17,1610838000.0
16318,1,0,2021-01-18,75,0,426,0,2021-01-18,1610924400.0
16319,1,0,2021-01-19,143,0,569,0,2021-01-19,1611010800.0
16320,1,0,2021-01-20,134,0,703,0,2021-01-20,1611097200.0
16321,1,0,2021-01-21,150,0,853,0,2021-01-21,1611183600.0
16322,1,0,2021-01-22,132,0,985,0,2021-01-22,1611270000.0
16323,1,0,2021-01-23,1,0,986,0,2021-01-23,1611356400.0
16324,1,0,2021-01-24,0,0,986,0,2021-01-24,1611442800.0
16325,1,0,2021-01-25,203,0,1189,0,2021-01-25,1611529200.0
16326,1,0,2021-01-26,211,0,1400,0,2021-01-26,1611615600.0
16327,1,0,2021-01-27,234,0,1634,0,2021-01-27,1611702000.0
16328,1,0,2021-01-28,238,2,1872,2,2021-01-28,1611788400.0
16329,1,0,2021-01-29,197,0,2069,2,2021-01-29,1611874800.0
16330,1,0,2021-01-30,17,0,2086,2,2021-01-30,1611961200.0
16331,1,0,2021-01-31,1,0,2087,2,2021-01-31,1612047600.0
16332,1,0,2021-02-01,222,3,2309,5,2021-02-01,1612134000.0
16333,1,0,2021-02-02,242,24,2551,29,2021-02-02,1612220400.0
16334,1,0,2021-02-03,213,1,2764,30,2021-02-03,1612306800.0
16335,1,0,2021-02-04,300,19,3064,49,2021-02-04,1612393200.0
16336,1,0,2021-02-05,253,32,3317,81,2021-02-05,1612479600.0
16337,1,0,2021-02-06,49,1,3366,82,2021-02-06,1612566000.0
16338,1,0,2021-02-07,0,0,3366,82,2021-02-07,1612652400.0
16339,1,0,2021-02-08,223,20,3589,102,2021-02-08,1612738800.0
16340,1,0,2021-02-09,291,27,3880,129,2021-02-09,1612825200.0
16341,1,0,2021-02-10,222,28,4102,157,2021-02-10,1612911600.0
16342,1,0,2021-02-11,293,108,4395,265,2021-02-11,1612998000.0
16343,1,0,2021-02-12,283,23,4678,288,2021-02-12,1613084400.0
16344,1,0,2021-02-13,50,7,4728,295,2021-02-13,1613170800.0
16345,1,0,2021-02-14,19,36,4747,331,2021-02-14,1613257200.0
16346,1,0,2021-02-15,72,43,4819,374,2021-02-15,1613343600.0
16347,1,0,2021-02-16,16,0,4835,374,2021-02-16,1613430000.0
16348,1,0,2021-02-17,17,0,4852,374,2021-02-17,1613516400.0
16349,1,0,2021-02-18,220,16,5072,390,2021-02-18,1613602800.0
16350,1,0,2021-02-19,230,19,5302,409,2021-02-19,1613689200.0
16351,1,0,2021-02-20,47,0,5349,409,2021-02-20,1613775600.0
16352,1,0,2021-02-21,1,0,5350,409,2021-02-21,1613862000.0
16353,1,0,2021-02-22,157,54,5507,463,2021-02-22,1613948400.0
16354,1,0,2021-02-23,189,70,5696,533,2021-02-23,1614034800.0
16355,1,0,2021-02-24,316,119,6012,652,2021-02-24,1614121200.0
16356,1,0,2021-02-25,369,75,6381,727,2021-02-25,1614207600.0
16357,1,0,2021-02-26,210,81,6591,808,2021-02-26,1614294000.0
16358,1,0,2021-02-27,63,0,6654,808,2021-02-27,1614380400.0
16359,1,0,2021-02-28,1,0,6655,808,2021-02-28,1614466800.0
16360,1,0,2021-03-01,140,80,6795,888,2021-03-01,1614553200.0
16361,1,0,2021-03-02,241,127,7036,1015,2021-03-02,1614639600.0
16362,1,0,2021-03-03,211,118,7247,1133,2021-03-03,1614726000.0
16363,1,0,2021-03-04,305,80,7552,1213,2021-03-04,1614812400.0
16364,1,0,2021-03-05,331,141,7883,1354,2021-03-05,1614898800.0
16365,1,0,2021-03-06,586,1,8469,1355,2021-03-06,1614985200.0
16366,1,0,2021-03-07,1,0,8470,1355,2021-03-07,1615071600.0
16367,1,0,2021-03-08,282,130,8752,1485,2021-03-08,1615158000.0
16368,1,0,2021-03-09,358,149,9110,1634,2021-03-09,1615244400.0
16369,1,0,2021-03-10,372,153,9482,1787,2021-03-10,1615330800.0
16370,1,0,2021-03-11,120,43,9602,1830,2021-03-11,1615417200.0
16371,1,0,2021-03-12,416,205,10018,2035,2021-03-12,1615503600.0
16372,1,0,2021-03-13,132,1,10150,2036,2021-03-13,1615590000.0
16373,1,0,2021-03-14,13,23,10163,2059,2021-03-14,1615676400.0
16374,1,0,2021-03-15,410,37,10573,2096,2021-03-15,1615762800.0
16375,1,0,2021-03-16,451,73,11024,2169,2021-03-16,1615849200.0
16376,1,0,2021-03-17,423,78,11447,2247,2021-03-17,1615935600.0
16377,1,0,2021-03-18,541,99,11988,2346,2021-03-18,1616022000.0
16378,1,0,2021-03-19,529,92,12517,2438,2021-03-19,1616108400.0
16379,1,0,2021-03-20,174,43,12691,2481,2021-03-20,1616194800.0
16380,1,0,2021-03-21,8,0,12699,2481,2021-03-21,1616281200.0
16381,1,0,2021-03-22,335,79,13034,2560,2021-03-22,1616367600.0
16382,1,0,2021-03-23,483,150,13517,2710,2021-03-23,1616454000.0
16383,1,0,2021-03-24,457,103,13974,2813,2021-03-24,1616540400.0
16384,1,0,2021-03-25,731,170,14705,2983,2021-03-25,1616626800.0
16385,1,0,2021-03-26,635,116,15340,3099,2021-03-26,1616713200.0
16386,1,0,2021-03-27,269,42,15609,3141,2021-03-27,1616799600.0
16387,1,0,2021-03-28,7,0,15616,3141,2021-03-28,1616886000.0
16388,1,0,2021-03-29,360,78,15976,3219,2021-03-29,1616972400.0
16389,1,0,2021-03-30,617,154,16593,3373,2021-03-30,1617058800.0
16390,1,0,2021-03-31,526,118,17119,3491,2021-03-31,1617145200.0
16391,1,0,2021-04-01,622,191,17741,3682,2021-04-01,1617231600.0
16392,1,0,2021-04-02,38,35,17779,3717,2021-04-02,1617318000.0
16393,1,0,2021-04-03,44,2,17823,3719,2021-04-03,1617404400.0
16394,1,0,2021-04-04,4,18,17827,3737,2021-04-04,1617490800.0
16395,1,0,2021-04-05,11,0,17838,3737,2021-04-05,1617577200.0
16396,1,0,2021-04-06,438,179,18276,3916,2021-04-06,1617663600.0
16397,1,0,2021-04-07,568,111,18844,4027,2021-04-07,1617750000.0
16398,1,0,2021-04-08,487,152,19331,4179,2021-04-08,1617836400.0
16399,1,0,2021-04-09,481,197,19812,4376,2021-04-09,1617922800.0
16400,1,0,2021-04-10,96,4,19908,4380,2021-04-10,1618009200.0
16401,1,0,2021-04-11,2,25,19910,4405,2021-04-11,1618095600.0
16402,1,0,2021-04-12,282,250,20192,4655,2021-04-12,1618185600.0
16403,1,0,2021-04-13,551,309,20743,4964,2021-04-13,1618272000.0
16404,1,0,2021-04-14,428,217,21171,5181,2021-04-14,1618358400.0
16405,1,0,2021-04-15,550,307,21721,5488,2021-04-15,1618444800.0
16406,1,0,2021-04-16,551,260,22272,5748,2021-04-16,1618531200.0
16407,1,0,2021-04-17,192,2,22464,5750,2021-04-17,1618617600.0
16408,1,0,2021-04-18,4,14,22468,5764,2021-04-18,1618704000.0
16409,1,0,2021-04-19,388,234,22856,5998,2021-04-19,1618790400.0
16410,1,0,2021-04-20,722,325,23578,6323,2021-04-20,1618876800.0
16411,1,0,2021-04-21,618,305,24196,6628,2021-04-21,1618963200.0
16412,1,0,2021-04-22,804,320,25000,6948,2021-04-22,1619049600.0
16413,1,0,2021-04-23,842,232,25842,7180,2021-04-23,1619136000.0
16414,1,0,2021-04-24,376,68,26218,7248,2021-04-24,1619222400.0
16415,1,0,2021-04-25,591,60,26809,7308,2021-04-25,1619308800.0
16416,1,0,2021-04-26,942,195,27751,7503,2021-04-26,1619395200.0
16417,1,0,2021-04-27,652,211,28403,7714,2021-04-27,1619481600.0
16418,1,0,2021-04-28,837,248,29240,7962,2021-04-28,1619568000.0
16419,1,0,2021-04-29,1193,169,30433,8131,2021-04-29,1619654400.0
16420,1,0,2021-04-30,1258,152,31691,8283,2021-04-30,1619740800.0
16421,1,0,2021-05-01,594,37,32285,8320,2021-05-01,1619827200.0
16422,1,0,2021-05-02,345,13,32630,8333,2021-05-02,1619913600.0
16423,1,0,2021-05-03,917,158,33547,8491,2021-05-03,1620000000.0
16424,1,0,2021-05-04,954,183,34501,8674,2021-05-04,1620086400.0
16425,1,0,2021-05-05,1002,224,35503,8898,2021-05-05,1620172800.0
16426,1,0,2021-05-06,1143,143,36646,9041,2021-05-06,1620259200.0
16427,1,0,2021-05-07,1235,234,37881,9275,2021-05-07,1620345600.0
16428,1,0,2021-05-08,316,21,38197,9296,2021-05-08,1620432000.0
16429,1,0,2021-05-09,178,3,38375,9299,2021-05-09,1620518400.0
16430,1,0,2021-05-10,832,188,39207,9487,2021-05-10,1620604800.0
16431,1,0,2021-05-11,956,281,40163,9768,2021-05-11,1620691200.0
16432,1,0,2021-05-12,894,295,41057,10063,2021-05-12,1620777600.0
16433,1,0,2021-05-13,211,75,41268,10138,2021-05-13,1620864000.0
16434,1,0,2021-05-14,859,257,42127,10395,2021-05-14,1620950400.0
16435,1,0,2021-05-15,475,9,42602,10404,2021-05-15,1621036800.0
16436,1,0,2021-05-16,182,30,42784,10434,2021-05-16,1621123200.0
16437,1,0,2021-05-17,707,243,43491,10677,2021-05-17,1621206000.0
16438,1,0,2021-05-18,723,359,44214,11036,2021-05-18,1621292400.0
16439,1,0,2021-05-19,694,504,44908,11540,2021-05-19,1621378800.0
16440,1,0,2021-05-20,775,346,45683,11886,2021-05-20,1621465200.0
16441,1,0,2021-05-21,813,390,46496,12276,2021-05-21,1621551600.0
16442,1,0,2021-05-22,493,211,46989,12487,2021-05-22,1621638000.0
16443,1,0,2021-05-23,201,109,47190,12596,2021-05-23,1621724400.0
16444,1,0,2021-05-24,199,174,47389,12770,2021-05-24,1621810800.0
16445,1,0,2021-05-25,534,654,47923,13424,2021-05-25,1621897200.0
16446,1,0,2021-05-26,584,483,48507,13907,2021-05-26,1621983600.0
16447,1,0,2021-05-27,130,181,48637,14088,2021-05-27,1622070000.0
16448,1,0,2021-05-28,516,505,49153,14593,2021-05-28,1622156400.0
16449,1,0,2021-05-29,227,134,49380,14727,2021-05-29,1622242800.0
16450,1,0,2021-05-30,71,111,49451,14838,2021-05-30,1622329200.0
16451,1,0,2021-05-31,434,528,49885,15366,2021-05-31,1622415600.0
16452,1,0,2021-06-01,562,699,50447,16065,2021-06-01,1622502000.0
16453,1,0,2021-06-02,565,682,51012,16747,2021-06-02,1622588400.0
16454,1,0,2021-06-03,495,547,51507,17294,2021-06-03,1622674800.0
16455,1,0,2021-06-04,742,778,52249,18072,2021-06-04,1622761200.0
16456,1,0,2021-06-05,313,632,52562,18704,2021-06-05,1622847600.0
16457,1,0,2021-06-06,122,522,52684,19226,2021-06-06,1622934000.0
16458,1,0,2021-06-07,420,762,53104,19988,2021-06-07,1623020400.0
16459,1,0,2021-06-08,524,868,53628,20856,2021-06-08,1623106800.0
16460,1,0,2021-06-09,464,847,54092,21703,2021-06-09,1623193200.0
16461,1,0,2021-06-10,497,825,54589,22528,2021-06-10,1623279600.0
16462,1,0,2021-06-11,450,1210,55039,23738,2021-06-11,1623366000.0
16463,1,0,2021-06-12,289,652,55328,24390,2021-06-12,1623452400.0
16464,1,0,2021-06-13,128,311,55456,24701,2021-06-13,1623538800.0
16465,1,0,2021-06-14,352,3789,55808,28490,2021-06-14,1623625200.0
16466,1,0,2021-06-15,461,1987,56269,30477,2021-06-15,1623711600.0
16467,1,0,2021-06-16,462,1461,56731,31938,2021-06-16,1623798000.0
16468,1,0,2021-06-17,417,991,57148,32929,2021-06-17,1623884400.0
16469,1,0,2021-06-18,453,1001,57601,33930,2021-06-18,1623970800.0
16470,1,0,2021-06-19,294,495,57895,34425,2021-06-19,1624057200.0
16471,1,0,2021-06-20,108,224,58003,34649,2021-06-20,1624143600.0
16472,1,0,2021-06-21,317,662,58320,35311,2021-06-21,1624230000.0
16473,1,0,2021-06-22,311,853,58631,36164,2021-06-22,1624316400.0
16474,1,0,2021-06-23,348,867,58979,37031,2021-06-23,1624402800.0
16475,1,0,2021-06-24,377,704,59356,37735,2021-06-24,1624489200.0
16476,1,0,2021-06-25,438,742,59794,38477,2021-06-25,1624575600.0
16477,1,0,2021-06-26,292,504,60086,38981,2021-06-26,1624662000.0
16478,1,0,2021-06-27,106,168,60192,39149,2021-06-27,1624748400.0
16479,1,0,2021-06-28,285,672,60477,39821,2021-06-28,1624834800.0
16480,1,0,2021-06-29,355,744,60832,40565,2021-06-29,1624921200.0
16481,1,0,2021-06-30,402,891,61234,41456,2021-06-30,1625007600.0
16482,1,0,2021-07-01,336,625,61570,42081,2021-07-01,1625094000.0
16483,1,0,2021-07-02,413,653,61983,42734,2021-07-02,1625180400.0
16484,1,0,2021-07-03,266,443,62249,43177,2021-07-03,1625266800.0
16485,1,0,2021-07-04,110,228,62359,43405,2021-07-04,1625353200.0
16486,1,0,2021-07-05,314,487,62673,43892,2021-07-05,1625439600.0
16487,1,0,2021-07-06,360,742,63033,44634,2021-07-06,1625526000.0
16488,1,0,2021-07-07,369,823,63402,45457,2021-07-07,1625612400.0
16489,1,0,2021-07-08,345,760,63747,46217,2021-07-08,1625698800.0
16490,2,0,2020-12-27,0,0,0,0,2020-12-27,1609023600.0
16491,2,0,2020-12-28,0,0,0,0,2020-12-28,1609110000.0
16492,2,0,2020-12-29,0,0,0,0,2020-12-29,1609196400.0
16493,2,0,2020-12-30,0,0,0,0,2020-12-30,1609282800.0
16494,2,0,2020-12-31,0,0,0,0,2020-12-31,1609369200.0
16495,2,0,2021-01-01,0,0,0,0,2021-01-01,1609455600.0
16496,2,0,2021-01-02,0,0,0,0,2021-01-02,1609542000.0
16497,2,0,2021-01-03,0,0,0,0,2021-01-03,1609628400.0
16498,2,0,2021-01-04,0,0,0,0,2021-01-04,1609714800.0
16499,2,0,2021-01-05,0,0,0,0,2021-01-05,1609801200.0
16500,2,0,2021-01-06,5,0,5,0,2021-01-06,1609887600.0
16501,2,0,2021-01-07,31,0,36,0,2021-01-07,1609974000.0
16502,2,0,2021-01-08,81,0,117,0,2021-01-08,1610060400.0
16503,2,0,2021-01-09,20,0,137,0,2021-01-09,1610146800.0
16504,2,0,2021-01-10,0,0,137,0,2021-01-10,1610233200.0
16505,2,0,2021-01-11,122,0,259,0,2021-01-11,1610319600.0
16506,2,0,2021-01-12,78,0,337,0,2021-01-12,1610406000.0
16507,2,0,2021-01-13,64,0,401,0,2021-01-13,1610492400.0
16508,2,0,2021-01-14,88,0,489,0,2021-01-14,1610578800.0
16509,2,0,2021-01-15,136,0,625,0,2021-01-15,1610665200.0
16510,2,0,2021-01-16,51,0,676,0,2021-01-16,1610751600.0
16511,2,0,2021-01-17,0,0,676,0,2021-01-17,1610838000.0
16512,2,0,2021-01-18,157,0,833,0,2021-01-18,1610924400.0
16513,2,0,2021-01-19,168,0,1001,0,2021-01-19,1611010800.0
16514,2,0,2021-01-20,164,0,1165,0,2021-01-20,1611097200.0
16515,2,0,2021-01-21,181,0,1346,0,2021-01-21,1611183600.0
16516,2,0,2021-01-22,156,0,1502,0,2021-01-22,1611270000.0
16517,2,0,2021-01-23,58,0,1560,0,2021-01-23,1611356400.0
16518,2,0,2021-01-24,0,0,1560,0,2021-01-24,1611442800.0
16519,2,0,2021-01-25,160,0,1720,0,2021-01-25,1611529200.0
16520,2,0,2021-01-26,137,0,1857,0,2021-01-26,1611615600.0
16521,2,0,2021-01-27,162,5,2019,5,2021-01-27,1611702000.0
16522,2,0,2021-01-28,143,12,2162,17,2021-01-28,1611788400.0
16523,2,0,2021-01-29,143,41,2305,58,2021-01-29,1611874800.0
16524,2,0,2021-01-30,96,16,2401,74,2021-01-30,1611961200.0
16525,2,0,2021-01-31,0,0,2401,74,2021-01-31,1612047600.0
16526,2,0,2021-02-01,119,73,2520,147,2021-02-01,1612134000.0
16527,2,0,2021-02-02,184,95,2704,242,2021-02-02,1612220400.0
16528,2,0,2021-02-03,131,80,2835,322,2021-02-03,1612306800.0
16529,2,0,2021-02-04,158,73,2993,395,2021-02-04,1612393200.0
16530,2,0,2021-02-05,120,97,3113,492,2021-02-05,1612479600.0
16531,2,0,2021-02-06,62,26,3175,518,2021-02-06,1612566000.0
16532,2,0,2021-02-07,1,0,3176,518,2021-02-07,1612652400.0
16533,2,0,2021-02-08,137,78,3313,596,2021-02-08,1612738800.0
16534,2,0,2021-02-09,176,78,3489,674,2021-02-09,1612825200.0
16535,2,0,2021-02-10,138,90,3627,764,2021-02-10,1612911600.0
16536,2,0,2021-02-11,150,103,3777,867,2021-02-11,1612998000.0
16537,2,0,2021-02-12,124,128,3901,995,2021-02-12,1613084400.0
16538,2,0,2021-02-13,38,37,3939,1032,2021-02-13,1613170800.0
16539,2,0,2021-02-14,0,0,3939,1032,2021-02-14,1613257200.0
16540,2,0,2021-02-15,51,67,3990,1099,2021-02-15,1613343600.0
16541,2,0,2021-02-16,0,1,3990,1100,2021-02-16,1613430000.0
16542,2,0,2021-02-17,1,3,3991,1103,2021-02-17,1613516400.0
16543,2,0,2021-02-18,68,127,4059,1230,2021-02-18,1613602800.0
16544,2,0,2021-02-19,69,131,4128,1361,2021-02-19,1613689200.0
16545,2,0,2021-02-20,48,69,4176,1430,2021-02-20,1613775600.0
16546,2,0,2021-02-21,0,0,4176,1430,2021-02-21,1613862000.0
16547,2,0,2021-02-22,102,60,4278,1490,2021-02-22,1613948400.0
16548,2,0,2021-02-23,113,238,4391,1728,2021-02-23,1614034800.0
16549,2,0,2021-02-24,106,223,4497,1951,2021-02-24,1614121200.0
16550,2,0,2021-02-25,89,148,4586,2099,2021-02-25,1614207600.0
16551,2,0,2021-02-26,127,168,4713,2267,2021-02-26,1614294000.0
16552,2,0,2021-02-27,69,52,4782,2319,2021-02-27,1614380400.0
16553,2,0,2021-02-28,0,0,4782,2319,2021-02-28,1614466800.0
16554,2,0,2021-03-01,138,143,4920,2462,2021-03-01,1614553200.0
16555,2,0,2021-03-02,158,78,5078,2540,2021-03-02,1614639600.0
16556,2,0,2021-03-03,179,142,5257,2682,2021-03-03,1614726000.0
16557,2,0,2021-03-04,145,133,5402,2815,2021-03-04,1614812400.0
16558,2,0,2021-03-05,238,127,5640,2942,2021-03-05,1614898800.0
16559,2,0,2021-03-06,119,58,5759,3000,2021-03-06,1614985200.0
16560,2,0,2021-03-07,100,0,5859,3000,2021-03-07,1615071600.0
16561,2,0,2021-03-08,196,129,6055,3129,2021-03-08,1615158000.0
16562,2,0,2021-03-09,269,102,6324,3231,2021-03-09,1615244400.0
16563,2,0,2021-03-10,323,133,6647,3364,2021-03-10,1615330800.0
16564,2,0,2021-03-11,334,77,6981,3441,2021-03-11,1615417200.0
16565,2,0,2021-03-12,398,49,7379,3490,2021-03-12,1615503600.0
16566,2,0,2021-03-13,155,21,7534,3511,2021-03-13,1615590000.0
16567,2,0,2021-03-14,4,1,7538,3512,2021-03-14,1615676400.0
16568,2,0,2021-03-15,276,92,7814,3604,2021-03-15,1615762800.0
16569,2,0,2021-03-16,305,52,8119,3656,2021-03-16,1615849200.0
16570,2,0,2021-03-17,387,41,8506,3697,2021-03-17,1615935600.0
16571,2,0,2021-03-18,435,39,8941,3736,2021-03-18,1616022000.0
16572,2,0,2021-03-19,396,56,9337,3792,2021-03-19,1616108400.0
16573,2,0,2021-03-20,149,47,9486,3839,2021-03-20,1616194800.0
16574,2,0,2021-03-21,25,1,9511,3840,2021-03-21,1616281200.0
16575,2,0,2021-03-22,362,113,9873,3953,2021-03-22,1616367600.0
16576,2,0,2021-03-23,401,116,10274,4069,2021-03-23,1616454000.0
16577,2,0,2021-03-24,427,97,10701,4166,2021-03-24,1616540400.0
16578,2,0,2021-03-25,474,87,11175,4253,2021-03-25,1616626800.0
16579,2,0,2021-03-26,632,86,11807,4339,2021-03-26,1616713200.0
16580,2,0,2021-03-27,152,68,11959,4407,2021-03-27,1616799600.0
16581,2,0,2021-03-28,81,2,12040,4409,2021-03-28,1616886000.0
16582,2,0,2021-03-29,421,157,12461,4566,2021-03-29,1616972400.0
16583,2,0,2021-03-30,469,234,12930,4800,2021-03-30,1617058800.0
16584,2,0,2021-03-31,1143,174,14073,4974,2021-03-31,1617145200.0
16585,2,0,2021-04-01,951,163,15024,5137,2021-04-01,1617231600.0
16586,2,0,2021-04-02,895,3,15919,5140,2021-04-02,1617318000.0
16587,2,0,2021-04-03,788,37,16707,5177,2021-04-03,1617404400.0
16588,2,0,2021-04-04,750,2,17457,5179,2021-04-04,1617490800.0
16589,2,0,2021-04-05,828,9,18285,5188,2021-04-05,1617577200.0
16590,2,0,2021-04-06,883,108,19168,5296,2021-04-06,1617663600.0
16591,2,0,2021-04-07,1435,288,20603,5584,2021-04-07,1617750000.0
16592,2,0,2021-04-08,1306,237,21909,5821,2021-04-08,1617836400.0
16593,2,0,2021-04-09,1239,300,23148,6121,2021-04-09,1617922800.0
16594,2,0,2021-04-10,838,143,23986,6264,2021-04-10,1618009200.0
16595,2,0,2021-04-11,621,4,24607,6268,2021-04-11,1618095600.0
16596,2,0,2021-04-12,868,282,25475,6550,2021-04-12,1618185600.0
16597,2,0,2021-04-13,867,310,26342,6860,2021-04-13,1618272000.0
16598,2,0,2021-04-14,957,314,27299,7174,2021-04-14,1618358400.0
16599,2,0,2021-04-15,958,279,28257,7453,2021-04-15,1618444800.0
16600,2,0,2021-04-16,991,281,29248,7734,2021-04-16,1618531200.0
16601,2,0,2021-04-17,528,149,29776,7883,2021-04-17,1618617600.0
16602,2,0,2021-04-18,339,49,30115,7932,2021-04-18,1618704000.0
16603,2,0,2021-04-19,668,327,30783,8259,2021-04-19,1618790400.0
16604,2,0,2021-04-20,869,294,31652,8553,2021-04-20,1618876800.0
16605,2,0,2021-04-21,999,339,32651,8892,2021-04-21,1618963200.0
16606,2,0,2021-04-22,602,293,33253,9185,2021-04-22,1619049600.0
16607,2,0,2021-04-23,606,447,33859,9632,2021-04-23,1619136000.0
16608,2,0,2021-04-24,360,189,34219,9821,2021-04-24,1619222400.0
16609,2,0,2021-04-25,168,198,34387,10019,2021-04-25,1619308800.0
16610,2,0,2021-04-26,515,530,34902,10549,2021-04-26,1619395200.0
16611,2,0,2021-04-27,564,602,35466,11151,2021-04-27,1619481600.0
16612,2,0,2021-04-28,449,683,35915,11834,2021-04-28,1619568000.0
16613,2,0,2021-04-29,652,622,36567,12456,2021-04-29,1619654400.0
16614,2,0,2021-04-30,771,666,37338,13122,2021-04-30,1619740800.0
16615,2,0,2021-05-01,243,244,37581,13366,2021-05-01,1619827200.0
16616,2,0,2021-05-02,226,504,37807,13870,2021-05-02,1619913600.0
16617,2,0,2021-05-03,569,759,38376,14629,2021-05-03,1620000000.0
16618,2,0,2021-05-04,524,660,38900,15289,2021-05-04,1620086400.0
16619,2,0,2021-05-05,541,887,39441,16176,2021-05-05,1620172800.0
16620,2,0,2021-05-06,546,769,39987,16945,2021-05-06,1620259200.0
16621,2,0,2021-05-07,629,998,40616,17943,2021-05-07,1620345600.0
16622,2,0,2021-05-08,224,516,40840,18459,2021-05-08,1620432000.0
16623,2,0,2021-05-09,173,505,41013,18964,2021-05-09,1620518400.0
16624,2,0,2021-05-10,519,839,41532,19803,2021-05-10,1620604800.0
16625,2,0,2021-05-11,477,866,42009,20669,2021-05-11,1620691200.0
16626,2,0,2021-05-12,556,880,42565,21549,2021-05-12,1620777600.0
16627,2,0,2021-05-13,273,520,42838,22069,2021-05-13,1620864000.0
16628,2,0,2021-05-14,388,737,43226,22806,2021-05-14,1620950400.0
16629,2,0,2021-05-15,233,576,43459,23382,2021-05-15,1621036800.0
16630,2,0,2021-05-16,155,437,43614,23819,2021-05-16,1621123200.0
16631,2,0,2021-05-17,472,741,44086,24560,2021-05-17,1621206000.0
16632,2,0,2021-05-18,446,665,44532,25225,2021-05-18,1621292400.0
16633,2,0,2021-05-19,451,717,44983,25942,2021-05-19,1621378800.0
16634,2,0,2021-05-20,593,477,45576,26419,2021-05-20,1621465200.0
16635,2,0,2021-05-21,545,689,46121,27108,2021-05-21,1621551600.0
16636,2,0,2021-05-22,185,361,46306,27469,2021-05-22,1621638000.0
16637,2,0,2021-05-23,110,179,46416,27648,2021-05-23,1621724400.0
16638,2,0,2021-05-24,135,234,46551,27882,2021-05-24,1621810800.0
16639,2,0,2021-05-25,350,693,46901,28575,2021-05-25,1621897200.0
16640,2,0,2021-05-26,381,690,47282,29265,2021-05-26,1621983600.0
16641,2,0,2021-05-27,265,641,47547,29906,2021-05-27,1622070000.0
16642,2,0,2021-05-28,275,806,47822,30712,2021-05-28,1622156400.0
16643,2,0,2021-05-29,152,507,47974,31219,2021-05-29,1622242800.0
16644,2,0,2021-05-30,17,30,47991,31249,2021-05-30,1622329200.0
16645,2,0,2021-05-31,342,657,48333,31906,2021-05-31,1622415600.0
16646,2,0,2021-06-01,296,523,48629,32429,2021-06-01,1622502000.0
16647,2,0,2021-06-02,319,544,48948,32973,2021-06-02,1622588400.0
16648,2,0,2021-06-03,246,425,49194,33398,2021-06-03,1622674800.0
16649,2,0,2021-06-04,349,621,49543,34019,2021-06-04,1622761200.0
16650,2,0,2021-06-05,257,328,49800,34347,2021-06-05,1622847600.0
16651,2,0,2021-06-06,22,31,49822,34378,2021-06-06,1622934000.0
16652,2,0,2021-06-07,259,729,50081,35107,2021-06-07,1623020400.0
16653,2,0,2021-06-08,254,573,50335,35680,2021-06-08,1623106800.0
16654,2,0,2021-06-09,297,676,50632,36356,2021-06-09,1623193200.0
16655,2,0,2021-06-10,303,436,50935,36792,2021-06-10,1623279600.0
16656,2,0,2021-06-11,336,521,51271,37313,2021-06-11,1623366000.0
16657,2,0,2021-06-12,243,307,51514,37620,2021-06-12,1623452400.0
16658,2,0,2021-06-13,32,28,51546,37648,2021-06-13,1623538800.0
16659,2,0,2021-06-14,363,517,51909,38165,2021-06-14,1623625200.0
16660,2,0,2021-06-15,407,436,52316,38601,2021-06-15,1623711600.0
16661,2,0,2021-06-16,425,403,52741,39004,2021-06-16,1623798000.0
16662,2,0,2021-06-17,348,548,53089,39552,2021-06-17,1623884400.0
16663,2,0,2021-06-18,421,518,53510,40070,2021-06-18,1623970800.0
16664,2,0,2021-06-19,225,178,53735,40248,2021-06-19,1624057200.0
16665,2,0,2021-06-20,25,17,53760,40265,2021-06-20,1624143600.0
16666,2,0,2021-06-21,317,563,54077,40828,2021-06-21,1624230000.0
16667,2,0,2021-06-22,288,434,54365,41262,2021-06-22,1624316400.0
16668,2,0,2021-06-23,406,525,54771,41787,2021-06-23,1624402800.0
16669,2,0,2021-06-24,313,405,55084,42192,2021-06-24,1624489200.0
16670,2,0,2021-06-25,306,352,55390,42544,2021-06-25,1624575600.0
16671,2,0,2021-06-26,215,188,55605,42732,2021-06-26,1624662000.0
16672,2,0,2021-06-27,15,20,55620,42752,2021-06-27,1624748400.0
16673,2,0,2021-06-28,317,388,55937,43140,2021-06-28,1624834800.0
16674,2,0,2021-06-29,317,387,56254,43527,2021-06-29,1624921200.0
16675,2,0,2021-06-30,427,376,56681,43903,2021-06-30,1625007600.0
16676,2,0,2021-07-01,335,355,57016,44258,2021-07-01,1625094000.0
16677,2,0,2021-07-02,121,181,57137,44439,2021-07-02,1625180400.0
16678,2,0,2021-07-03,99,114,57236,44553,2021-07-03,1625266800.0
16679,2,0,2021-07-04,24,34,57260,44587,2021-07-04,1625353200.0
16680,2,0,2021-07-05,481,538,57741,45125,2021-07-05,1625439600.0
16681,2,0,2021-07-06,469,365,58210,45490,2021-07-06,1625526000.0
16682,2,0,2021-07-07,570,431,58780,45921,2021-07-07,1625612400.0
16683,2,0,2021-07-08,460,364,59240,46285,2021-07-08,1625698800.0
16684,3,0,2020-12-27,0,0,0,0,2020-12-27,1609023600.0
16685,3,0,2020-12-28,0,0,0,0,2020-12-28,1609110000.0
16686,3,0,2020-12-29,0,0,0,0,2020-12-29,1609196400.0
16687,3,0,2020-12-30,0,0,0,0,2020-12-30,1609282800.0
16688,3,0,2020-12-31,0,0,0,0,2020-12-31,1609369200.0
16689,3,0,2021-01-01,0,0,0,0,2021-01-01,1609455600.0
16690,3,0,2021-01-02,2,0,2,0,2021-01-02,1609542000.0
16691,3,0,2021-01-03,0,0,2,0,2021-01-03,1609628400.0
16692,3,0,2021-01-04,0,0,2,0,2021-01-04,1609714800.0
16693,3,0,2021-01-05,0,0,2,0,2021-01-05,1609801200.0
16694,3,0,2021-01-06,0,0,2,0,2021-01-06,1609887600.0
16695,3,0,2021-01-07,0,0,2,0,2021-01-07,1609974000.0
16696,3,0,2021-01-08,0,0,2,0,2021-01-08,1610060400.0
16697,3,0,2021-01-09,0,0,2,0,2021-01-09,1610146800.0
16698,3,0,2021-01-10,0,0,2,0,2021-01-10,1610233200.0
16699,3,0,2021-01-11,0,0,2,0,2021-01-11,1610319600.0
16700,3,0,2021-01-12,0,0,2,0,2021-01-12,1610406000.0
16701,3,0,2021-01-13,30,0,32,0,2021-01-13,1610492400.0
16702,3,0,2021-01-14,46,0,78,0,2021-01-14,1610578800.0
16703,3,0,2021-01-15,35,0,113,0,2021-01-15,1610665200.0
16704,3,0,2021-01-16,18,0,131,0,2021-01-16,1610751600.0
16705,3,0,2021-01-17,0,0,131,0,2021-01-17,1610838000.0
16706,3,0,2021-01-18,63,0,194,0,2021-01-18,1610924400.0
16707,3,0,2021-01-19,149,0,343,0,2021-01-19,1611010800.0
16708,3,0,2021-01-20,133,0,476,0,2021-01-20,1611097200.0
16709,3,0,2021-01-21,118,0,594,0,2021-01-21,1611183600.0
16710,3,0,2021-01-22,76,0,670,0,2021-01-22,1611270000.0
16711,3,0,2021-01-23,0,0,670,0,2021-01-23,1611356400.0
16712,3,0,2021-01-24,0,0,670,0,2021-01-24,1611442800.0
16713,3,0,2021-01-25,56,0,726,0,2021-01-25,1611529200.0
16714,3,0,2021-01-26,100,0,826,0,2021-01-26,1611615600.0
16715,3,0,2021-01-27,109,0,935,0,2021-01-27,1611702000.0
16716,3,0,2021-01-28,96,2,1031,2,2021-01-28,1611788400.0
16717,3,0,2021-01-29,104,2,1135,4,2021-01-29,1611874800.0
16718,3,0,2021-01-30,0,0,1135,4,2021-01-30,1611961200.0
16719,3,0,2021-01-31,0,0,1135,4,2021-01-31,1612047600.0
16720,3,0,2021-02-01,54,0,1189,4,2021-02-01,1612134000.0
16721,3,0,2021-02-02,122,4,1311,8,2021-02-02,1612220400.0
16722,3,0,2021-02-03,116,7,1427,15,2021-02-03,1612306800.0
16723,3,0,2021-02-04,79,26,1506,41,2021-02-04,1612393200.0
16724,3,0,2021-02-05,65,7,1571,48,2021-02-05,1612479600.0
16725,3,0,2021-02-06,0,0,1571,48,2021-02-06,1612566000.0
16726,3,0,2021-02-07,0,0,1571,48,2021-02-07,1612652400.0
16727,3,0,2021-02-08,52,13,1623,61,2021-02-08,1612738800.0
16728,3,0,2021-02-09,92,38,1715,99,2021-02-09,1612825200.0
16729,3,0,2021-02-10,101,41,1816,140,2021-02-10,1612911600.0
16730,3,0,2021-02-11,105,93,1921,233,2021-02-11,1612998000.0
16731,3,0,2021-02-12,87,62,2008,295,2021-02-12,1613084400.0
16732,3,0,2021-02-13,0,0,2008,295,2021-02-13,1613170800.0
16733,3,0,2021-02-14,0,0,2008,295,2021-02-14,1613257200.0
16734,3,0,2021-02-15,27,65,2035,360,2021-02-15,1613343600.0
16735,3,0,2021-02-16,123,51,2158,411,2021-02-16,1613430000.0
16736,3,0,2021-02-17,145,115,2303,526,2021-02-17,1613516400.0
16737,3,0,2021-02-18,103,141,2406,667,2021-02-18,1613602800.0
16738,3,0,2021-02-19,122,72,2528,739,2021-02-19,1613689200.0
16739,3,0,2021-02-20,0,0,2528,739,2021-02-20,1613775600.0
16740,3,0,2021-02-21,0,0,2528,739,2021-02-21,1613862000.0
16741,3,0,2021-02-22,78,48,2606,787,2021-02-22,1613948400.0
16742,3,0,2021-02-23,158,98,2764,885,2021-02-23,1614034800.0
16743,3,0,2021-02-24,190,119,2954,1004,2021-02-24,1614121200.0
16744,3,0,2021-02-25,258,86,3212,1090,2021-02-25,1614207600.0
16745,3,0,2021-02-26,264,67,3476,1157,2021-02-26,1614294000.0
16746,3,0,2021-02-27,121,1,3597,1158,2021-02-27,1614380400.0
16747,3,0,2021-02-28,0,0,3597,1158,2021-02-28,1614466800.0
16748,3,0,2021-03-01,180,84,3777,1242,2021-03-01,1614553200.0
16749,3,0,2021-03-02,255,106,4032,1348,2021-03-02,1614639600.0
16750,3,0,2021-03-03,255,124,4287,1472,2021-03-03,1614726000.0
16751,3,0,2021-03-04,281,75,4568,1547,2021-03-04,1614812400.0
16752,3,0,2021-03-05,272,40,4840,1587,2021-03-05,1614898800.0
16753,3,0,2021-03-06,117,0,4957,1587,2021-03-06,1614985200.0
16754,3,0,2021-03-07,0,0,4957,1587,2021-03-07,1615071600.0
16755,3,0,2021-03-08,187,37,5144,1624,2021-03-08,1615158000.0
16756,3,0,2021-03-09,350,86,5494,1710,2021-03-09,1615244400.0
16757,3,0,2021-03-10,357,95,5851,1805,2021-03-10,1615330800.0
16758,3,0,2021-03-11,270,114,6121,1919,2021-03-11,1615417200.0
16759,3,0,2021-03-12,287,90,6408,2009,2021-03-12,1615503600.0
16760,3,0,2021-03-13,110,2,6518,2011,2021-03-13,1615590000.0
16761,3,0,2021-03-14,0,0,6518,2011,2021-03-14,1615676400.0
16762,3,0,2021-03-15,180,23,6698,2034,2021-03-15,1615762800.0
16763,3,0,2021-03-16,241,135,6939,2169,2021-03-16,1615849200.0
16764,3,0,2021-03-17,273,121,7212,2290,2021-03-17,1615935600.0
16765,3,0,2021-03-18,249,145,7461,2435,2021-03-18,1616022000.0
16766,3,0,2021-03-19,284,110,7745,2545,2021-03-19,1616108400.0
16767,3,0,2021-03-20,255,12,8000,2557,2021-03-20,1616194800.0
16768,3,0,2021-03-21,119,0,8119,2557,2021-03-21,1616281200.0
16769,3,0,2021-03-22,219,102,8338,2659,2021-03-22,1616367600.0
16770,3,0,2021-03-23,274,177,8612,2836,2021-03-23,1616454000.0
16771,3,0,2021-03-24,235,195,8847,3031,2021-03-24,1616540400.0
16772,3,0,2021-03-25,167,169,9014,3200,2021-03-25,1616626800.0
16773,3,0,2021-03-26,188,294,9202,3494,2021-03-26,1616713200.0
16774,3,0,2021-03-27,56,88,9258,3582,2021-03-27,1616799600.0
16775,3,0,2021-03-28,0,0,9258,3582,2021-03-28,1616886000.0
16776,3,0,2021-03-29,175,232,9433,3814,2021-03-29,1616972400.0
16777,3,0,2021-03-30,445,212,9878,4026,2021-03-30,1617058800.0
16778,3,0,2021-03-31,318,270,10196,4296,2021-03-31,1617145200.0
16779,3,0,2021-04-01,444,239,10640,4535,2021-04-01,1617231600.0
16780,3,0,2021-04-02,306,265,10946,4800,2021-04-02,1617318000.0
16781,3,0,2021-04-03,152,113,11098,4913,2021-04-03,1617404400.0
16782,3,0,2021-04-04,0,0,11098,4913,2021-04-04,1617490800.0
16783,3,0,2021-04-05,118,8,11216,4921,2021-04-05,1617577200.0
16784,3,0,2021-04-06,438,302,11654,5223,2021-04-06,1617663600.0
16785,3,0,2021-04-07,501,316,12155,5539,2021-04-07,1617750000.0
16786,3,0,2021-04-08,511,233,12666,5772,2021-04-08,1617836400.0
16787,3,0,2021-04-09,496,206,13162,5978,2021-04-09,1617922800.0
16788,3,0,2021-04-10,146,86,13308,6064,2021-04-10,1618009200.0
16789,3,0,2021-04-11,2,0,13310,6064,2021-04-11,1618095600.0
16790,3,0,2021-04-12,552,237,13862,6301,2021-04-12,1618185600.0
16791,3,0,2021-04-13,672,204,14534,6505,2021-04-13,1618272000.0
16792,3,0,2021-04-14,720,256,15254,6761,2021-04-14,1618358400.0
16793,3,0,2021-04-15,774,201,16028,6962,2021-04-15,1618444800.0
16794,3,0,2021-04-16,755,245,16783,7207,2021-04-16,1618531200.0
16795,3,0,2021-04-17,499,98,17282,7305,2021-04-17,1618617600.0
16796,3,0,2021-04-18,499,8,17781,7313,2021-04-18,1618704000.0
16797,3,0,2021-04-19,713,195,18494,7508,2021-04-19,1618790400.0
16798,3,0,2021-04-20,604,235,19098,7743,2021-04-20,1618876800.0
16799,3,0,2021-04-21,866,165,19964,7908,2021-04-21,1618963200.0
16800,3,0,2021-04-22,723,173,20687,8081,2021-04-22,1619049600.0
16801,3,0,2021-04-23,705,173,21392,8254,2021-04-23,1619136000.0
16802,3,0,2021-04-24,525,57,21917,8311,2021-04-24,1619222400.0
16803,3,0,2021-04-25,612,4,22529,8315,2021-04-25,1619308800.0
16804,3,0,2021-04-26,777,170,23306,8485,2021-04-26,1619395200.0
16805,3,0,2021-04-27,784,244,24090,8729,2021-04-27,1619481600.0
16806,3,0,2021-04-28,694,258,24784,8987,2021-04-28,1619568000.0
16807,3,0,2021-04-29,621,233,25405,9220,2021-04-29,1619654400.0
16808,3,0,2021-04-30,673,214,26078,9434,2021-04-30,1619740800.0
16809,3,0,2021-05-01,210,6,26288,9440,2021-05-01,1619827200.0
16810,3,0,2021-05-02,602,28,26890,9468,2021-05-02,1619913600.0
16811,3,0,2021-05-03,553,343,27443,9811,2021-05-03,1620000000.0
16812,3,0,2021-05-04,617,279,28060,10090,2021-05-04,1620086400.0
16813,3,0,2021-05-05,658,408,28718,10498,2021-05-05,1620172800.0
16814,3,0,2021-05-06,650,419,29368,10917,2021-05-06,1620259200.0
16815,3,0,2021-05-07,547,419,29915,11336,2021-05-07,1620345600.0
16816,3,0,2021-05-08,341,43,30256,11379,2021-05-08,1620432000.0
16817,3,0,2021-05-09,262,58,30518,11437,2021-05-09,1620518400.0
16818,3,0,2021-05-10,419,579,30937,12016,2021-05-10,1620604800.0
16819,3,0,2021-05-11,392,460,31329,12476,2021-05-11,1620691200.0
16820,3,0,2021-05-12,503,592,31832,13068,2021-05-12,1620777600.0
16821,3,0,2021-05-13,333,62,32165,13130,2021-05-13,1620864000.0
16822,3,0,2021-05-14,474,505,32639,13635,2021-05-14,1620950400.0
16823,3,0,2021-05-15,255,325,32894,13960,2021-05-15,1621036800.0
16824,3,0,2021-05-16,207,200,33101,14160,2021-05-16,1621123200.0
16825,3,0,2021-05-17,444,546,33545,14706,2021-05-17,1621206000.0
16826,3,0,2021-05-18,559,504,34104,15210,2021-05-18,1621292400.0
16827,3,0,2021-05-19,525,507,34629,15717,2021-05-19,1621378800.0
16828,3,0,2021-05-20,636,396,35265,16113,2021-05-20,1621465200.0
16829,3,0,2021-05-21,494,573,35759,16686,2021-05-21,1621551600.0
16830,3,0,2021-05-22,168,486,35927,17172,2021-05-22,1621638000.0
16831,3,0,2021-05-23,269,454,36196,17626,2021-05-23,1621724400.0
16832,3,0,2021-05-24,560,209,36756,17835,2021-05-24,1621810800.0
16833,3,0,2021-05-25,495,681,37251,18516,2021-05-25,1621897200.0
16834,3,0,2021-05-26,435,655,37686,19171,2021-05-26,1621983600.0
16835,3,0,2021-05-27,694,451,38380,19622,2021-05-27,1622070000.0
16836,3,0,2021-05-28,551,517,38931,20139,2021-05-28,1622156400.0
16837,3,0,2021-05-29,239,341,39170,20480,2021-05-29,1622242800.0
16838,3,0,2021-05-30,151,394,39321,20874,2021-05-30,1622329200.0
16839,3,0,2021-05-31,341,550,39662,21424,2021-05-31,1622415600.0
16840,3,0,2021-06-01,394,416,40056,21840,2021-06-01,1622502000.0
16841,3,0,2021-06-02,525,518,40581,22358,2021-06-02,1622588400.0
16842,3,0,2021-06-03,482,424,41063,22782,2021-06-03,1622674800.0
16843,3,0,2021-06-04,550,450,41613,23232,2021-06-04,1622761200.0
16844,3,0,2021-06-05,272,270,41885,23502,2021-06-05,1622847600.0
16845,3,0,2021-06-06,211,285,42096,23787,2021-06-06,1622934000.0
16846,3,0,2021-06-07,465,407,42561,24194,2021-06-07,1623020400.0
16847,3,0,2021-06-08,521,271,43082,24465,2021-06-08,1623106800.0
16848,3,0,2021-06-09,498,339,43580,24804,2021-06-09,1623193200.0
16849,3,0,2021-06-10,346,251,43926,25055,2021-06-10,1623279600.0
16850,3,0,2021-06-11,408,434,44334,25489,2021-06-11,1623366000.0
16851,3,0,2021-06-12,166,269,44500,25758,2021-06-12,1623452400.0
16852,3,0,2021-06-13,200,247,44700,26005,2021-06-13,1623538800.0
16853,3,0,2021-06-14,352,519,45052,26524,2021-06-14,1623625200.0
16854,3,0,2021-06-15,355,405,45407,26929,2021-06-15,1623711600.0
16855,3,0,2021-06-16,394,407,45801,27336,2021-06-16,1623798000.0
16856,3,0,2021-06-17,365,540,46166,27876,2021-06-17,1623884400.0
16857,3,0,2021-06-18,339,536,46505,28412,2021-06-18,1623970800.0
16858,3,0,2021-06-19,230,237,46735,28649,2021-06-19,1624057200.0
16859,3,0,2021-06-20,123,263,46858,28912,2021-06-20,1624143600.0
16860,3,0,2021-06-21,264,556,47122,29468,2021-06-21,1624230000.0
16861,3,0,2021-06-22,306,427,47428,29895,2021-06-22,1624316400.0
16862,3,0,2021-06-23,277,495,47705,30390,2021-06-23,1624402800.0
16863,3,0,2021-06-24,387,460,48092,30850,2021-06-24,1624489200.0
16864,3,0,2021-06-25,377,505,48469,31355,2021-06-25,1624575600.0
16865,3,0,2021-06-26,164,309,48633,31664,2021-06-26,1624662000.0
16866,3,0,2021-06-27,117,161,48750,31825,2021-06-27,1624748400.0
16867,3,0,2021-06-28,281,551,49031,32376,2021-06-28,1624834800.0
16868,3,0,2021-06-29,325,463,49356,32839,2021-06-29,1624921200.0
16869,3,0,2021-06-30,306,628,49662,33467,2021-06-30,1625007600.0
16870,3,0,2021-07-01,319,368,49981,33835,2021-07-01,1625094000.0
16871,3,0,2021-07-02,388,471,50369,34306,2021-07-02,1625180400.0
16872,3,0,2021-07-03,203,244,50572,34550,2021-07-03,1625266800.0
16873,3,0,2021-07-04,85,226,50657,34776,2021-07-04,1625353200.0
16874,3,0,2021-07-05,291,505,50948,35281,2021-07-05,1625439600.0
16875,3,0,2021-07-06,292,423,51240,35704,2021-07-06,1625526000.0
16876,3,0,2021-07-07,305,364,51545,36068,2021-07-07,1625612400.0
16877,3,0,2021-07-08,254,294,51799,36362,2021-07-08,1625698800.0
16878,4,0,2020-12-27,0,0,0,0,2020-12-27,1609023600.0
16879,4,0,2020-12-28,0,0,0,0,2020-12-28,1609110000.0
16880,4,0,2020-12-29,0,0,0,0,2020-12-29,1609196400.0
16881,4,0,2020-12-30,0,0,0,0,2020-12-30,1609282800.0
16882,4,0,2020-12-31,0,0,0,0,2020-12-31,1609369200.0
16883,4,0,2021-01-01,1,0,1,0,2021-01-01,1609455600.0
16884,4,0,2021-01-02,0,0,1,0,2021-01-02,1609542000.0
16885,4,0,2021-01-03,0,0,1,0,2021-01-03,1609628400.0
16886,4,0,2021-01-04,0,0,1,0,2021-01-04,1609714800.0
16887,4,0,2021-01-05,2,0,3,0,2021-01-05,1609801200.0
16888,4,0,2021-01-06,0,0,3,0,2021-01-06,1609887600.0
16889,4,0,2021-01-07,0,0,3,0,2021-01-07,1609974000.0
16890,4,0,2021-01-08,0,0,3,0,2021-01-08,1610060400.0
16891,4,0,2021-01-09,1,0,4,0,2021-01-09,1610146800.0
16892,4,0,2021-01-10,0,0,4,0,2021-01-10,1610233200.0
16893,4,0,2021-01-11,0,0,4,0,2021-01-11,1610319600.0
16894,4,0,2021-01-12,0,0,4,0,2021-01-12,1610406000.0
16895,4,0,2021-01-13,0,0,4,0,2021-01-13,1610492400.0
16896,4,0,2021-01-14,0,0,4,0,2021-01-14,1610578800.0
16897,4,0,2021-01-15,332,0,336,0,2021-01-15,1610665200.0
16898,4,0,2021-01-16,27,0,363,0,2021-01-16,1610751600.0
16899,4,0,2021-01-17,0,0,363,0,2021-01-17,1610838000.0
16900,4,0,2021-01-18,49,0,412,0,2021-01-18,1610924400.0
16901,4,0,2021-01-19,393,0,805,0,2021-01-19,1611010800.0
16902,4,0,2021-01-20,481,0,1286,0,2021-01-20,1611097200.0
16903,4,0,2021-01-21,614,1,1900,1,2021-01-21,1611183600.0
16904,4,0,2021-01-22,409,0,2309,1,2021-01-22,1611270000.0
16905,4,0,2021-01-23,75,0,2384,1,2021-01-23,1611356400.0
16906,4,0,2021-01-24,0,0,2384,1,2021-01-24,1611442800.0
16907,4,0,2021-01-25,273,0,2657,1,2021-01-25,1611529200.0
16908,4,0,2021-01-26,429,0,3086,1,2021-01-26,1611615600.0
16909,4,0,2021-01-27,317,0,3403,1,2021-01-27,1611702000.0
16910,4,0,2021-01-28,407,0,3810,1,2021-01-28,1611788400.0
16911,4,0,2021-01-29,421,3,4231,4,2021-01-29,1611874800.0
16912,4,0,2021-01-30,420,0,4651,4,2021-01-30,1611961200.0
16913,4,0,2021-01-31,0,0,4651,4,2021-01-31,1612047600.0
16914,4,0,2021-02-01,372,3,5023,7,2021-02-01,1612134000.0
16915,4,0,2021-02-02,499,4,5522,11,2021-02-02,1612220400.0
16916,4,0,2021-02-03,602,13,6124,24,2021-02-03,1612306800.0
16917,4,0,2021-02-04,626,21,6750,45,2021-02-04,1612393200.0
16918,4,0,2021-02-05,564,98,7314,143,2021-02-05,1612479600.0
16919,4,0,2021-02-06,501,4,7815,147,2021-02-06,1612566000.0
16920,4,0,2021-02-07,0,8,7815,155,2021-02-07,1612652400.0
16921,4,0,2021-02-08,472,34,8287,189,2021-02-08,1612738800.0
16922,4,0,2021-02-09,784,90,9071,279,2021-02-09,1612825200.0
16923,4,0,2021-02-10,820,85,9891,364,2021-02-10,1612911600.0
16924,4,0,2021-02-11,796,85,10687,449,2021-02-11,1612998000.0
16925,4,0,2021-02-12,637,95,11324,544,2021-02-12,1613084400.0
16926,4,0,2021-02-13,651,74,11975,618,2021-02-13,1613170800.0
16927,4,0,2021-02-14,1,0,11976,618,2021-02-14,1613257200.0
16928,4,0,2021-02-15,524,124,12500,742,2021-02-15,1613343600.0
16929,4,0,2021-02-16,651,534,13151,1276,2021-02-16,1613430000.0
16930,4,0,2021-02-17,592,328,13743,1604,2021-02-17,1613516400.0
16931,4,0,2021-02-18,493,414,14236,2018,2021-02-18,1613602800.0
16932,4,0,2021-02-19,496,320,14732,2338,2021-02-19,1613689200.0
16933,4,0,2021-02-20,576,116,15308,2454,2021-02-20,1613775600.0
16934,4,0,2021-02-21,0,0,15308,2454,2021-02-21,1613862000.0
16935,4,0,2021-02-22,402,236,15710,2690,2021-02-22,1613948400.0
16936,4,0,2021-02-23,607,236,16317,2926,2021-02-23,1614034800.0
16937,4,0,2021-02-24,583,253,16900,3179,2021-02-24,1614121200.0
16938,4,0,2021-02-25,645,294,17545,3473,2021-02-25,1614207600.0
16939,4,0,2021-02-26,483,470,18028,3943,2021-02-26,1614294000.0
16940,4,0,2021-02-27,385,470,18413,4413,2021-02-27,1614380400.0
16941,4,0,2021-02-28,0,0,18413,4413,2021-02-28,1614466800.0
16942,4,0,2021-03-01,290,391,18703,4804,2021-03-01,1614553200.0
16943,4,0,2021-03-02,486,500,19189,5304,2021-03-02,1614639600.0
16944,4,0,2021-03-03,755,554,19944,5858,2021-03-03,1614726000.0
16945,4,0,2021-03-04,775,538,20719,6396,2021-03-04,1614812400.0
16946,4,0,2021-03-05,727,532,21446,6928,2021-03-05,1614898800.0
16947,4,0,2021-03-06,812,529,22258,7457,2021-03-06,1614985200.0
16948,4,0,2021-03-07,0,0,22258,7457,2021-03-07,1615071600.0
16949,4,0,2021-03-08,435,590,22693,8047,2021-03-08,1615158000.0
16950,4,0,2021-03-09,670,774,23363,8821,2021-03-09,1615244400.0
16951,4,0,2021-03-10,644,849,24007,9670,2021-03-10,1615330800.0
16952,4,0,2021-03-11,699,642,24706,10312,2021-03-11,1615417200.0
16953,4,0,2021-03-12,729,661,25435,10973,2021-03-12,1615503600.0
16954,4,0,2021-03-13,668,609,26103,11582,2021-03-13,1615590000.0
16955,4,0,2021-03-14,2,0,26105,11582,2021-03-14,1615676400.0
16956,4,0,2021-03-15,504,506,26609,12088,2021-03-15,1615762800.0
16957,4,0,2021-03-16,680,708,27289,12796,2021-03-16,1615849200.0
16958,4,0,2021-03-17,847,537,28136,13333,2021-03-17,1615935600.0
16959,4,0,2021-03-18,1021,551,29157,13884,2021-03-18,1616022000.0
16960,4,0,2021-03-19,784,541,29941,14425,2021-03-19,1616108400.0
16961,4,0,2021-03-20,576,595,30517,15020,2021-03-20,1616194800.0
16962,4,0,2021-03-21,0,0,30517,15020,2021-03-21,1616281200.0
16963,4,0,2021-03-22,565,478,31082,15498,2021-03-22,1616367600.0
16964,4,0,2021-03-23,780,634,31862,16132,2021-03-23,1616454000.0
16965,4,0,2021-03-24,792,667,32654,16799,2021-03-24,1616540400.0
16966,4,0,2021-03-25,929,549,33583,17348,2021-03-25,1616626800.0
16967,4,0,2021-03-26,921,441,34504,17789,2021-03-26,1616713200.0
16968,4,0,2021-03-27,782,337,35286,18126,2021-03-27,1616799600.0
16969,4,0,2021-03-28,1,0,35287,18126,2021-03-28,1616886000.0
16970,4,0,2021-03-29,961,269,36248,18395,2021-03-29,1616972400.0
16971,4,0,2021-03-30,883,498,37131,18893,2021-03-30,1617058800.0
16972,4,0,2021-03-31,740,669,37871,19562,2021-03-31,1617145200.0
16973,4,0,2021-04-01,716,707,38587,20269,2021-04-01,1617231600.0
16974,4,0,2021-04-02,688,758,39275,21027,2021-04-02,1617318000.0
16975,4,0,2021-04-03,699,699,39974,21726,2021-04-03,1617404400.0
16976,4,0,2021-04-04,0,0,39974,21726,2021-04-04,1617490800.0
16977,4,0,2021-04-05,0,2,39974,21728,2021-04-05,1617577200.0
16978,4,0,2021-04-06,795,634,40769,22362,2021-04-06,1617663600.0
16979,4,0,2021-04-07,1369,777,42138,23139,2021-04-07,1617750000.0
16980,4,0,2021-04-08,1792,775,43930,23914,2021-04-08,1617836400.0
16981,4,0,2021-04-09,1509,779,45439,24693,2021-04-09,1617922800.0
16982,4,0,2021-04-10,1137,649,46576,25342,2021-04-10,1618009200.0
16983,4,0,2021-04-11,2,0,46578,25342,2021-04-11,1618095600.0
16984,4,0,2021-04-12,1238,542,47816,25884,2021-04-12,1618185600.0
16985,4,0,2021-04-13,1440,745,49256,26629,2021-04-13,1618272000.0
16986,4,0,2021-04-14,2069,770,51325,27399,2021-04-14,1618358400.0
16987,4,0,2021-04-15,2504,939,53829,28338,2021-04-15,1618444800.0
16988,4,0,2021-04-16,1932,766,55761,29104,2021-04-16,1618531200.0
16989,4,0,2021-04-17,1289,595,57050,29699,2021-04-17,1618617600.0
16990,4,0,2021-04-18,0,0,57050,29699,2021-04-18,1618704000.0
16991,4,0,2021-04-19,1376,561,58426,30260,2021-04-19,1618790400.0
16992,4,0,2021-04-20,1649,792,60075,31052,2021-04-20,1618876800.0
16993,4,0,2021-04-21,2127,598,62202,31650,2021-04-21,1618963200.0
16994,4,0,2021-04-22,2946,780,65148,32430,2021-04-22,1619049600.0
16995,4,0,2021-04-23,2309,796,67457,33226,2021-04-23,1619136000.0
16996,4,0,2021-04-24,1102,790,68559,34016,2021-04-24,1619222400.0
16997,4,0,2021-04-25,2,0,68561,34016,2021-04-25,1619308800.0
16998,4,0,2021-04-26,1164,908,69725,34924,2021-04-26,1619395200.0
16999,4,0,2021-04-27,1683,1014,71408,35938,2021-04-27,1619481600.0
17000,4,0,2021-04-28,2897,716,74305,36654,2021-04-28,1619568000.0
17001,4,0,2021-04-29,3946,797,78251,37451,2021-04-29,1619654400.0
17002,4,0,2021-04-30,3432,879,81683,38330,2021-04-30,1619740800.0
17003,4,0,2021-05-01,2106,202,83789,38532,2021-05-01,1619827200.0
17004,4,0,2021-05-02,2,0,83791,38532,2021-05-02,1619913600.0
17005,4,0,2021-05-03,1865,542,85656,39074,2021-05-03,1620000000.0
17006,4,0,2021-05-04,2127,1072,87783,40146,2021-05-04,1620086400.0
17007,4,0,2021-05-05,3119,1607,90902,41753,2021-05-05,1620172800.0
17008,4,0,2021-05-06,4005,1562,94907,43315,2021-05-06,1620259200.0
17009,4,0,2021-05-07,3228,1502,98135,44817,2021-05-07,1620345600.0
17010,4,0,2021-05-08,1565,481,99700,45298,2021-05-08,1620432000.0
17011,4,0,2021-05-09,1,0,99701,45298,2021-05-09,1620518400.0
17012,4,0,2021-05-10,2411,976,102112,46274,2021-05-10,1620604800.0
17013,4,0,2021-05-11,3650,1583,105762,47857,2021-05-11,1620691200.0
17014,4,0,2021-05-12,4723,2310,110485,50167,2021-05-12,1620777600.0
17015,4,0,2021-05-13,3554,544,114039,50711,2021-05-13,1620864000.0
17016,4,0,2021-05-14,5267,2350,119306,53061,2021-05-14,1620950400.0
17017,4,0,2021-05-15,3162,1477,122468,54538,2021-05-15,1621036800.0
17018,4,0,2021-05-16,15,6,122483,54544,2021-05-16,1621123200.0
17019,4,0,2021-05-17,2999,1372,125482,55916,2021-05-17,1621206000.0
17020,4,0,2021-05-18,3754,1552,129236,57468,2021-05-18,1621292400.0
17021,4,0,2021-05-19,4681,2162,133917,59630,2021-05-19,1621378800.0
17022,4,0,2021-05-20,5141,2648,139058,62278,2021-05-20,1621465200.0
17023,4,0,2021-05-21,4988,2414,144046,64692,2021-05-21,1621551600.0
17024,4,0,2021-05-22,3367,1112,147413,65804,2021-05-22,1621638000.0
17025,4,0,2021-05-23,5,0,147418,65804,2021-05-23,1621724400.0
17026,4,0,2021-05-24,3642,966,151060,66770,2021-05-24,1621810800.0
17027,4,0,2021-05-25,4246,1511,155306,68281,2021-05-25,1621897200.0
17028,4,0,2021-05-26,4980,2604,160286,70885,2021-05-26,1621983600.0
17029,4,0,2021-05-27,4612,3689,164898,74574,2021-05-27,1622070000.0
17030,4,0,2021-05-28,4376,3497,169274,78071,2021-05-28,1622156400.0
17031,4,0,2021-05-29,2553,2256,171827,80327,2021-05-29,1622242800.0
17032,4,0,2021-05-30,7,13,171834,80340,2021-05-30,1622329200.0
17033,4,0,2021-05-31,2351,1988,174185,82328,2021-05-31,1622415600.0
17034,4,0,2021-06-01,3296,2342,177481,84670,2021-06-01,1622502000.0
17035,4,0,2021-06-02,3963,3046,181444,87716,2021-06-02,1622588400.0
17036,4,0,2021-06-03,4040,3326,185484,91042,2021-06-03,1622674800.0
17037,4,0,2021-06-04,3847,3410,189331,94452,2021-06-04,1622761200.0
17038,4,0,2021-06-05,2210,1799,191541,96251,2021-06-05,1622847600.0
17039,4,0,2021-06-06,1071,74,192612,96325,2021-06-06,1622934000.0
17040,4,0,2021-06-07,2009,2324,194621,98649,2021-06-07,1623020400.0
17041,4,0,2021-06-08,2544,3046,197165,101695,2021-06-08,1623106800.0
17042,4,0,2021-06-09,2973,4547,200138,106242,2021-06-09,1623193200.0
17043,4,0,2021-06-10,3387,4210,203525,110452,2021-06-10,1623279600.0
17044,4,0,2021-06-11,2838,4400,206363,114852,2021-06-11,1623366000.0
17045,4,0,2021-06-12,1712,3203,208075,118055,2021-06-12,1623452400.0
17046,4,0,2021-06-13,1313,184,209388,118239,2021-06-13,1623538800.0
17047,4,0,2021-06-14,1482,3029,210870,121268,2021-06-14,1623625200.0
17048,4,0,2021-06-15,2044,3330,212914,124598,2021-06-15,1623711600.0
17049,4,0,2021-06-16,2721,4393,215635,128991,2021-06-16,1623798000.0
17050,4,0,2021-06-17,2499,4701,218134,133692,2021-06-17,1623884400.0
17051,4,0,2021-06-18,2558,4674,220692,138366,2021-06-18,1623970800.0
17052,4,0,2021-06-19,1295,3407,221987,141773,2021-06-19,1624057200.0
17053,4,0,2021-06-20,625,235,222612,142008,2021-06-20,1624143600.0
17054,4,0,2021-06-21,1255,3087,223867,145095,2021-06-21,1624230000.0
17055,4,0,2021-06-22,1603,3538,225470,148633,2021-06-22,1624316400.0
17056,4,0,2021-06-23,2232,4786,227702,153419,2021-06-23,1624402800.0
17057,4,0,2021-06-24,2272,3874,229974,157293,2021-06-24,1624489200.0
17058,4,0,2021-06-25,2173,3918,232147,161211,2021-06-25,1624575600.0
17059,4,0,2021-06-26,1386,2598,233533,163809,2021-06-26,1624662000.0
17060,4,0,2021-06-27,655,200,234188,164009,2021-06-27,1624748400.0
17061,4,0,2021-06-28,1297,2351,235485,166360,2021-06-28,1624834800.0
17062,4,0,2021-06-29,1727,2637,237212,168997,2021-06-29,1624921200.0
17063,4,0,2021-06-30,2537,3613,239749,172610,2021-06-30,1625007600.0
17064,4,0,2021-07-01,2654,3613,242403,176223,2021-07-01,1625094000.0
17065,4,0,2021-07-02,2489,3467,244892,179690,2021-07-02,1625180400.0
17066,4,0,2021-07-03,1597,2310,246489,182000,2021-07-03,1625266800.0
17067,4,0,2021-07-04,871,966,247360,182966,2021-07-04,1625353200.0
17068,4,0,2021-07-05,1668,2036,249028,185002,2021-07-05,1625439600.0
17069,4,0,2021-07-06,2384,2284,251412,187286,2021-07-06,1625526000.0
17070,4,0,2021-07-07,2610,2898,254022,190184,2021-07-07,1625612400.0
17071,4,0,2021-07-08,2338,2969,256360,193153,2021-07-08,1625698800.0
17072,5,0,2020-12-27,0,0,0,0,2020-12-27,1609023600.0
17073,5,0,2020-12-28,0,0,0,0,2020-12-28,1609110000.0
17074,5,0,2020-12-29,0,0,0,0,2020-12-29,1609196400.0
17075,5,0,2020-12-30,0,0,0,0,2020-12-30,1609282800.0
17076,5,0,2020-12-31,0,0,0,0,2020-12-31,1609369200.0
17077,5,0,2021-01-01,0,0,0,0,2021-01-01,1609455600.0
17078,5,0,2021-01-02,0,0,0,0,2021-01-02,1609542000.0
17079,5,0,2021-01-03,0,0,0,0,2021-01-03,1609628400.0
17080,5,0,2021-01-04,0,0,0,0,2021-01-04,1609714800.0
17081,5,0,2021-01-05,0,0,0,0,2021-01-05,1609801200.0
17082,5,0,2021-01-06,0,0,0,0,2021-01-06,1609887600.0
17083,5,0,2021-01-07,0,0,0,0,2021-01-07,1609974000.0
17084,5,0,2021-01-08,0,0,0,0,2021-01-08,1610060400.0
17085,5,0,2021-01-09,0,0,0,0,2021-01-09,1610146800.0
17086,5,0,2021-01-10,0,0,0,0,2021-01-10,1610233200.0
17087,5,0,2021-01-11,0,0,0,0,2021-01-11,1610319600.0
17088,5,0,2021-01-12,0,0,0,0,2021-01-12,1610406000.0
17089,5,0,2021-01-13,0,0,0,0,2021-01-13,1610492400.0
17090,5,0,2021-01-14,0,0,0,0,2021-01-14,1610578800.0
17091,5,0,2021-01-15,0,0,0,0,2021-01-15,1610665200.0
17092,5,0,2021-01-16,0,0,0,0,2021-01-16,1610751600.0
17093,5,0,2021-01-17,0,0,0,0,2021-01-17,1610838000.0
17094,5,0,2021-01-18,0,0,0,0,2021-01-18,1610924400.0
17095,5,0,2021-01-19,0,0,0,0,2021-01-19,1611010800.0
17096,5,0,2021-01-20,0,0,0,0,2021-01-20,1611097200.0
17097,5,0,2021-01-21,0,0,0,0,2021-01-21,1611183600.0
17098,5,0,2021-01-22,0,0,0,0,2021-01-22,1611270000.0
17099,5,0,2021-01-23,0,0,0,0,2021-01-23,1611356400.0
17100,5,0,2021-01-24,0,0,0,0,2021-01-24,1611442800.0
17101,5,0,2021-01-25,0,0,0,0,2021-01-25,1611529200.0
17102,5,0,2021-01-26,0,0,0,0,2021-01-26,1611615600.0
17103,5,0,2021-01-27,0,0,0,0,2021-01-27,1611702000.0
17104,5,0,2021-01-28,0,0,0,0,2021-01-28,1611788400.0
17105,5,0,2021-01-29,0,0,0,0,2021-01-29,1611874800.0
17106,5,0,2021-01-30,0,0,0,0,2021-01-30,1611961200.0
17107,5,0,2021-01-31,0,0,0,0,2021-01-31,1612047600.0
17108,5,0,2021-02-01,0,0,0,0,2021-02-01,1612134000.0
17109,5,0,2021-02-02,0,0,0,0,2021-02-02,1612220400.0
17110,5,0,2021-02-03,0,0,0,0,2021-02-03,1612306800.0
17111,5,0,2021-02-04,0,0,0,0,2021-02-04,1612393200.0
17112,5,0,2021-02-05,0,0,0,0,2021-02-05,1612479600.0
17113,5,0,2021-02-06,0,0,0,0,2021-02-06,1612566000.0
17114,5,0,2021-02-07,0,0,0,0,2021-02-07,1612652400.0
17115,5,0,2021-02-08,0,0,0,0,2021-02-08,1612738800.0
17116,5,0,2021-02-09,0,0,0,0,2021-02-09,1612825200.0
17117,5,0,2021-02-10,0,0,0,0,2021-02-10,1612911600.0
17118,5,0,2021-02-11,0,0,0,0,2021-02-11,1612998000.0
17119,5,0,2021-02-12,0,0,0,0,2021-02-12,1613084400.0
17120,5,0,2021-02-13,0,0,0,0,2021-02-13,1613170800.0
17121,5,0,2021-02-14,0,0,0,0,2021-02-14,1613257200.0
17122,5,0,2021-02-15,0,0,0,0,2021-02-15,1613343600.0
17123,5,0,2021-02-16,0,0,0,0,2021-02-16,1613430000.0
17124,5,0,2021-02-17,0,0,0,0,2021-02-17,1613516400.0
17125,5,0,2021-02-18,0,0,0,0,2021-02-18,1613602800.0
17126,5,0,2021-02-19,0,0,0,0,2021-02-19,1613689200.0
17127,5,0,2021-02-20,0,0,0,0,2021-02-20,1613775600.0
17128,5,0,2021-02-21,0,0,0,0,2021-02-21,1613862000.0
17129,5,0,2021-02-22,0,0,0,0,2021-02-22,1613948400.0
17130,5,0,2021-02-23,0,0,0,0,2021-02-23,1614034800.0
17131,5,0,2021-02-24,0,0,0,0,2021-02-24,1614121200.0
17132,5,0,2021-02-25,0,0,0,0,2021-02-25,1614207600.0
17133,5,0,2021-02-26,0,0,0,0,2021-02-26,1614294000.0
17134,5,0,2021-02-27,0,0,0,0,2021-02-27,1614380400.0
17135,5,0,2021-02-28,0,0,0,0,2021-02-28,1614466800.0
17136,5,0,2021-03-01,0,0,0,0,2021-03-01,1614553200.0
17137,5,0,2021-03-02,0,0,0,0,2021-03-02,1614639600.0
17138,5,0,2021-03-03,0,0,0,0,2021-03-03,1614726000.0
17139,5,0,2021-03-04,0,0,0,0,2021-03-04,1614812400.0
17140,5,0,2021-03-05,0,0,0,0,2021-03-05,1614898800.0
17141,5,0,2021-03-06,0,0,0,0,2021-03-06,1614985200.0
17142,5,0,2021-03-07,0,0,0,0,2021-03-07,1615071600.0
17143,5,0,2021-03-08,0,0,0,0,2021-03-08,1615158000.0
17144,5,0,2021-03-09,0,0,0,0,2021-03-09,1615244400.0
17145,5,0,2021-03-10,0,0,0,0,2021-03-10,1615330800.0
17146,5,0,2021-03-11,0,0,0,0,2021-03-11,1615417200.0
17147,5,0,2021-03-12,0,0,0,0,2021-03-12,1615503600.0
17148,5,0,2021-03-13,0,0,0,0,2021-03-13,1615590000.0
17149,5,0,2021-03-14,0,0,0,0,2021-03-14,1615676400.0
17150,5,0,2021-03-15,0,0,0,0,2021-03-15,1615762800.0
17151,5,0,2021-03-16,0,0,0,0,2021-03-16,1615849200.0
17152,5,0,2021-03-17,0,0,0,0,2021-03-17,1615935600.0
17153,5,0,2021-03-18,0,0,0,0,2021-03-18,1616022000.0
17154,5,0,2021-03-19,0,0,0,0,2021-03-19,1616108400.0
17155,5,0,2021-03-20,0,0,0,0,2021-03-20,1616194800.0
17156,5,0,2021-03-21,0,0,0,0,2021-03-21,1616281200.0
17157,5,0,2021-03-22,0,0,0,0,2021-03-22,1616367600.0
17158,5,0,2021-03-23,0,0,0,0,2021-03-23,1616454000.0
17159,5,0,2021-03-24,0,0,0,0,2021-03-24,1616540400.0
17160,5,0,2021-03-25,0,0,0,0,2021-03-25,1616626800.0
17161,5,0,2021-03-26,0,0,0,0,2021-03-26,1616713200.0
17162,5,0,2021-03-27,0,0,0,0,2021-03-27,1616799600.0
17163,5,0,2021-03-28,0,0,0,0,2021-03-28,1616886000.0
17164,5,0,2021-03-29,2,0,2,0,2021-03-29,1616972400.0
17165,5,0,2021-03-30,0,0,2,0,2021-03-30,1617058800.0
17166,5,0,2021-03-31,0,0,2,0,2021-03-31,1617145200.0
17167,5,0,2021-04-01,0,0,2,0,2021-04-01,1617231600.0
17168,5,0,2021-04-02,0,0,2,0,2021-04-02,1617318000.0
17169,5,0,2021-04-03,0,0,2,0,2021-04-03,1617404400.0
17170,5,0,2021-04-04,0,0,2,0,2021-04-04,1617490800.0
17171,5,0,2021-04-05,0,0,2,0,2021-04-05,1617577200.0
17172,5,0,2021-04-06,0,0,2,0,2021-04-06,1617663600.0
17173,5,0,2021-04-07,0,0,2,0,2021-04-07,1617750000.0
17174,5,0,2021-04-08,1,0,3,0,2021-04-08,1617836400.0
17175,5,0,2021-04-09,0,0,3,0,2021-04-09,1617922800.0
17176,5,0,2021-04-10,0,0,3,0,2021-04-10,1618009200.0
17177,5,0,2021-04-11,0,0,3,0,2021-04-11,1618095600.0
17178,5,0,2021-04-12,0,0,3,0,2021-04-12,1618185600.0
17179,5,0,2021-04-13,0,0,3,0,2021-04-13,1618272000.0
17180,5,0,2021-04-14,0,0,3,0,2021-04-14,1618358400.0
17181,5,0,2021-04-15,0,0,3,0,2021-04-15,1618444800.0
17182,5,0,2021-04-16,0,0,3,0,2021-04-16,1618531200.0
17183,5,0,2021-04-17,0,0,3,0,2021-04-17,1618617600.0
17184,5,0,2021-04-18,0,0,3,0,2021-04-18,1618704000.0
17185,5,0,2021-04-19,0,0,3,0,2021-04-19,1618790400.0
17186,5,0,2021-04-20,0,0,3,0,2021-04-20,1618876800.0
17187,5,0,2021-04-21,0,0,3,0,2021-04-21,1618963200.0
17188,5,0,2021-04-22,0,0,3,0,2021-04-22,1619049600.0
17189,5,0,2021-04-23,0,0,3,0,2021-04-23,1619136000.0
17190,5,0,2021-04-24,0,0,3,0,2021-04-24,1619222400.0
17191,5,0,2021-04-25,0,0,3,0,2021-04-25,1619308800.0
17192,5,0,2021-04-26,0,0,3,0,2021-04-26,1619395200.0
17193,5,0,2021-04-27,0,0,3,0,2021-04-27,1619481600.0
17194,5,0,2021-04-28,0,0,3,0,2021-04-28,1619568000.0
17195,5,0,2021-04-29,0,0,3,0,2021-04-29,1619654400.0
17196,5,0,2021-04-30,0,0,3,0,2021-04-30,1619740800.0
17197,5,0,2021-05-01,0,0,3,0,2021-05-01,1619827200.0
17198,5,0,2021-05-02,0,0,3,0,2021-05-02,1619913600.0
17199,5,0,2021-05-03,0,0,3,0,2021-05-03,1620000000.0
17200,5,0,2021-05-04,0,0,3,0,2021-05-04,1620086400.0
17201,5,0,2021-05-05,0,0,3,0,2021-05-05,1620172800.0
17202,5,0,2021-05-06,0,0,3,0,2021-05-06,1620259200.0
17203,5,0,2021-05-07,0,0,3,0,2021-05-07,1620345600.0
17204,5,0,2021-05-08,0,0,3,0,2021-05-08,1620432000.0
17205,5,0,2021-05-09,0,0,3,0,2021-05-09,1620518400.0
17206,5,0,2021-05-10,0,0,3,0,2021-05-10,1620604800.0
17207,5,0,2021-05-11,0,0,3,0,2021-05-11,1620691200.0
17208,5,0,2021-05-12,0,0,3,0,2021-05-12,1620777600.0
17209,5,0,2021-05-13,0,0,3,0,2021-05-13,1620864000.0
17210,5,0,2021-05-14,0,0,3,0,2021-05-14,1620950400.0
17211,5,0,2021-05-15,0,0,3,0,2021-05-15,1621036800.0
17212,5,0,2021-05-16,0,0,3,0,2021-05-16,1621123200.0
17213,5,0,2021-05-17,0,0,3,0,2021-05-17,1621206000.0
17214,5,0,2021-05-18,0,0,3,0,2021-05-18,1621292400.0
17215,5,0,2021-05-19,0,0,3,0,2021-05-19,1621378800.0
17216,5,0,2021-05-20,0,0,3,0,2021-05-20,1621465200.0
17217,5,0,2021-05-21,0,0,3,0,2021-05-21,1621551600.0
17218,5,0,2021-05-22,0,0,3,0,2021-05-22,1621638000.0
17219,5,0,2021-05-23,0,0,3,0,2021-05-23,1621724400.0
17220,5,0,2021-05-24,0,0,3,0,2021-05-24,1621810800.0
17221,5,0,2021-05-25,0,0,3,0,2021-05-25,1621897200.0
17222,5,0,2021-05-26,0,0,3,0,2021-05-26,1621983600.0
17223,5,0,2021-05-27,0,0,3,0,2021-05-27,1622070000.0
17224,5,0,2021-05-28,0,0,3,0,2021-05-28,1622156400.0
17225,5,0,2021-05-29,0,2,3,2,2021-05-29,1622242800.0
17226,5,0,2021-05-30,0,0,3,2,2021-05-30,1622329200.0
17227,5,0,2021-05-31,0,0,3,2,2021-05-31,1622415600.0
17228,5,0,2021-06-01,0,0,3,2,2021-06-01,1622502000.0
17229,5,0,2021-06-02,0,0,3,2,2021-06-02,1622588400.0
17230,5,0,2021-06-03,0,0,3,2,2021-06-03,1622674800.0
17231,5,0,2021-06-04,0,0,3,2,2021-06-04,1622761200.0
17232,5,0,2021-06-05,0,0,3,2,2021-06-05,1622847600.0
17233,5,0,2021-06-06,0,0,3,2,2021-06-06,1622934000.0
17234,5,0,2021-06-07,0,0,3,2,2021-06-07,1623020400.0
17235,5,0,2021-06-08,0,0,3,2,2021-06-08,1623106800.0
17236,5,0,2021-06-09,0,0,3,2,2021-06-09,1623193200.0
17237,5,0,2021-06-10,0,0,3,2,2021-06-10,1623279600.0
17238,5,0,2021-06-11,0,0,3,2,2021-06-11,1623366000.0
17239,5,0,2021-06-12,0,0,3,2,2021-06-12,1623452400.0
17240,5,0,2021-06-13,0,0,3,2,2021-06-13,1623538800.0
17241,5,0,2021-06-14,0,0,3,2,2021-06-14,1623625200.0
17242,5,0,2021-06-15,0,0,3,2,2021-06-15,1623711600.0
17243,5,0,2021-06-16,0,0,3,2,2021-06-16,1623798000.0
17244,5,0,2021-06-17,0,0,3,2,2021-06-17,1623884400.0
17245,5,0,2021-06-18,0,0,3,2,2021-06-18,1623970800.0
17246,5,0,2021-06-19,0,0,3,2,2021-06-19,1624057200.0
17247,5,0,2021-06-20,0,0,3,2,2021-06-20,1624143600.0
17248,5,0,2021-06-21,0,0,3,2,2021-06-21,1624230000.0
17249,5,0,2021-06-22,0,0,3,2,2021-06-22,1624316400.0
17250,5,0,2021-06-23,0,0,3,2,2021-06-23,1624402800.0
17251,5,0,2021-06-24,0,0,3,2,2021-06-24,1624489200.0
17252,5,0,2021-06-25,0,0,3,2,2021-06-25,1624575600.0
17253,5,0,2021-06-26,0,0,3,2,2021-06-26,1624662000.0
17254,5,0,2021-06-27,0,0,3,2,2021-06-27,1624748400.0
17255,5,0,2021-06-28,0,0,3,2,2021-06-28,1624834800.0
17256,5,0,2021-06-29,0,0,3,2,2021-06-29,1624921200.0
17257,5,0,2021-06-30,0,0,3,2,2021-06-30,1625007600.0
17258,5,0,2021-07-01,0,0,3,2,2021-07-01,1625094000.0
17259,5,0,2021-07-02,0,0,3,2,2021-07-02,1625180400.0
17260,5,0,2021-07-03,0,0,3,2,2021-07-03,1625266800.0
17261,5,0,2021-07-04,0,0,3,2,2021-07-04,1625353200.0
17262,5,0,2021-07-05,0,0,3,2,2021-07-05,1625439600.0
17263,5,0,2021-07-06,0,0,3,2,2021-07-06,1625526000.0
17264,5,0,2021-07-07,0,0,3,2,2021-07-07,1625612400.0
17265,5,0,2021-07-08,0,0,3,2,2021-07-08,1625698800.0
17266,6,0,2020-12-27,0,0,0,0,2020-12-27,1609023600.0
17267,6,0,2020-12-28,0,0,0,0,2020-12-28,1609110000.0
17268,6,0,2020-12-29,0,0,0,0,2020-12-29,1609196400.0
17269,6,0,2020-12-30,0,0,0,0,2020-12-30,1609282800.0
17270,6,0,2020-12-31,0,0,0,0,2020-12-31,1609369200.0
17271,6,0,2021-01-01,0,0,0,0,2021-01-01,1609455600.0
17272,6,0,2021-01-02,0,0,0,0,2021-01-02,1609542000.0
17273,6,0,2021-01-03,0,0,0,0,2021-01-03,1609628400.0
17274,6,0,2021-01-04,0,0,0,0,2021-01-04,1609714800.0
17275,6,0,2021-01-05,0,0,0,0,2021-01-05,1609801200.0
17276,6,0,2021-01-06,0,0,0,0,2021-01-06,1609887600.0
17277,6,0,2021-01-07,0,0,0,0,2021-01-07,1609974000.0
17278,6,0,2021-01-08,0,0,0,0,2021-01-08,1610060400.0
17279,6,0,2021-01-09,0,0,0,0,2021-01-09,1610146800.0
17280,6,0,2021-01-10,0,0,0,0,2021-01-10,1610233200.0
17281,6,0,2021-01-11,9,0,9,0,2021-01-11,1610319600.0
17282,6,0,2021-01-12,0,0,9,0,2021-01-12,1610406000.0
17283,6,0,2021-01-13,0,0,9,0,2021-01-13,1610492400.0
17284,6,0,2021-01-14,0,0,9,0,2021-01-14,1610578800.0
17285,6,0,2021-01-15,1,0,10,0,2021-01-15,1610665200.0
17286,6,0,2021-01-16,1,0,11,0,2021-01-16,1610751600.0
17287,6,0,2021-01-17,0,0,11,0,2021-01-17,1610838000.0
17288,6,0,2021-01-18,1,0,12,0,2021-01-18,1610924400.0
17289,6,0,2021-01-19,0,0,12,0,2021-01-19,1611010800.0
17290,6,0,2021-01-20,0,0,12,0,2021-01-20,1611097200.0
17291,6,0,2021-01-21,0,0,12,0,2021-01-21,1611183600.0
17292,6,0,2021-01-22,0,0,12,0,2021-01-22,1611270000.0
17293,6,0,2021-01-23,1,0,13,0,2021-01-23,1611356400.0
17294,6,0,2021-01-24,0,0,13,0,2021-01-24,1611442800.0
17295,6,0,2021-01-25,141,0,154,0,2021-01-25,1611529200.0
17296,6,0,2021-01-26,165,0,319,0,2021-01-26,1611615600.0
17297,6,0,2021-01-27,250,0,569,0,2021-01-27,1611702000.0
17298,6,0,2021-01-28,102,5,671,5,2021-01-28,1611788400.0
17299,6,0,2021-01-29,231,1,902,6,2021-01-29,1611874800.0
17300,6,0,2021-01-30,285,2,1187,8,2021-01-30,1611961200.0
17301,6,0,2021-01-31,1,0,1188,8,2021-01-31,1612047600.0
17302,6,0,2021-02-01,160,0,1348,8,2021-02-01,1612134000.0
17303,6,0,2021-02-02,330,0,1678,8,2021-02-02,1612220400.0
17304,6,0,2021-02-03,228,0,1906,8,2021-02-03,1612306800.0
17305,6,0,2021-02-04,215,3,2121,11,2021-02-04,1612393200.0
17306,6,0,2021-02-05,214,0,2335,11,2021-02-05,1612479600.0
17307,6,0,2021-02-06,83,10,2418,21,2021-02-06,1612566000.0
17308,6,0,2021-02-07,0,0,2418,21,2021-02-07,1612652400.0
17309,6,0,2021-02-08,82,2,2500,23,2021-02-08,1612738800.0
17310,6,0,2021-02-09,194,0,2694,23,2021-02-09,1612825200.0
17311,6,0,2021-02-10,187,1,2881,24,2021-02-10,1612911600.0
17312,6,0,2021-02-11,236,0,3117,24,2021-02-11,1612998000.0
17313,6,0,2021-02-12,287,1,3404,25,2021-02-12,1613084400.0
17314,6,0,2021-02-13,56,0,3460,25,2021-02-13,1613170800.0
17315,6,0,2021-02-14,1,0,3461,25,2021-02-14,1613257200.0
17316,6,0,2021-02-15,359,1,3820,26,2021-02-15,1613343600.0
17317,6,0,2021-02-16,266,3,4086,29,2021-02-16,1613430000.0
17318,6,0,2021-02-17,167,0,4253,29,2021-02-17,1613516400.0
17319,6,0,2021-02-18,217,1,4470,30,2021-02-18,1613602800.0
17320,6,0,2021-02-19,235,14,4705,44,2021-02-19,1613689200.0
17321,6,0,2021-02-20,139,4,4844,48,2021-02-20,1613775600.0
17322,6,0,2021-02-21,0,0,4844,48,2021-02-21,1613862000.0
17323,6,0,2021-02-22,130,118,4974,166,2021-02-22,1613948400.0
17324,6,0,2021-02-23,185,149,5159,315,2021-02-23,1614034800.0
17325,6,0,2021-02-24,176,140,5335,455,2021-02-24,1614121200.0
17326,6,0,2021-02-25,227,280,5562,735,2021-02-25,1614207600.0
17327,6,0,2021-02-26,242,257,5804,992,2021-02-26,1614294000.0
17328,6,0,2021-02-27,0,0,5804,992,2021-02-27,1614380400.0
17329,6,0,2021-02-28,0,0,5804,992,2021-02-28,1614466800.0
17330,6,0,2021-03-01,145,258,5949,1250,2021-03-01,1614553200.0
17331,6,0,2021-03-02,228,255,6177,1505,2021-03-02,1614639600.0
17332,6,0,2021-03-03,202,183,6379,1688,2021-03-03,1614726000.0
17333,6,0,2021-03-04,205,136,6584,1824,2021-03-04,1614812400.0
17334,6,0,2021-03-05,224,109,6808,1933,2021-03-05,1614898800.0
17335,6,0,2021-03-06,1,0,6809,1933,2021-03-06,1614985200.0
17336,6,0,2021-03-07,0,0,6809,1933,2021-03-07,1615071600.0
17337,6,0,2021-03-08,189,124,6998,2057,2021-03-08,1615158000.0
17338,6,0,2021-03-09,391,139,7389,2196,2021-03-09,1615244400.0
17339,6,0,2021-03-10,180,175,7569,2371,2021-03-10,1615330800.0
17340,6,0,2021-03-11,167,204,7736,2575,2021-03-11,1615417200.0
17341,6,0,2021-03-12,238,287,7974,2862,2021-03-12,1615503600.0
17342,6,0,2021-03-13,2,0,7976,2862,2021-03-13,1615590000.0
17343,6,0,2021-03-14,0,0,7976,2862,2021-03-14,1615676400.0
17344,6,0,2021-03-15,157,287,8133,3149,2021-03-15,1615762800.0
17345,6,0,2021-03-16,236,207,8369,3356,2021-03-16,1615849200.0
17346,6,0,2021-03-17,264,130,8633,3486,2021-03-17,1615935600.0
17347,6,0,2021-03-18,172,216,8805,3702,2021-03-18,1616022000.0
17348,6,0,2021-03-19,172,278,8977,3980,2021-03-19,1616108400.0
17349,6,0,2021-03-20,0,0,8977,3980,2021-03-20,1616194800.0
17350,6,0,2021-03-21,0,0,8977,3980,2021-03-21,1616281200.0
17351,6,0,2021-03-22,98,125,9075,4105,2021-03-22,1616367600.0
17352,6,0,2021-03-23,136,234,9211,4339,2021-03-23,1616454000.0
17353,6,0,2021-03-24,160,125,9371,4464,2021-03-24,1616540400.0
17354,6,0,2021-03-25,186,192,9557,4656,2021-03-25,1616626800.0
17355,6,0,2021-03-26,160,204,9717,4860,2021-03-26,1616713200.0
17356,6,0,2021-03-27,18,0,9735,4860,2021-03-27,1616799600.0
17357,6,0,2021-03-28,0,0,9735,4860,2021-03-28,1616886000.0
17358,6,0,2021-03-29,0,2,9735,4862,2021-03-29,1616972400.0
17359,6,0,2021-03-30,272,301,10007,5163,2021-03-30,1617058800.0
17360,6,0,2021-03-31,225,112,10232,5275,2021-03-31,1617145200.0
17361,6,0,2021-04-01,243,86,10475,5361,2021-04-01,1617231600.0
17362,6,0,2021-04-02,286,232,10761,5593,2021-04-02,1617318000.0
17363,6,0,2021-04-03,906,243,11667,5836,2021-04-03,1617404400.0
17364,6,0,2021-04-04,1,0,11668,5836,2021-04-04,1617490800.0
17365,6,0,2021-04-05,1,0,11669,5836,2021-04-05,1617577200.0
17366,6,0,2021-04-06,162,261,11831,6097,2021-04-06,1617663600.0
17367,6,0,2021-04-07,237,241,12068,6338,2021-04-07,1617750000.0
17368,6,0,2021-04-08,286,116,12354,6454,2021-04-08,1617836400.0
17369,6,0,2021-04-09,248,147,12602,6601,2021-04-09,1617922800.0
17370,6,0,2021-04-10,181,87,12783,6688,2021-04-10,1618009200.0
17371,6,0,2021-04-11,7,0,12790,6688,2021-04-11,1618095600.0
17372,6,0,2021-04-12,0,19,12790,6707,2021-04-12,1618185600.0
17373,6,0,2021-04-13,394,318,13184,7025,2021-04-13,1618272000.0
17374,6,0,2021-04-14,239,186,13423,7211,2021-04-14,1618358400.0
17375,6,0,2021-04-15,207,91,13630,7302,2021-04-15,1618444800.0
17376,6,0,2021-04-16,214,103,13844,7405,2021-04-16,1618531200.0
17377,6,0,2021-04-17,226,107,14070,7512,2021-04-17,1618617600.0
17378,6,0,2021-04-18,1,0,14071,7512,2021-04-18,1618704000.0
17379,6,0,2021-04-19,7,1,14078,7513,2021-04-19,1618790400.0
17380,6,0,2021-04-20,368,192,14446,7705,2021-04-20,1618876800.0
17381,6,0,2021-04-21,412,109,14858,7814,2021-04-21,1618963200.0
17382,6,0,2021-04-22,410,110,15268,7924,2021-04-22,1619049600.0
17383,6,0,2021-04-23,367,120,15635,8044,2021-04-23,1619136000.0
17384,6,0,2021-04-24,413,88,16048,8132,2021-04-24,1619222400.0
17385,6,0,2021-04-25,2,0,16050,8132,2021-04-25,1619308800.0
17386,6,0,2021-04-26,54,0,16104,8132,2021-04-26,1619395200.0
17387,6,0,2021-04-27,351,255,16455,8387,2021-04-27,1619481600.0
17388,6,0,2021-04-28,355,472,16810,8859,2021-04-28,1619568000.0
17389,6,0,2021-04-29,558,293,17368,9152,2021-04-29,1619654400.0
17390,6,0,2021-04-30,403,195,17771,9347,2021-04-30,1619740800.0
17391,6,0,2021-05-01,670,209,18441,9556,2021-05-01,1619827200.0
17392,6,0,2021-05-02,0,0,18441,9556,2021-05-02,1619913600.0
17393,6,0,2021-05-03,139,0,18580,9556,2021-05-03,1620000000.0
17394,6,0,2021-05-04,353,380,18933,9936,2021-05-04,1620086400.0
17395,6,0,2021-05-05,447,255,19380,10191,2021-05-05,1620172800.0
17396,6,0,2021-05-06,320,156,19700,10347,2021-05-06,1620259200.0
17397,6,0,2021-05-07,341,90,20041,10437,2021-05-07,1620345600.0
17398,6,0,2021-05-08,300,115,20341,10552,2021-05-08,1620432000.0
17399,6,0,2021-05-09,0,0,20341,10552,2021-05-09,1620518400.0
17400,6,0,2021-05-10,8,9,20349,10561,2021-05-10,1620604800.0
17401,6,0,2021-05-11,360,429,20709,10990,2021-05-11,1620691200.0
17402,6,0,2021-05-12,333,252,21042,11242,2021-05-12,1620777600.0
17403,6,0,2021-05-13,127,71,21169,11313,2021-05-13,1620864000.0
17404,6,0,2021-05-14,0,0,21169,11313,2021-05-14,1620950400.0
17405,6,0,2021-05-15,484,192,21653,11505,2021-05-15,1621036800.0
17406,6,0,2021-05-16,0,0,21653,11505,2021-05-16,1621123200.0
17407,6,0,2021-05-17,122,29,21775,11534,2021-05-17,1621206000.0
17408,6,0,2021-05-18,516,354,22291,11888,2021-05-18,1621292400.0
17409,6,0,2021-05-19,650,565,22941,12453,2021-05-19,1621378800.0
17410,6,0,2021-05-20,1055,350,23996,12803,2021-05-20,1621465200.0
17411,6,0,2021-05-21,1046,195,25042,12998,2021-05-21,1621551600.0
17412,6,0,2021-05-22,1241,173,26283,13171,2021-05-22,1621638000.0
17413,6,0,2021-05-23,0,0,26283,13171,2021-05-23,1621724400.0
17414,6,0,2021-05-24,1,0,26284,13171,2021-05-24,1621810800.0
17415,6,0,2021-05-25,885,522,27169,13693,2021-05-25,1621897200.0
17416,6,0,2021-05-26,1035,716,28204,14409,2021-05-26,1621983600.0
17417,6,0,2021-05-27,1317,351,29521,14760,2021-05-27,1622070000.0
17418,6,0,2021-05-28,954,231,30475,14991,2021-05-28,1622156400.0
17419,6,0,2021-05-29,1130,227,31605,15218,2021-05-29,1622242800.0
17420,6,0,2021-05-30,0,1,31605,15219,2021-05-30,1622329200.0
17421,6,0,2021-05-31,104,3,31709,15222,2021-05-31,1622415600.0
17422,6,0,2021-06-01,1148,487,32857,15709,2021-06-01,1622502000.0
17423,6,0,2021-06-02,1202,295,34059,16004,2021-06-02,1622588400.0
17424,6,0,2021-06-03,804,195,34863,16199,2021-06-03,1622674800.0
17425,6,0,2021-06-04,993,180,35856,16379,2021-06-04,1622761200.0
17426,6,0,2021-06-05,673,210,36529,16589,2021-06-05,1622847600.0
17427,6,0,2021-06-06,1,0,36530,16589,2021-06-06,1622934000.0
17428,6,0,2021-06-07,85,5,36615,16594,2021-06-07,1623020400.0
17429,6,0,2021-06-08,946,320,37561,16914,2021-06-08,1623106800.0
17430,6,0,2021-06-09,965,421,38526,17335,2021-06-09,1623193200.0
17431,6,0,2021-06-10,678,139,39204,17474,2021-06-10,1623279600.0
17432,6,0,2021-06-11,841,252,40045,17726,2021-06-11,1623366000.0
17433,6,0,2021-06-12,578,214,40623,17940,2021-06-12,1623452400.0
17434,6,0,2021-06-13,0,0,40623,17940,2021-06-13,1623538800.0
17435,6,0,2021-06-14,178,84,40801,18024,2021-06-14,1623625200.0
17436,6,0,2021-06-15,399,764,41200,18788,2021-06-15,1623711600.0
17437,6,0,2021-06-16,881,1306,42081,20094,2021-06-16,1623798000.0
17438,6,0,2021-06-17,757,578,42838,20672,2021-06-17,1623884400.0
17439,6,0,2021-06-18,686,524,43524,21196,2021-06-18,1623970800.0
17440,6,0,2021-06-19,527,591,44051,21787,2021-06-19,1624057200.0
17441,6,0,2021-06-20,0,0,44051,21787,2021-06-20,1624143600.0
17442,6,0,2021-06-21,124,115,44175,21902,2021-06-21,1624230000.0
17443,6,0,2021-06-22,424,1084,44599,22986,2021-06-22,1624316400.0
17444,6,0,2021-06-23,647,1103,45246,24089,2021-06-23,1624402800.0
17445,6,0,2021-06-24,456,494,45702,24583,2021-06-24,1624489200.0
17446,6,0,2021-06-25,523,413,46225,24996,2021-06-25,1624575600.0
17447,6,0,2021-06-26,382,641,46607,25637,2021-06-26,1624662000.0
17448,6,0,2021-06-27,0,0,46607,25637,2021-06-27,1624748400.0
17449,6,0,2021-06-28,99,175,46706,25812,2021-06-28,1624834800.0
17450,6,0,2021-06-29,641,919,47347,26731,2021-06-29,1624921200.0
17451,6,0,2021-06-30,630,879,47977,27610,2021-06-30,1625007600.0
17452,6,0,2021-07-01,541,493,48518,28103,2021-07-01,1625094000.0
17453,6,0,2021-07-02,430,381,48948,28484,2021-07-02,1625180400.0
17454,6,0,2021-07-03,434,371,49382,28855,2021-07-03,1625266800.0
17455,6,0,2021-07-04,0,0,49382,28855,2021-07-04,1625353200.0
17456,6,0,2021-07-05,113,208,49495,29063,2021-07-05,1625439600.0
17457,6,0,2021-07-06,493,796,49988,29859,2021-07-06,1625526000.0
17458,6,0,2021-07-07,746,916,50734,30775,2021-07-07,1625612400.0
17459,6,0,2021-07-08,783,564,51517,31339,2021-07-08,1625698800.0
17460,7,0,2020-12-27,0,0,0,0,2020-12-27,1609023600.0
17461,7,0,2020-12-28,0,0,0,0,2020-12-28,1609110000.0
17462,7,0,2020-12-29,0,0,0,0,2020-12-29,1609196400.0
17463,7,0,2020-12-30,0,0,0,0,2020-12-30,1609282800.0
17464,7,0,2020-12-31,0,0,0,0,2020-12-31,1609369200.0
17465,7,0,2021-01-01,0,0,0,0,2021-01-01,1609455600.0
17466,7,0,2021-01-02,0,0,0,0,2021-01-02,1609542000.0
17467,7,0,2021-01-03,0,0,0,0,2021-01-03,1609628400.0
17468,7,0,2021-01-04,0,0,0,0,2021-01-04,1609714800.0
17469,7,0,2021-01-05,0,0,0,0,2021-01-05,1609801200.0
17470,7,0,2021-01-06,0,0,0,0,2021-01-06,1609887600.0
17471,7,0,2021-01-07,0,0,0,0,2021-01-07,1609974000.0
17472,7,0,2021-01-08,0,0,0,0,2021-01-08,1610060400.0
17473,7,0,2021-01-09,0,0,0,0,2021-01-09,1610146800.0
17474,7,0,2021-01-10,0,0,0,0,2021-01-10,1610233200.0
17475,7,0,2021-01-11,0,0,0,0,2021-01-11,1610319600.0
17476,7,0,2021-01-12,0,0,0,0,2021-01-12,1610406000.0
17477,7,0,2021-01-13,0,0,0,0,2021-01-13,1610492400.0
17478,7,0,2021-01-14,0,0,0,0,2021-01-14,1610578800.0
17479,7,0,2021-01-15,0,0,0,0,2021-01-15,1610665200.0
17480,7,0,2021-01-16,0,0,0,0,2021-01-16,1610751600.0
17481,7,0,2021-01-17,0,0,0,0,2021-01-17,1610838000.0
17482,7,0,2021-01-18,1,0,1,0,2021-01-18,1610924400.0
17483,7,0,2021-01-19,0,0,1,0,2021-01-19,1611010800.0
17484,7,0,2021-01-20,0,0,1,0,2021-01-20,1611097200.0
17485,7,0,2021-01-21,12,0,13,0,2021-01-21,1611183600.0
17486,7,0,2021-01-22,12,0,25,0,2021-01-22,1611270000.0
17487,7,0,2021-01-23,0,0,25,0,2021-01-23,1611356400.0
17488,7,0,2021-01-24,0,0,25,0,2021-01-24,1611442800.0
17489,7,0,2021-01-25,0,0,25,0,2021-01-25,1611529200.0
17490,7,0,2021-01-26,0,0,25,0,2021-01-26,1611615600.0
17491,7,0,2021-01-27,12,0,37,0,2021-01-27,1611702000.0
17492,7,0,2021-01-28,1,0,38,0,2021-01-28,1611788400.0
17493,7,0,2021-01-29,6,0,44,0,2021-01-29,1611874800.0
17494,7,0,2021-01-30,0,0,44,0,2021-01-30,1611961200.0
17495,7,0,2021-01-31,0,0,44,0,2021-01-31,1612047600.0
17496,7,0,2021-02-01,0,0,44,0,2021-02-01,1612134000.0
17497,7,0,2021-02-02,0,0,44,0,2021-02-02,1612220400.0
17498,7,0,2021-02-03,11,0,55,0,2021-02-03,1612306800.0
17499,7,0,2021-02-04,12,0,67,0,2021-02-04,1612393200.0
17500,7,0,2021-02-05,11,0,78,0,2021-02-05,1612479600.0
17501,7,0,2021-02-06,0,0,78,0,2021-02-06,1612566000.0
17502,7,0,2021-02-07,0,0,78,0,2021-02-07,1612652400.0
17503,7,0,2021-02-08,0,0,78,0,2021-02-08,1612738800.0
17504,7,0,2021-02-09,13,0,91,0,2021-02-09,1612825200.0
17505,7,0,2021-02-10,0,0,91,0,2021-02-10,1612911600.0
17506,7,0,2021-02-11,17,0,108,0,2021-02-11,1612998000.0
17507,7,0,2021-02-12,45,0,153,0,2021-02-12,1613084400.0
17508,7,0,2021-02-13,0,0,153,0,2021-02-13,1613170800.0
17509,7,0,2021-02-14,0,0,153,0,2021-02-14,1613257200.0
17510,7,0,2021-02-15,0,0,153,0,2021-02-15,1613343600.0
17511,7,0,2021-02-16,0,0,153,0,2021-02-16,1613430000.0
17512,7,0,2021-02-17,0,0,153,0,2021-02-17,1613516400.0
17513,7,0,2021-02-18,18,0,171,0,2021-02-18,1613602800.0
17514,7,0,2021-02-19,34,0,205,0,2021-02-19,1613689200.0
17515,7,0,2021-02-20,0,0,205,0,2021-02-20,1613775600.0
17516,7,0,2021-02-21,0,0,205,0,2021-02-21,1613862000.0
17517,7,0,2021-02-22,0,0,205,0,2021-02-22,1613948400.0
17518,7,0,2021-02-23,0,22,205,22,2021-02-23,1614034800.0
17519,7,0,2021-02-24,0,0,205,22,2021-02-24,1614121200.0
17520,7,0,2021-02-25,15,10,220,32,2021-02-25,1614207600.0
17521,7,0,2021-02-26,33,19,253,51,2021-02-26,1614294000.0
17522,7,0,2021-02-27,0,0,253,51,2021-02-27,1614380400.0
17523,7,0,2021-02-28,0,0,253,51,2021-02-28,1614466800.0
17524,7,0,2021-03-01,0,0,253,51,2021-03-01,1614553200.0
17525,7,0,2021-03-02,17,11,270,62,2021-03-02,1614639600.0
17526,7,0,2021-03-03,0,0,270,62,2021-03-03,1614726000.0
17527,7,0,2021-03-04,16,11,286,73,2021-03-04,1614812400.0
17528,7,0,2021-03-05,33,19,319,92,2021-03-05,1614898800.0
17529,7,0,2021-03-06,0,0,319,92,2021-03-06,1614985200.0
17530,7,0,2021-03-07,0,0,319,92,2021-03-07,1615071600.0
17531,7,0,2021-03-08,0,0,319,92,2021-03-08,1615158000.0
17532,7,0,2021-03-09,1,0,320,92,2021-03-09,1615244400.0
17533,7,0,2021-03-10,0,0,320,92,2021-03-10,1615330800.0
17534,7,0,2021-03-11,20,30,340,122,2021-03-11,1615417200.0
17535,7,0,2021-03-12,62,42,402,164,2021-03-12,1615503600.0
17536,7,0,2021-03-13,0,0,402,164,2021-03-13,1615590000.0
17537,7,0,2021-03-14,0,0,402,164,2021-03-14,1615676400.0
17538,7,0,2021-03-15,0,0,402,164,2021-03-15,1615762800.0
17539,7,0,2021-03-16,30,9,432,173,2021-03-16,1615849200.0
17540,7,0,2021-03-17,0,0,432,173,2021-03-17,1615935600.0
17541,7,0,2021-03-18,29,16,461,189,2021-03-18,1616022000.0
17542,7,0,2021-03-19,56,31,517,220,2021-03-19,1616108400.0
17543,7,0,2021-03-20,0,0,517,220,2021-03-20,1616194800.0
17544,7,0,2021-03-21,0,0,517,220,2021-03-21,1616281200.0
17545,7,0,2021-03-22,0,0,517,220,2021-03-22,1616367600.0
17546,7,0,2021-03-23,0,0,517,220,2021-03-23,1616454000.0
17547,7,0,2021-03-24,0,0,517,220,2021-03-24,1616540400.0
17548,7,0,2021-03-25,65,13,582,233,2021-03-25,1616626800.0
17549,7,0,2021-03-26,73,24,655,257,2021-03-26,1616713200.0
17550,7,0,2021-03-27,0,0,655,257,2021-03-27,1616799600.0
17551,7,0,2021-03-28,0,0,655,257,2021-03-28,1616886000.0
17552,7,0,2021-03-29,0,0,655,257,2021-03-29,1616972400.0
17553,7,0,2021-03-30,40,17,695,274,2021-03-30,1617058800.0
17554,7,0,2021-03-31,26,14,721,288,2021-03-31,1617145200.0
17555,7,0,2021-04-01,25,30,746,318,2021-04-01,1617231600.0
17556,7,0,2021-04-02,0,0,746,318,2021-04-02,1617318000.0
17557,7,0,2021-04-03,0,0,746,318,2021-04-03,1617404400.0
17558,7,0,2021-04-04,0,0,746,318,2021-04-04,1617490800.0
17559,7,0,2021-04-05,9,0,755,318,2021-04-05,1617577200.0
17560,7,0,2021-04-06,0,0,755,318,2021-04-06,1617663600.0
17561,7,0,2021-04-07,0,0,755,318,2021-04-07,1617750000.0
17562,7,0,2021-04-08,57,46,812,364,2021-04-08,1617836400.0
17563,7,0,2021-04-09,59,31,871,395,2021-04-09,1617922800.0
17564,7,0,2021-04-10,0,0,871,395,2021-04-10,1618009200.0
17565,7,0,2021-04-11,0,0,871,395,2021-04-11,1618095600.0
17566,7,0,2021-04-12,0,0,871,395,2021-04-12,1618185600.0
17567,7,0,2021-04-13,0,0,871,395,2021-04-13,1618272000.0
17568,7,0,2021-04-14,5,6,876,401,2021-04-14,1618358400.0
17569,7,0,2021-04-15,56,67,932,468,2021-04-15,1618444800.0
17570,7,0,2021-04-16,90,33,1022,501,2021-04-16,1618531200.0
17571,7,0,2021-04-17,0,1,1022,502,2021-04-17,1618617600.0
17572,7,0,2021-04-18,0,0,1022,502,2021-04-18,1618704000.0
17573,7,0,2021-04-19,1,0,1023,502,2021-04-19,1618790400.0
17574,7,0,2021-04-20,335,53,1358,555,2021-04-20,1618876800.0
17575,7,0,2021-04-21,337,11,1695,566,2021-04-21,1618963200.0
17576,7,0,2021-04-22,284,27,1979,593,2021-04-22,1619049600.0
17577,7,0,2021-04-23,258,38,2237,631,2021-04-23,1619136000.0
17578,7,0,2021-04-24,231,1,2468,632,2021-04-24,1619222400.0
17579,7,0,2021-04-25,0,0,2468,632,2021-04-25,1619308800.0
17580,7,0,2021-04-26,283,9,2751,641,2021-04-26,1619395200.0
17581,7,0,2021-04-27,224,41,2975,682,2021-04-27,1619481600.0
17582,7,0,2021-04-28,192,9,3167,691,2021-04-28,1619568000.0
17583,7,0,2021-04-29,170,14,3337,705,2021-04-29,1619654400.0
17584,7,0,2021-04-30,172,12,3509,717,2021-04-30,1619740800.0
17585,7,0,2021-05-01,201,9,3710,726,2021-05-01,1619827200.0
17586,7,0,2021-05-02,0,0,3710,726,2021-05-02,1619913600.0
17587,7,0,2021-05-03,135,6,3845,732,2021-05-03,1620000000.0
17588,7,0,2021-05-04,161,36,4006,768,2021-05-04,1620086400.0
17589,7,0,2021-05-05,221,10,4227,778,2021-05-05,1620172800.0
17590,7,0,2021-05-06,175,25,4402,803,2021-05-06,1620259200.0
17591,7,0,2021-05-07,149,21,4551,824,2021-05-07,1620345600.0
17592,7,0,2021-05-08,1,0,4552,824,2021-05-08,1620432000.0
17593,7,0,2021-05-09,0,2,4552,826,2021-05-09,1620518400.0
17594,7,0,2021-05-10,0,0,4552,826,2021-05-10,1620604800.0
17595,7,0,2021-05-11,2,41,4554,867,2021-05-11,1620691200.0
17596,7,0,2021-05-12,6,36,4560,903,2021-05-12,1620777600.0
17597,7,0,2021-05-13,0,0,4560,903,2021-05-13,1620864000.0
17598,7,0,2021-05-14,28,97,4588,1000,2021-05-14,1620950400.0
17599,7,0,2021-05-15,0,0,4588,1000,2021-05-15,1621036800.0
17600,7,0,2021-05-16,1,0,4589,1000,2021-05-16,1621123200.0
17601,7,0,2021-05-17,1,13,4590,1013,2021-05-17,1621206000.0
17602,7,0,2021-05-18,17,28,4607,1041,2021-05-18,1621292400.0
17603,7,0,2021-05-19,0,1,4607,1042,2021-05-19,1621378800.0
17604,7,0,2021-05-20,0,8,4607,1050,2021-05-20,1621465200.0
17605,7,0,2021-05-21,12,30,4619,1080,2021-05-21,1621551600.0
17606,7,0,2021-05-22,0,0,4619,1080,2021-05-22,1621638000.0
17607,7,0,2021-05-23,0,0,4619,1080,2021-05-23,1621724400.0
17608,7,0,2021-05-24,0,0,4619,1080,2021-05-24,1621810800.0
17609,7,0,2021-05-25,50,327,4669,1407,2021-05-25,1621897200.0
17610,7,0,2021-05-26,54,349,4723,1756,2021-05-26,1621983600.0
17611,7,0,2021-05-27,34,316,4757,2072,2021-05-27,1622070000.0
17612,7,0,2021-05-28,27,251,4784,2323,2021-05-28,1622156400.0
17613,7,0,2021-05-29,35,371,4819,2694,2021-05-29,1622242800.0
17614,7,0,2021-05-30,0,0,4819,2694,2021-05-30,1622329200.0
17615,7,0,2021-05-31,45,213,4864,2907,2021-05-31,1622415600.0
17616,7,0,2021-06-01,47,223,4911,3130,2021-06-01,1622502000.0
17617,7,0,2021-06-02,69,262,4980,3392,2021-06-02,1622588400.0
17618,7,0,2021-06-03,41,243,5021,3635,2021-06-03,1622674800.0
17619,7,0,2021-06-04,74,262,5095,3897,2021-06-04,1622761200.0
17620,7,0,2021-06-05,1,0,5096,3897,2021-06-05,1622847600.0
17621,7,0,2021-06-06,0,0,5096,3897,2021-06-06,1622934000.0
17622,7,0,2021-06-07,1,1,5097,3898,2021-06-07,1623020400.0
17623,7,0,2021-06-08,3,2,5100,3900,2021-06-08,1623106800.0
17624,7,0,2021-06-09,0,3,5100,3903,2021-06-09,1623193200.0
17625,7,0,2021-06-10,8,1,5108,3904,2021-06-10,1623279600.0
17626,7,0,2021-06-11,3,6,5111,3910,2021-06-11,1623366000.0
17627,7,0,2021-06-12,16,56,5127,3966,2021-06-12,1623452400.0
17628,7,0,2021-06-13,0,0,5127,3966,2021-06-13,1623538800.0
17629,7,0,2021-06-14,0,0,5127,3966,2021-06-14,1623625200.0
17630,7,0,2021-06-15,0,1,5127,3967,2021-06-15,1623711600.0
17631,7,0,2021-06-16,0,0,5127,3967,2021-06-16,1623798000.0
17632,7,0,2021-06-17,2,6,5129,3973,2021-06-17,1623884400.0
17633,7,0,2021-06-18,0,2,5129,3975,2021-06-18,1623970800.0
17634,7,0,2021-06-19,25,47,5154,4022,2021-06-19,1624057200.0
17635,7,0,2021-06-20,0,0,5154,4022,2021-06-20,1624143600.0
17636,7,0,2021-06-21,0,2,5154,4024,2021-06-21,1624230000.0
17637,7,0,2021-06-22,8,0,5162,4024,2021-06-22,1624316400.0
17638,7,0,2021-06-23,15,2,5177,4026,2021-06-23,1624402800.0
17639,7,0,2021-06-24,10,5,5187,4031,2021-06-24,1624489200.0
17640,7,0,2021-06-25,0,0,5187,4031,2021-06-25,1624575600.0
17641,7,0,2021-06-26,28,39,5215,4070,2021-06-26,1624662000.0
17642,7,0,2021-06-27,0,0,5215,4070,2021-06-27,1624748400.0
17643,7,0,2021-06-28,0,1,5215,4071,2021-06-28,1624834800.0
17644,7,0,2021-06-29,0,0,5215,4071,2021-06-29,1624921200.0
17645,7,0,2021-06-30,0,0,5215,4071,2021-06-30,1625007600.0
17646,7,0,2021-07-01,26,22,5241,4093,2021-07-01,1625094000.0
17647,7,0,2021-07-02,26,22,5267,4115,2021-07-02,1625180400.0
17648,7,0,2021-07-03,27,206,5294,4321,2021-07-03,1625266800.0
17649,7,0,2021-07-04,0,0,5294,4321,2021-07-04,1625353200.0
17650,7,0,2021-07-05,4,8,5298,4329,2021-07-05,1625439600.0
17651,7,0,2021-07-06,0,0,5298,4329,2021-07-06,1625526000.0
17652,7,0,2021-07-07,8,0,5306,4329,2021-07-07,1625612400.0
17653,7,0,2021-07-08,33,16,5339,4345,2021-07-08,1625698800.0
17654,8,0,2020-12-27,0,0,0,0,2020-12-27,1609023600.0
17655,8,0,2020-12-28,0,0,0,0,2020-12-28,1609110000.0
17656,8,0,2020-12-29,0,0,0,0,2020-12-29,1609196400.0
17657,8,0,2020-12-30,0,0,0,0,2020-12-30,1609282800.0
17658,8,0,2020-12-31,0,0,0,0,2020-12-31,1609369200.0
17659,8,0,2021-01-01,0,0,0,0,2021-01-01,1609455600.0
17660,8,0,2021-01-02,0,0,0,0,2021-01-02,1609542000.0
17661,8,0,2021-01-03,0,0,0,0,2021-01-03,1609628400.0
17662,8,0,2021-01-04,0,0,0,0,2021-01-04,1609714800.0
17663,8,0,2021-01-05,0,0,0,0,2021-01-05,1609801200.0
17664,8,0,2021-01-06,0,0,0,0,2021-01-06,1609887600.0
17665,8,0,2021-01-07,0,0,0,0,2021-01-07,1609974000.0
17666,8,0,2021-01-08,0,0,0,0,2021-01-08,1610060400.0
17667,8,0,2021-01-09,0,0,0,0,2021-01-09,1610146800.0
17668,8,0,2021-01-10,0,0,0,0,2021-01-10,1610233200.0
17669,8,0,2021-01-11,0,0,0,0,2021-01-11,1610319600.0
17670,8,0,2021-01-12,0,0,0,0,2021-01-12,1610406000.0
17671,8,0,2021-01-13,10,0,10,0,2021-01-13,1610492400.0
17672,8,0,2021-01-14,12,0,22,0,2021-01-14,1610578800.0
17673,8,0,2021-01-15,9,0,31,0,2021-01-15,1610665200.0
17674,8,0,2021-01-16,0,0,31,0,2021-01-16,1610751600.0
17675,8,0,2021-01-17,0,0,31,0,2021-01-17,1610838000.0
17676,8,0,2021-01-18,0,0,31,0,2021-01-18,1610924400.0
17677,8,0,2021-01-19,12,0,43,0,2021-01-19,1611010800.0
17678,8,0,2021-01-20,12,0,55,0,2021-01-20,1611097200.0
17679,8,0,2021-01-21,6,0,61,0,2021-01-21,1611183600.0
17680,8,0,2021-01-22,0,0,61,0,2021-01-22,1611270000.0
17681,8,0,2021-01-23,0,0,61,0,2021-01-23,1611356400.0
17682,8,0,2021-01-24,0,0,61,0,2021-01-24,1611442800.0
17683,8,0,2021-01-25,0,0,61,0,2021-01-25,1611529200.0
17684,8,0,2021-01-26,9,0,70,0,2021-01-26,1611615600.0
17685,8,0,2021-01-27,10,0,80,0,2021-01-27,1611702000.0
17686,8,0,2021-01-28,6,0,86,0,2021-01-28,1611788400.0
17687,8,0,2021-01-29,0,0,86,0,2021-01-29,1611874800.0
17688,8,0,2021-01-30,0,0,86,0,2021-01-30,1611961200.0
17689,8,0,2021-01-31,0,0,86,0,2021-01-31,1612047600.0
17690,8,0,2021-02-01,0,0,86,0,2021-02-01,1612134000.0
17691,8,0,2021-02-02,38,0,124,0,2021-02-02,1612220400.0
17692,8,0,2021-02-03,10,0,134,0,2021-02-03,1612306800.0
17693,8,0,2021-02-04,29,1,163,1,2021-02-04,1612393200.0
17694,8,0,2021-02-05,6,0,169,1,2021-02-05,1612479600.0
17695,8,0,2021-02-06,0,0,169,1,2021-02-06,1612566000.0
17696,8,0,2021-02-07,0,0,169,1,2021-02-07,1612652400.0
17697,8,0,2021-02-08,0,0,169,1,2021-02-08,1612738800.0
17698,8,0,2021-02-09,38,0,207,1,2021-02-09,1612825200.0
17699,8,0,2021-02-10,27,0,234,1,2021-02-10,1612911600.0
17700,8,0,2021-02-11,0,0,234,1,2021-02-11,1612998000.0
17701,8,0,2021-02-12,36,0,270,1,2021-02-12,1613084400.0
17702,8,0,2021-02-13,0,0,270,1,2021-02-13,1613170800.0
17703,8,0,2021-02-14,0,0,270,1,2021-02-14,1613257200.0
17704,8,0,2021-02-15,50,0,320,1,2021-02-15,1613343600.0
17705,8,0,2021-02-16,0,0,320,1,2021-02-16,1613430000.0
17706,8,0,2021-02-17,0,0,320,1,2021-02-17,1613516400.0
17707,8,0,2021-02-18,27,0,347,1,2021-02-18,1613602800.0
17708,8,0,2021-02-19,44,0,391,1,2021-02-19,1613689200.0
17709,8,0,2021-02-20,0,0,391,1,2021-02-20,1613775600.0
17710,8,0,2021-02-21,0,0,391,1,2021-02-21,1613862000.0
17711,8,0,2021-02-22,45,2,436,3,2021-02-22,1613948400.0
17712,8,0,2021-02-23,41,29,477,32,2021-02-23,1614034800.0
17713,8,0,2021-02-24,35,1,512,33,2021-02-24,1614121200.0
17714,8,0,2021-02-25,55,35,567,68,2021-02-25,1614207600.0
17715,8,0,2021-02-26,39,2,606,70,2021-02-26,1614294000.0
17716,8,0,2021-02-27,0,0,606,70,2021-02-27,1614380400.0
17717,8,0,2021-02-28,0,0,606,70,2021-02-28,1614466800.0
17718,8,0,2021-03-01,48,5,654,75,2021-03-01,1614553200.0
17719,8,0,2021-03-02,7,27,661,102,2021-03-02,1614639600.0
17720,8,0,2021-03-03,38,27,699,129,2021-03-03,1614726000.0
17721,8,0,2021-03-04,30,26,729,155,2021-03-04,1614812400.0
17722,8,0,2021-03-05,46,9,775,164,2021-03-05,1614898800.0
17723,8,0,2021-03-06,0,0,775,164,2021-03-06,1614985200.0
17724,8,0,2021-03-07,0,0,775,164,2021-03-07,1615071600.0
17725,8,0,2021-03-08,30,7,805,171,2021-03-08,1615158000.0
17726,8,0,2021-03-09,19,27,824,198,2021-03-09,1615244400.0
17727,8,0,2021-03-10,32,27,856,225,2021-03-10,1615330800.0
17728,8,0,2021-03-11,2,0,858,225,2021-03-11,1615417200.0
17729,8,0,2021-03-12,52,21,910,246,2021-03-12,1615503600.0
17730,8,0,2021-03-13,11,0,921,246,2021-03-13,1615590000.0
17731,8,0,2021-03-14,0,0,921,246,2021-03-14,1615676400.0
17732,8,0,2021-03-15,31,42,952,288,2021-03-15,1615762800.0
17733,8,0,2021-03-16,73,3,1025,291,2021-03-16,1615849200.0
17734,8,0,2021-03-17,67,13,1092,304,2021-03-17,1615935600.0
17735,8,0,2021-03-18,82,39,1174,343,2021-03-18,1616022000.0
17736,8,0,2021-03-19,30,46,1204,389,2021-03-19,1616108400.0
17737,8,0,2021-03-20,0,0,1204,389,2021-03-20,1616194800.0
17738,8,0,2021-03-21,0,0,1204,389,2021-03-21,1616281200.0
17739,8,0,2021-03-22,34,45,1238,434,2021-03-22,1616367600.0
17740,8,0,2021-03-23,30,43,1268,477,2021-03-23,1616454000.0
17741,8,0,2021-03-24,38,42,1306,519,2021-03-24,1616540400.0
17742,8,0,2021-03-25,92,31,1398,550,2021-03-25,1616626800.0
17743,8,0,2021-03-26,45,32,1443,582,2021-03-26,1616713200.0
17744,8,0,2021-03-27,94,0,1537,582,2021-03-27,1616799600.0
17745,8,0,2021-03-28,0,0,1537,582,2021-03-28,1616886000.0
17746,8,0,2021-03-29,69,47,1606,629,2021-03-29,1616972400.0
17747,8,0,2021-03-30,98,19,1704,648,2021-03-30,1617058800.0
17748,8,0,2021-03-31,89,44,1793,692,2021-03-31,1617145200.0
17749,8,0,2021-04-01,56,45,1849,737,2021-04-01,1617231600.0
17750,8,0,2021-04-02,0,0,1849,737,2021-04-02,1617318000.0
17751,8,0,2021-04-03,0,0,1849,737,2021-04-03,1617404400.0
17752,8,0,2021-04-04,0,0,1849,737,2021-04-04,1617490800.0
17753,8,0,2021-04-05,0,0,1849,737,2021-04-05,1617577200.0
17754,8,0,2021-04-06,49,61,1898,798,2021-04-06,1617663600.0
17755,8,0,2021-04-07,91,28,1989,826,2021-04-07,1617750000.0
17756,8,0,2021-04-08,120,3,2109,829,2021-04-08,1617836400.0
17757,8,0,2021-04-09,89,27,2198,856,2021-04-09,1617922800.0
17758,8,0,2021-04-10,164,1,2362,857,2021-04-10,1618009200.0
17759,8,0,2021-04-11,0,0,2362,857,2021-04-11,1618095600.0
17760,8,0,2021-04-12,41,72,2403,929,2021-04-12,1618185600.0
17761,8,0,2021-04-13,48,71,2451,1000,2021-04-13,1618272000.0
17762,8,0,2021-04-14,81,43,2532,1043,2021-04-14,1618358400.0
17763,8,0,2021-04-15,92,20,2624,1063,2021-04-15,1618444800.0
17764,8,0,2021-04-16,77,38,2701,1101,2021-04-16,1618531200.0
17765,8,0,2021-04-17,165,0,2866,1101,2021-04-17,1618617600.0
17766,8,0,2021-04-18,0,0,2866,1101,2021-04-18,1618704000.0
17767,8,0,2021-04-19,52,64,2918,1165,2021-04-19,1618790400.0
17768,8,0,2021-04-20,83,27,3001,1192,2021-04-20,1618876800.0
17769,8,0,2021-04-21,91,24,3092,1216,2021-04-21,1618963200.0
17770,8,0,2021-04-22,101,18,3193,1234,2021-04-22,1619049600.0
17771,8,0,2021-04-23,44,65,3237,1299,2021-04-23,1619136000.0
17772,8,0,2021-04-24,99,72,3336,1371,2021-04-24,1619222400.0
17773,8,0,2021-04-25,0,0,3336,1371,2021-04-25,1619308800.0
17774,8,0,2021-04-26,28,88,3364,1459,2021-04-26,1619395200.0
17775,8,0,2021-04-27,59,61,3423,1520,2021-04-27,1619481600.0
17776,8,0,2021-04-28,90,34,3513,1554,2021-04-28,1619568000.0
17777,8,0,2021-04-29,89,30,3602,1584,2021-04-29,1619654400.0
17778,8,0,2021-04-30,104,9,3706,1593,2021-04-30,1619740800.0
17779,8,0,2021-05-01,0,8,3706,1601,2021-05-01,1619827200.0
17780,8,0,2021-05-02,0,0,3706,1601,2021-05-02,1619913600.0
17781,8,0,2021-05-03,24,96,3730,1697,2021-05-03,1620000000.0
17782,8,0,2021-05-04,158,97,3888,1794,2021-05-04,1620086400.0
17783,8,0,2021-05-05,141,50,4029,1844,2021-05-05,1620172800.0
17784,8,0,2021-05-06,200,30,4229,1874,2021-05-06,1620259200.0
17785,8,0,2021-05-07,127,64,4356,1938,2021-05-07,1620345600.0
17786,8,0,2021-05-08,69,120,4425,2058,2021-05-08,1620432000.0
17787,8,0,2021-05-09,0,0,4425,2058,2021-05-09,1620518400.0
17788,8,0,2021-05-10,124,92,4549,2150,2021-05-10,1620604800.0
17789,8,0,2021-05-11,132,73,4681,2223,2021-05-11,1620691200.0
17790,8,0,2021-05-12,156,58,4837,2281,2021-05-12,1620777600.0
17791,8,0,2021-05-13,83,0,4920,2281,2021-05-13,1620864000.0
17792,8,0,2021-05-14,129,49,5049,2330,2021-05-14,1620950400.0
17793,8,0,2021-05-15,86,2,5135,2332,2021-05-15,1621036800.0
17794,8,0,2021-05-16,0,0,5135,2332,2021-05-16,1621123200.0
17795,8,0,2021-05-17,146,100,5281,2432,2021-05-17,1621206000.0
17796,8,0,2021-05-18,151,83,5432,2515,2021-05-18,1621292400.0
17797,8,0,2021-05-19,84,68,5516,2583,2021-05-19,1621378800.0
17798,8,0,2021-05-20,104,19,5620,2602,2021-05-20,1621465200.0
17799,8,0,2021-05-21,98,38,5718,2640,2021-05-21,1621551600.0
17800,8,0,2021-05-22,100,2,5818,2642,2021-05-22,1621638000.0
17801,8,0,2021-05-23,0,0,5818,2642,2021-05-23,1621724400.0
17802,8,0,2021-05-24,33,0,5851,2642,2021-05-24,1621810800.0
17803,8,0,2021-05-25,119,66,5970,2708,2021-05-25,1621897200.0
17804,8,0,2021-05-26,110,33,6080,2741,2021-05-26,1621983600.0
17805,8,0,2021-05-27,111,35,6191,2776,2021-05-27,1622070000.0
17806,8,0,2021-05-28,33,1,6224,2777,2021-05-28,1622156400.0
17807,8,0,2021-05-29,59,211,6283,2988,2021-05-29,1622242800.0
17808,8,0,2021-05-30,0,0,6283,2988,2021-05-30,1622329200.0
17809,8,0,2021-05-31,109,55,6392,3043,2021-05-31,1622415600.0
17810,8,0,2021-06-01,112,50,6504,3093,2021-06-01,1622502000.0
17811,8,0,2021-06-02,131,24,6635,3117,2021-06-02,1622588400.0
17812,8,0,2021-06-03,101,31,6736,3148,2021-06-03,1622674800.0
17813,8,0,2021-06-04,128,60,6864,3208,2021-06-04,1622761200.0
17814,8,0,2021-06-05,82,19,6946,3227,2021-06-05,1622847600.0
17815,8,0,2021-06-06,0,0,6946,3227,2021-06-06,1622934000.0
17816,8,0,2021-06-07,96,86,7042,3313,2021-06-07,1623020400.0
17817,8,0,2021-06-08,81,82,7123,3395,2021-06-08,1623106800.0
17818,8,0,2021-06-09,98,66,7221,3461,2021-06-09,1623193200.0
17819,8,0,2021-06-10,111,49,7332,3510,2021-06-10,1623279600.0
17820,8,0,2021-06-11,116,85,7448,3595,2021-06-11,1623366000.0
17821,8,0,2021-06-12,57,25,7505,3620,2021-06-12,1623452400.0
17822,8,0,2021-06-13,0,0,7505,3620,2021-06-13,1623538800.0
17823,8,0,2021-06-14,106,107,7611,3727,2021-06-14,1623625200.0
17824,8,0,2021-06-15,86,109,7697,3836,2021-06-15,1623711600.0
17825,8,0,2021-06-16,103,142,7800,3978,2021-06-16,1623798000.0
17826,8,0,2021-06-17,84,64,7884,4042,2021-06-17,1623884400.0
17827,8,0,2021-06-18,66,96,7950,4138,2021-06-18,1623970800.0
17828,8,0,2021-06-19,64,73,8014,4211,2021-06-19,1624057200.0
17829,8,0,2021-06-20,0,0,8014,4211,2021-06-20,1624143600.0
17830,8,0,2021-06-21,78,140,8092,4351,2021-06-21,1624230000.0
17831,8,0,2021-06-22,70,95,8162,4446,2021-06-22,1624316400.0
17832,8,0,2021-06-23,68,108,8230,4554,2021-06-23,1624402800.0
17833,8,0,2021-06-24,42,69,8272,4623,2021-06-24,1624489200.0
17834,8,0,2021-06-25,63,88,8335,4711,2021-06-25,1624575600.0
17835,8,0,2021-06-26,35,58,8370,4769,2021-06-26,1624662000.0
17836,8,0,2021-06-27,0,0,8370,4769,2021-06-27,1624748400.0
17837,8,0,2021-06-28,70,125,8440,4894,2021-06-28,1624834800.0
17838,8,0,2021-06-29,59,95,8499,4989,2021-06-29,1624921200.0
17839,8,0,2021-06-30,56,106,8555,5095,2021-06-30,1625007600.0
17840,8,0,2021-07-01,41,80,8596,5175,2021-07-01,1625094000.0
17841,8,0,2021-07-02,52,89,8648,5264,2021-07-02,1625180400.0
17842,8,0,2021-07-03,40,86,8688,5350,2021-07-03,1625266800.0
17843,8,0,2021-07-04,0,1,8688,5351,2021-07-04,1625353200.0
17844,8,0,2021-07-05,66,90,8754,5441,2021-07-05,1625439600.0
17845,8,0,2021-07-06,55,71,8809,5512,2021-07-06,1625526000.0
17846,8,0,2021-07-07,55,120,8864,5632,2021-07-07,1625612400.0
17847,8,0,2021-07-08,52,104,8916,5736,2021-07-08,1625698800.0
17848,11,0,2020-12-27,13,0,13,0,2020-12-27,1609023600.0
17849,11,0,2020-12-28,12,0,25,0,2020-12-28,1609110000.0
17850,11,0,2020-12-29,56,0,81,0,2020-12-29,1609196400.0
17851,11,0,2020-12-30,91,0,172,0,2020-12-30,1609282800.0
17852,11,0,2020-12-31,39,0,211,0,2020-12-31,1609369200.0
17853,11,0,2021-01-01,32,0,243,0,2021-01-01,1609455600.0
17854,11,0,2021-01-02,64,0,307,0,2021-01-02,1609542000.0
17855,11,0,2021-01-03,78,0,385,0,2021-01-03,1609628400.0
17856,11,0,2021-01-04,554,0,939,0,2021-01-04,1609714800.0
17857,11,0,2021-01-05,2075,0,3014,0,2021-01-05,1609801200.0
17858,11,0,2021-01-06,3022,0,6036,0,2021-01-06,1609887600.0
17859,11,0,2021-01-07,5394,0,11430,0,2021-01-07,1609974000.0
17860,11,0,2021-01-08,7136,0,18566,0,2021-01-08,1610060400.0
17861,11,0,2021-01-09,1897,0,20463,0,2021-01-09,1610146800.0
17862,11,0,2021-01-10,1756,0,22219,0,2021-01-10,1610233200.0
17863,11,0,2021-01-11,8022,0,30241,0,2021-01-11,1610319600.0
17864,11,0,2021-01-12,10381,0,40622,0,2021-01-12,1610406000.0
17865,11,0,2021-01-13,10030,0,50652,0,2021-01-13,1610492400.0
17866,11,0,2021-01-14,10161,0,60813,0,2021-01-14,1610578800.0
17867,11,0,2021-01-15,8931,0,69744,0,2021-01-15,1610665200.0
17868,11,0,2021-01-16,2419,9,72163,9,2021-01-16,1610751600.0
17869,11,0,2021-01-17,1093,6,73256,15,2021-01-17,1610838000.0
17870,11,0,2021-01-18,12269,22,85525,37,2021-01-18,1610924400.0
17871,11,0,2021-01-19,15871,22,101396,59,2021-01-19,1611010800.0
17872,11,0,2021-01-20,18396,26,119792,85,2021-01-20,1611097200.0
17873,11,0,2021-01-21,22327,25,142119,110,2021-01-21,1611183600.0
17874,11,0,2021-01-22,17116,54,159235,164,2021-01-22,1611270000.0
17875,11,0,2021-01-23,4963,7,164198,171,2021-01-23,1611356400.0
17876,11,0,2021-01-24,1285,0,165483,171,2021-01-24,1611442800.0
17877,11,0,2021-01-25,8875,153,174358,324,2021-01-25,1611529200.0
17878,11,0,2021-01-26,12349,333,186707,657,2021-01-26,1611615600.0
17879,11,0,2021-01-27,16235,641,202942,1298,2021-01-27,1611702000.0
17880,11,0,2021-01-28,20314,1112,223256,2410,2021-01-28,1611788400.0
17881,11,0,2021-01-29,15404,1298,238660,3708,2021-01-29,1611874800.0
17882,11,0,2021-01-30,4468,82,243128,3790,2021-01-30,1611961200.0
17883,11,0,2021-01-31,586,19,243714,3809,2021-01-31,1612047600.0
17884,11,0,2021-02-01,7393,1937,251107,5746,2021-02-01,1612134000.0
17885,11,0,2021-02-02,8359,2793,259466,8539,2021-02-02,1612220400.0
17886,11,0,2021-02-03,8130,3778,267596,12317,2021-02-03,1612306800.0
17887,11,0,2021-02-04,8787,4567,276383,16884,2021-02-04,1612393200.0
17888,11,0,2021-02-05,8953,4406,285336,21290,2021-02-05,1612479600.0
17889,11,0,2021-02-06,3273,744,288609,22034,2021-02-06,1612566000.0
17890,11,0,2021-02-07,588,535,289197,22569,2021-02-07,1612652400.0
17891,11,0,2021-02-08,6227,5857,295424,28426,2021-02-08,1612738800.0
17892,11,0,2021-02-09,8443,9563,303867,37989,2021-02-09,1612825200.0
17893,11,0,2021-02-10,9972,11020,313839,49009,2021-02-10,1612911600.0
17894,11,0,2021-02-11,12388,16169,326227,65178,2021-02-11,1612998000.0
17895,11,0,2021-02-12,11877,10268,338104,75446,2021-02-12,1613084400.0
17896,11,0,2021-02-13,2596,2555,340700,78001,2021-02-13,1613170800.0
17897,11,0,2021-02-14,315,554,341015,78555,2021-02-14,1613257200.0
17898,11,0,2021-02-15,4460,11863,345475,90418,2021-02-15,1613343600.0
17899,11,0,2021-02-16,5683,18266,351158,108684,2021-02-16,1613430000.0
17900,11,0,2021-02-17,5692,15412,356850,124096,2021-02-17,1613516400.0
17901,11,0,2021-02-18,8651,20464,365501,144560,2021-02-18,1613602800.0
17902,11,0,2021-02-19,9047,15139,374548,159699,2021-02-19,1613689200.0
17903,11,0,2021-02-20,1691,4806,376239,164505,2021-02-20,1613775600.0
17904,11,0,2021-02-21,398,817,376637,165322,2021-02-21,1613862000.0
17905,11,0,2021-02-22,4231,9813,380868,175135,2021-02-22,1613948400.0
17906,11,0,2021-02-23,4954,10377,385822,185512,2021-02-23,1614034800.0
17907,11,0,2021-02-24,5422,9750,391244,195262,2021-02-24,1614121200.0
17908,11,0,2021-02-25,8629,13817,399873,209079,2021-02-25,1614207600.0
17909,11,0,2021-02-26,11200,9877,411073,218956,2021-02-26,1614294000.0
17910,11,0,2021-02-27,5069,3197,416142,222153,2021-02-27,1614380400.0
17911,11,0,2021-02-28,748,626,416890,222779,2021-02-28,1614466800.0
17912,11,0,2021-03-01,8860,7677,425750,230456,2021-03-01,1614553200.0
17913,11,0,2021-03-02,14400,9264,440150,239720,2021-03-02,1614639600.0
17914,11,0,2021-03-03,18702,9528,458852,249248,2021-03-03,1614726000.0
17915,11,0,2021-03-04,28295,10208,487147,259456,2021-03-04,1614812400.0
17916,11,0,2021-03-05,36531,10002,523678,269458,2021-03-05,1614898800.0
17917,11,0,2021-03-06,46458,2731,570136,272189,2021-03-06,1614985200.0
17918,11,0,2021-03-07,34314,2188,604450,274377,2021-03-07,1615071600.0
17919,11,0,2021-03-08,17789,6868,622239,281245,2021-03-08,1615158000.0
17920,11,0,2021-03-09,26896,6987,649135,288232,2021-03-09,1615244400.0
17921,11,0,2021-03-10,27681,7534,676816,295766,2021-03-10,1615330800.0
17922,11,0,2021-03-11,37097,8644,713913,304410,2021-03-11,1615417200.0
17923,11,0,2021-03-12,44849,8103,758762,312513,2021-03-12,1615503600.0
17924,11,0,2021-03-13,39901,1845,798663,314358,2021-03-13,1615590000.0
17925,11,0,2021-03-14,14277,474,812940,314832,2021-03-14,1615676400.0
17926,11,0,2021-03-15,29257,3249,842197,318081,2021-03-15,1615762800.0
17927,11,0,2021-03-16,23778,3260,865975,321341,2021-03-16,1615849200.0
17928,11,0,2021-03-17,24469,3022,890444,324363,2021-03-17,1615935600.0
17929,11,0,2021-03-18,29044,3235,919488,327598,2021-03-18,1616022000.0
17930,11,0,2021-03-19,39709,3052,959197,330650,2021-03-19,1616108400.0
17931,11,0,2021-03-20,25881,881,985078,331531,2021-03-20,1616194800.0
17932,11,0,2021-03-21,5638,1068,990716,332599,2021-03-21,1616281200.0
17933,11,0,2021-03-22,32183,3135,1022899,335734,2021-03-22,1616367600.0
17934,11,0,2021-03-23,43366,4020,1066265,339754,2021-03-23,1616454000.0
17935,11,0,2021-03-24,42723,3674,1108988,343428,2021-03-24,1616540400.0
17936,11,0,2021-03-25,58027,3295,1167015,346723,2021-03-25,1616626800.0
17937,11,0,2021-03-26,57853,3853,1224868,350576,2021-03-26,1616713200.0
17938,11,0,2021-03-27,34520,1029,1259388,351605,2021-03-27,1616799600.0
17939,11,0,2021-03-28,10174,158,1269562,351763,2021-03-28,1616886000.0
17940,11,0,2021-03-29,33123,6977,1302685,358740,2021-03-29,1616972400.0
17941,11,0,2021-03-30,44928,9759,1347613,368499,2021-03-30,1617058800.0
17942,11,0,2021-03-31,39959,12218,1387572,380717,2021-03-31,1617145200.0
17943,11,0,2021-04-01,45503,19550,1433075,400267,2021-04-01,1617231600.0
17944,11,0,2021-04-02,39518,22051,1472593,422318,2021-04-02,1617318000.0
17945,11,0,2021-04-03,18408,20354,1491001,442672,2021-04-03,1617404400.0
17946,11,0,2021-04-04,6126,7036,1497127,449708,2021-04-04,1617490800.0
17947,11,0,2021-04-05,5975,1814,1503102,451522,2021-04-05,1617577200.0
17948,11,0,2021-04-06,30027,16996,1533129,468518,2021-04-06,1617663600.0
17949,11,0,2021-04-07,37632,18057,1570761,486575,2021-04-07,1617750000.0
17950,11,0,2021-04-08,46783,18465,1617544,505040,2021-04-08,1617836400.0
17951,11,0,2021-04-09,53907,18782,1671451,523822,2021-04-09,1617922800.0
17952,11,0,2021-04-10,29005,18307,1700456,542129,2021-04-10,1618009200.0
17953,11,0,2021-04-11,6558,6811,1707014,548940,2021-04-11,1618095600.0
17954,11,0,2021-04-12,30353,17761,1737367,566701,2021-04-12,1618185600.0
17955,11,0,2021-04-13,37381,25688,1774748,592389,2021-04-13,1618272000.0
17956,11,0,2021-04-14,35108,22443,1809856,614832,2021-04-14,1618358400.0
17957,11,0,2021-04-15,39253,26250,1849109,641082,2021-04-15,1618444800.0
17958,11,0,2021-04-16,41142,25760,1890251,666842,2021-04-16,1618531200.0
17959,11,0,2021-04-17,22819,13863,1913070,680705,2021-04-17,1618617600.0
17960,11,0,2021-04-18,5328,3419,1918398,684124,2021-04-18,1618704000.0
17961,11,0,2021-04-19,25154,21892,1943552,706016,2021-04-19,1618790400.0
17962,11,0,2021-04-20,30641,26213,1974193,732229,2021-04-20,1618876800.0
17963,11,0,2021-04-21,32288,26436,2006481,758665,2021-04-21,1618963200.0
17964,11,0,2021-04-22,34543,32573,2041024,791238,2021-04-22,1619049600.0
17965,11,0,2021-04-23,38007,29824,2079031,821062,2021-04-23,1619136000.0
17966,11,0,2021-04-24,37996,20650,2117027,841712,2021-04-24,1619222400.0
17967,11,0,2021-04-25,20533,6757,2137560,848469,2021-04-25,1619308800.0
17968,11,0,2021-04-26,33930,22605,2171490,871074,2021-04-26,1619395200.0
17969,11,0,2021-04-27,45801,25988,2217291,897062,2021-04-27,1619481600.0
17970,11,0,2021-04-28,48474,25381,2265765,922443,2021-04-28,1619568000.0
17971,11,0,2021-04-29,57847,26641,2323612,949084,2021-04-29,1619654400.0
17972,11,0,2021-04-30,61403,24979,2385015,974063,2021-04-30,1619740800.0
17973,11,0,2021-05-01,24136,4220,2409151,978283,2021-05-01,1619827200.0
17974,11,0,2021-05-02,14667,3926,2423818,982209,2021-05-02,1619913600.0
17975,11,0,2021-05-03,54480,31238,2478298,1013447,2021-05-03,1620000000.0
17976,11,0,2021-05-04,59775,29108,2538073,1042555,2021-05-04,1620086400.0
17977,11,0,2021-05-05,60440,28978,2598513,1071533,2021-05-05,1620172800.0
17978,11,0,2021-05-06,67399,31939,2665912,1103472,2021-05-06,1620259200.0
17979,11,0,2021-05-07,65700,33331,2731612,1136803,2021-05-07,1620345600.0
17980,11,0,2021-05-08,51237,13024,2782849,1149827,2021-05-08,1620432000.0
17981,11,0,2021-05-09,33208,7464,2816057,1157291,2021-05-09,1620518400.0
17982,11,0,2021-05-10,70843,24616,2886900,1181907,2021-05-10,1620604800.0
17983,11,0,2021-05-11,81867,30408,2968767,1212315,2021-05-11,1620691200.0
17984,11,0,2021-05-12,83742,25072,3052509,1237387,2021-05-12,1620777600.0
17985,11,0,2021-05-13,68261,4626,3120770,1242013,2021-05-13,1620864000.0
17986,11,0,2021-05-14,84669,14863,3205439,1256876,2021-05-14,1620950400.0
17987,11,0,2021-05-15,66825,9901,3272264,1266777,2021-05-15,1621036800.0
17988,11,0,2021-05-16,36739,2367,3309003,1269144,2021-05-16,1621123200.0
17989,11,0,2021-05-17,82974,9610,3391977,1278754,2021-05-17,1621206000.0
17990,11,0,2021-05-18,99827,10894,3491804,1289648,2021-05-18,1621292400.0
17991,11,0,2021-05-19,98471,19103,3590275,1308751,2021-05-19,1621378800.0
17992,11,0,2021-05-20,107417,18658,3697692,1327409,2021-05-20,1621465200.0
17993,11,0,2021-05-21,101760,16047,3799452,1343456,2021-05-21,1621551600.0
17994,11,0,2021-05-22,80152,7513,3879604,1350969,2021-05-22,1621638000.0
17995,11,0,2021-05-23,42083,2146,3921687,1353115,2021-05-23,1621724400.0
17996,11,0,2021-05-24,60165,3059,3981852,1356174,2021-05-24,1621810800.0
17997,11,0,2021-05-25,86305,23578,4068157,1379752,2021-05-25,1621897200.0
17998,11,0,2021-05-26,85198,23508,4153355,1403260,2021-05-26,1621983600.0
17999,11,0,2021-05-27,92930,30431,4246285,1433691,2021-05-27,1622070000.0
18000,11,0,2021-05-28,87346,34441,4333631,1468132,2021-05-28,1622156400.0
18001,11,0,2021-05-29,68463,19648,4402094,1487780,2021-05-29,1622242800.0
18002,11,0,2021-05-30,36115,4913,4438209,1492693,2021-05-30,1622329200.0
18003,11,0,2021-05-31,78164,31420,4516373,1524113,2021-05-31,1622415600.0
18004,11,0,2021-06-01,87355,40507,4603728,1564620,2021-06-01,1622502000.0
18005,11,0,2021-06-02,83519,35337,4687247,1599957,2021-06-02,1622588400.0
18006,11,0,2021-06-03,89120,42592,4776367,1642549,2021-06-03,1622674800.0
18007,11,0,2021-06-04,84848,47662,4861215,1690211,2021-06-04,1622761200.0
18008,11,0,2021-06-05,63697,41922,4924912,1732133,2021-06-05,1622847600.0
18009,11,0,2021-06-06,38016,13332,4962928,1745465,2021-06-06,1622934000.0
18010,11,0,2021-06-07,69085,44957,5032013,1790422,2021-06-07,1623020400.0
18011,11,0,2021-06-08,72572,52144,5104585,1842566,2021-06-08,1623106800.0
18012,11,0,2021-06-09,70719,53200,5175304,1895766,2021-06-09,1623193200.0
18013,11,0,2021-06-10,71333,70527,5246637,1966293,2021-06-10,1623279600.0
18014,11,0,2021-06-11,65660,62177,5312297,2028470,2021-06-11,1623366000.0
18015,11,0,2021-06-12,63797,38927,5376094,2067397,2021-06-12,1623452400.0
18016,11,0,2021-06-13,29580,18540,5405674,2085937,2021-06-13,1623538800.0
18017,11,0,2021-06-14,43237,68404,5448911,2154341,2021-06-14,1623625200.0
18018,11,0,2021-06-15,51149,74752,5500060,2229093,2021-06-15,1623711600.0
18019,11,0,2021-06-16,52400,69830,5552460,2298923,2021-06-16,1623798000.0
18020,11,0,2021-06-17,54088,72705,5606548,2371628,2021-06-17,1623884400.0
18021,11,0,2021-06-18,49989,87107,5656537,2458735,2021-06-18,1623970800.0
18022,11,0,2021-06-19,43465,62106,5700002,2520841,2021-06-19,1624057200.0
18023,11,0,2021-06-20,16300,33073,5716302,2553914,2021-06-20,1624143600.0
18024,11,0,2021-06-21,34357,77999,5750659,2631913,2021-06-21,1624230000.0
18025,11,0,2021-06-22,38965,93506,5789624,2725419,2021-06-22,1624316400.0
18026,11,0,2021-06-23,39448,89938,5829072,2815357,2021-06-23,1624402800.0
18027,11,0,2021-06-24,42293,87176,5871365,2902533,2021-06-24,1624489200.0
18028,11,0,2021-06-25,38875,101714,5910240,3004247,2021-06-25,1624575600.0
18029,11,0,2021-06-26,35409,78438,5945649,3082685,2021-06-26,1624662000.0
18030,11,0,2021-06-27,13358,37424,5959007,3120109,2021-06-27,1624748400.0
18031,11,0,2021-06-28,30332,89247,5989339,3209356,2021-06-28,1624834800.0
18032,11,0,2021-06-29,34141,100741,6023480,3310097,2021-06-29,1624921200.0
18033,11,0,2021-06-30,36752,97341,6060232,3407438,2021-06-30,1625007600.0
18034,11,0,2021-07-01,39191,96345,6099423,3503783,2021-07-01,1625094000.0
18035,11,0,2021-07-02,38498,100260,6137921,3604043,2021-07-02,1625180400.0
18036,11,0,2021-07-03,32165,85161,6170086,3689204,2021-07-03,1625266800.0
18037,11,0,2021-07-04,14250,39406,6184336,3728610,2021-07-04,1625353200.0
18038,11,0,2021-07-05,32658,78704,6216994,3807314,2021-07-05,1625439600.0
18039,11,0,2021-07-06,36158,91950,6253152,3899264,2021-07-06,1625526000.0
18040,11,0,2021-07-07,37715,87660,6290867,3986924,2021-07-07,1625612400.0
18041,11,0,2021-07-08,41429,88360,6332296,4075284,2021-07-08,1625698800.0
18042,24,0,2020-12-27,0,0,0,0,2020-12-27,1609023600.0
18043,24,0,2020-12-28,17,0,17,0,2020-12-28,1609110000.0
18044,24,0,2020-12-29,10,0,27,0,2020-12-29,1609196400.0
18045,24,0,2020-12-30,1,0,28,0,2020-12-30,1609282800.0
18046,24,0,2020-12-31,0,0,28,0,2020-12-31,1609369200.0
18047,24,0,2021-01-01,1,0,29,0,2021-01-01,1609455600.0
18048,24,0,2021-01-02,0,0,29,0,2021-01-02,1609542000.0
18049,24,0,2021-01-03,0,0,29,0,2021-01-03,1609628400.0
18050,24,0,2021-01-04,24,0,53,0,2021-01-04,1609714800.0
18051,24,0,2021-01-05,163,0,216,0,2021-01-05,1609801200.0
18052,24,0,2021-01-06,328,0,544,0,2021-01-06,1609887600.0
18053,24,0,2021-01-07,492,0,1036,0,2021-01-07,1609974000.0
18054,24,0,2021-01-08,952,0,1988,0,2021-01-08,1610060400.0
18055,24,0,2021-01-09,504,0,2492,0,2021-01-09,1610146800.0
18056,24,0,2021-01-10,395,0,2887,0,2021-01-10,1610233200.0
18057,24,0,2021-01-11,1279,0,4166,0,2021-01-11,1610319600.0
18058,24,0,2021-01-12,2575,0,6741,0,2021-01-12,1610406000.0
18059,24,0,2021-01-13,2191,0,8932,0,2021-01-13,1610492400.0
18060,24,0,2021-01-14,2504,0,11436,0,2021-01-14,1610578800.0
18061,24,0,2021-01-15,2115,0,13551,0,2021-01-15,1610665200.0
18062,24,0,2021-01-16,857,2,14408,2,2021-01-16,1610751600.0
18063,24,0,2021-01-17,322,3,14730,5,2021-01-17,1610838000.0
18064,24,0,2021-01-18,3215,13,17945,18,2021-01-18,1610924400.0
18065,24,0,2021-01-19,6326,10,24271,28,2021-01-19,1611010800.0
18066,24,0,2021-01-20,7165,5,31436,33,2021-01-20,1611097200.0
18067,24,0,2021-01-21,7417,1,38853,34,2021-01-21,1611183600.0
18068,24,0,2021-01-22,5120,1,43973,35,2021-01-22,1611270000.0
18069,24,0,2021-01-23,1276,1,45249,36,2021-01-23,1611356400.0
18070,24,0,2021-01-24,225,1,45474,37,2021-01-24,1611442800.0
18071,24,0,2021-01-25,3115,20,48589,57,2021-01-25,1611529200.0
18072,24,0,2021-01-26,4848,81,53437,138,2021-01-26,1611615600.0
18073,24,0,2021-01-27,5047,176,58484,314,2021-01-27,1611702000.0
18074,24,0,2021-01-28,5634,495,64118,809,2021-01-28,1611788400.0
18075,24,0,2021-01-29,3423,725,67541,1534,2021-01-29,1611874800.0
18076,24,0,2021-01-30,1208,397,68749,1931,2021-01-30,1611961200.0
18077,24,0,2021-01-31,251,368,69000,2299,2021-01-31,1612047600.0
18078,24,0,2021-02-01,2170,925,71170,3224,2021-02-01,1612134000.0
18079,24,0,2021-02-02,3032,1887,74202,5111,2021-02-02,1612220400.0
18080,24,0,2021-02-03,3111,1766,77313,6877,2021-02-03,1612306800.0
18081,24,0,2021-02-04,3234,1611,80547,8488,2021-02-04,1612393200.0
18082,24,0,2021-02-05,2394,1364,82941,9852,2021-02-05,1612479600.0
18083,24,0,2021-02-06,707,262,83648,10114,2021-02-06,1612566000.0
18084,24,0,2021-02-07,134,31,83782,10145,2021-02-07,1612652400.0
18085,24,0,2021-02-08,1968,1560,85750,11705,2021-02-08,1612738800.0
18086,24,0,2021-02-09,3413,3287,89163,14992,2021-02-09,1612825200.0
18087,24,0,2021-02-10,4085,3735,93248,18727,2021-02-10,1612911600.0
18088,24,0,2021-02-11,4656,4745,97904,23472,2021-02-11,1612998000.0
18089,24,0,2021-02-12,3483,3256,101387,26728,2021-02-12,1613084400.0
18090,24,0,2021-02-13,840,766,102227,27494,2021-02-13,1613170800.0
18091,24,0,2021-02-14,426,250,102653,27744,2021-02-14,1613257200.0
18092,24,0,2021-02-15,1964,2838,104617,30582,2021-02-15,1613343600.0
18093,24,0,2021-02-16,2849,4473,107466,35055,2021-02-16,1613430000.0
18094,24,0,2021-02-17,2691,5071,110157,40126,2021-02-17,1613516400.0
18095,24,0,2021-02-18,3521,5132,113678,45258,2021-02-18,1613602800.0
18096,24,0,2021-02-19,3258,3543,116936,48801,2021-02-19,1613689200.0
18097,24,0,2021-02-20,1288,981,118224,49782,2021-02-20,1613775600.0
18098,24,0,2021-02-21,433,238,118657,50020,2021-02-21,1613862000.0
18099,24,0,2021-02-22,1652,3054,120309,53074,2021-02-22,1613948400.0
18100,24,0,2021-02-23,2340,3133,122649,56207,2021-02-23,1614034800.0
18101,24,0,2021-02-24,2093,3457,124742,59664,2021-02-24,1614121200.0
18102,24,0,2021-02-25,3623,3139,128365,62803,2021-02-25,1614207600.0
18103,24,0,2021-02-26,4467,2596,132832,65399,2021-02-26,1614294000.0
18104,24,0,2021-02-27,1877,979,134709,66378,2021-02-27,1614380400.0
18105,24,0,2021-02-28,97,219,134806,66597,2021-02-28,1614466800.0
18106,24,0,2021-03-01,2177,2003,136983,68600,2021-03-01,1614553200.0
18107,24,0,2021-03-02,3431,2865,140414,71465,2021-03-02,1614639600.0
18108,24,0,2021-03-03,3551,3389,143965,74854,2021-03-03,1614726000.0
18109,24,0,2021-03-04,5339,3635,149304,78489,2021-03-04,1614812400.0
18110,24,0,2021-03-05,7039,3089,156343,81578,2021-03-05,1614898800.0
18111,24,0,2021-03-06,7377,691,163720,82269,2021-03-06,1614985200.0
18112,24,0,2021-03-07,2429,268,166149,82537,2021-03-07,1615071600.0
18113,24,0,2021-03-08,2689,2592,168838,85129,2021-03-08,1615158000.0
18114,24,0,2021-03-09,5777,2763,174615,87892,2021-03-09,1615244400.0
18115,24,0,2021-03-10,6413,3469,181028,91361,2021-03-10,1615330800.0
18116,24,0,2021-03-11,7806,3424,188834,94785,2021-03-11,1615417200.0
18117,24,0,2021-03-12,10789,2582,199623,97367,2021-03-12,1615503600.0
18118,24,0,2021-03-13,7122,681,206745,98048,2021-03-13,1615590000.0
18119,24,0,2021-03-14,1549,263,208294,98311,2021-03-14,1615676400.0
18120,24,0,2021-03-15,4559,1945,212853,100256,2021-03-15,1615762800.0
18121,24,0,2021-03-16,4597,2322,217450,102578,2021-03-16,1615849200.0
18122,24,0,2021-03-17,4462,1961,221912,104539,2021-03-17,1615935600.0
18123,24,0,2021-03-18,5064,2042,226976,106581,2021-03-18,1616022000.0
18124,24,0,2021-03-19,7783,1600,234759,108181,2021-03-19,1616108400.0
18125,24,0,2021-03-20,4436,842,239195,109023,2021-03-20,1616194800.0
18126,24,0,2021-03-21,557,344,239752,109367,2021-03-21,1616281200.0
18127,24,0,2021-03-22,4861,1633,244613,111000,2021-03-22,1616367600.0
18128,24,0,2021-03-23,8041,2216,252654,113216,2021-03-23,1616454000.0
18129,24,0,2021-03-24,8816,1905,261470,115121,2021-03-24,1616540400.0
18130,24,0,2021-03-25,12134,1841,273604,116962,2021-03-25,1616626800.0
18131,24,0,2021-03-26,13272,1834,286876,118796,2021-03-26,1616713200.0
18132,24,0,2021-03-27,5782,633,292658,119429,2021-03-27,1616799600.0
18133,24,0,2021-03-28,520,97,293178,119526,2021-03-28,1616886000.0
18134,24,0,2021-03-29,6763,1791,299941,121317,2021-03-29,1616972400.0
18135,24,0,2021-03-30,10175,2646,310116,123963,2021-03-30,1617058800.0
18136,24,0,2021-03-31,9895,2196,320011,126159,2021-03-31,1617145200.0
18137,24,0,2021-04-01,12047,3122,332058,129281,2021-04-01,1617231600.0
18138,24,0,2021-04-02,10642,3123,342700,132404,2021-04-02,1617318000.0
18139,24,0,2021-04-03,3415,1676,346115,134080,2021-04-03,1617404400.0
18140,24,0,2021-04-04,394,338,346509,134418,2021-04-04,1617490800.0
18141,24,0,2021-04-05,401,48,346910,134466,2021-04-05,1617577200.0
18142,24,0,2021-04-06,8328,3284,355238,137750,2021-04-06,1617663600.0
18143,24,0,2021-04-07,11071,4357,366309,142107,2021-04-07,1617750000.0
18144,24,0,2021-04-08,14190,4487,380499,146594,2021-04-08,1617836400.0
18145,24,0,2021-04-09,17769,3417,398268,150011,2021-04-09,1617922800.0
18146,24,0,2021-04-10,9393,1946,407661,151957,2021-04-10,1618009200.0
18147,24,0,2021-04-11,2910,1188,410571,153145,2021-04-11,1618095600.0
18148,24,0,2021-04-12,10849,3277,421420,156422,2021-04-12,1618185600.0
18149,24,0,2021-04-13,14994,4573,436414,160995,2021-04-13,1618272000.0
18150,24,0,2021-04-14,13478,4681,449892,165676,2021-04-14,1618358400.0
18151,24,0,2021-04-15,15363,4870,465255,170546,2021-04-15,1618444800.0
18152,24,0,2021-04-16,15696,4041,480951,174587,2021-04-16,1618531200.0
18153,24,0,2021-04-17,8196,1202,489147,175789,2021-04-17,1618617600.0
18154,24,0,2021-04-18,1102,265,490249,176054,2021-04-18,1618704000.0
18155,24,0,2021-04-19,9439,3900,499688,179954,2021-04-19,1618790400.0
18156,24,0,2021-04-20,12727,5690,512415,185644,2021-04-20,1618876800.0
18157,24,0,2021-04-21,12330,5678,524745,191322,2021-04-21,1618963200.0
18158,24,0,2021-04-22,13865,7177,538610,198499,2021-04-22,1619049600.0
18159,24,0,2021-04-23,13701,6672,552311,205171,2021-04-23,1619136000.0
18160,24,0,2021-04-24,10238,3002,562549,208173,2021-04-24,1619222400.0
18161,24,0,2021-04-25,3049,375,565598,208548,2021-04-25,1619308800.0
18162,24,0,2021-04-26,10207,5110,575805,213658,2021-04-26,1619395200.0
18163,24,0,2021-04-27,13875,7001,589680,220659,2021-04-27,1619481600.0
18164,24,0,2021-04-28,13031,7748,602711,228407,2021-04-28,1619568000.0
18165,24,0,2021-04-29,16584,7475,619295,235882,2021-04-29,1619654400.0
18166,24,0,2021-04-30,17478,5960,636773,241842,2021-04-30,1619740800.0
18167,24,0,2021-05-01,2911,504,639684,242346,2021-05-01,1619827200.0
18168,24,0,2021-05-02,2142,218,641826,242564,2021-05-02,1619913600.0
18169,24,0,2021-05-03,11295,5575,653121,248139,2021-05-03,1620000000.0
18170,24,0,2021-05-04,12820,9659,665941,257798,2021-05-04,1620086400.0
18171,24,0,2021-05-05,13893,8832,679834,266630,2021-05-05,1620172800.0
18172,24,0,2021-05-06,17497,8616,697331,275246,2021-05-06,1620259200.0
18173,24,0,2021-05-07,14565,10590,711896,285836,2021-05-07,1620345600.0
18174,24,0,2021-05-08,3707,2097,715603,287933,2021-05-08,1620432000.0
18175,24,0,2021-05-09,2349,3629,717952,291562,2021-05-09,1620518400.0
18176,24,0,2021-05-10,11538,11361,729490,302923,2021-05-10,1620604800.0
18177,24,0,2021-05-11,16370,12992,745860,315915,2021-05-11,1620691200.0
18178,24,0,2021-05-12,18241,12044,764101,327959,2021-05-12,1620777600.0
18179,24,0,2021-05-13,6932,2803,771033,330762,2021-05-13,1620864000.0
18180,24,0,2021-05-14,14511,8243,785544,339005,2021-05-14,1620950400.0
18181,24,0,2021-05-15,10465,4523,796009,343528,2021-05-15,1621036800.0
18182,24,0,2021-05-16,3167,1020,799176,344548,2021-05-16,1621123200.0
18183,24,0,2021-05-17,13320,6806,812496,351354,2021-05-17,1621206000.0
18184,24,0,2021-05-18,18489,7017,830985,358371,2021-05-18,1621292400.0
18185,24,0,2021-05-19,19049,6491,850034,364862,2021-05-19,1621378800.0
18186,24,0,2021-05-20,21343,7019,871377,371881,2021-05-20,1621465200.0
18187,24,0,2021-05-21,18436,7719,889813,379600,2021-05-21,1621551600.0
18188,24,0,2021-05-22,7629,3699,897442,383299,2021-05-22,1621638000.0
18189,24,0,2021-05-23,2991,783,900433,384082,2021-05-23,1621724400.0
18190,24,0,2021-05-24,8350,1183,908783,385265,2021-05-24,1621810800.0
18191,24,0,2021-05-25,17805,7564,926588,392829,2021-05-25,1621897200.0
18192,24,0,2021-05-26,19410,7093,945998,399922,2021-05-26,1621983600.0
18193,24,0,2021-05-27,20911,8417,966909,408339,2021-05-27,1622070000.0
18194,24,0,2021-05-28,20486,9941,987395,418280,2021-05-28,1622156400.0
18195,24,0,2021-05-29,12422,4755,999817,423035,2021-05-29,1622242800.0
18196,24,0,2021-05-30,2032,1386,1001849,424421,2021-05-30,1622329200.0
18197,24,0,2021-05-31,14582,7709,1016431,432130,2021-05-31,1622415600.0
18198,24,0,2021-06-01,19706,9984,1036137,442114,2021-06-01,1622502000.0
18199,24,0,2021-06-02,17790,9319,1053927,451433,2021-06-02,1622588400.0
18200,24,0,2021-06-03,20907,9882,1074834,461315,2021-06-03,1622674800.0
18201,24,0,2021-06-04,19942,11744,1094776,473059,2021-06-04,1622761200.0
18202,24,0,2021-06-05,9878,7871,1104654,480930,2021-06-05,1622847600.0
18203,24,0,2021-06-06,1994,2870,1106648,483800,2021-06-06,1622934000.0
18204,24,0,2021-06-07,14419,10803,1121067,494603,2021-06-07,1623020400.0
18205,24,0,2021-06-08,16083,13265,1137150,507868,2021-06-08,1623106800.0
18206,24,0,2021-06-09,16462,11220,1153612,519088,2021-06-09,1623193200.0
18207,24,0,2021-06-10,17899,10542,1171511,529630,2021-06-10,1623279600.0
18208,24,0,2021-06-11,17168,13401,1188679,543031,2021-06-11,1623366000.0
18209,24,0,2021-06-12,10076,6364,1198755,549395,2021-06-12,1623452400.0
18210,24,0,2021-06-13,893,1230,1199648,550625,2021-06-13,1623538800.0
18211,24,0,2021-06-14,10457,14339,1210105,564964,2021-06-14,1623625200.0
18212,24,0,2021-06-15,12982,15885,1223087,580849,2021-06-15,1623711600.0
18213,24,0,2021-06-16,13449,15096,1236536,595945,2021-06-16,1623798000.0
18214,24,0,2021-06-17,13135,15938,1249671,611883,2021-06-17,1623884400.0
18215,24,0,2021-06-18,14543,18281,1264214,630164,2021-06-18,1623970800.0
18216,24,0,2021-06-19,7925,5866,1272139,636030,2021-06-19,1624057200.0
18217,24,0,2021-06-20,554,812,1272693,636842,2021-06-20,1624143600.0
18218,24,0,2021-06-21,8855,15529,1281548,652371,2021-06-21,1624230000.0
18219,24,0,2021-06-22,10210,18118,1291758,670489,2021-06-22,1624316400.0
18220,24,0,2021-06-23,9699,16647,1301457,687136,2021-06-23,1624402800.0
18221,24,0,2021-06-24,9010,11704,1310467,698840,2021-06-24,1624489200.0
18222,24,0,2021-06-25,10650,18481,1321117,717321,2021-06-25,1624575600.0
18223,24,0,2021-06-26,5294,10237,1326411,727558,2021-06-26,1624662000.0
18224,24,0,2021-06-27,794,2070,1327205,729628,2021-06-27,1624748400.0
18225,24,0,2021-06-28,6477,17711,1333682,747339,2021-06-28,1624834800.0
18226,24,0,2021-06-29,7912,22970,1341594,770309,2021-06-29,1624921200.0
18227,24,0,2021-06-30,8136,21118,1349730,791427,2021-06-30,1625007600.0
18228,24,0,2021-07-01,7690,18395,1357420,809822,2021-07-01,1625094000.0
18229,24,0,2021-07-02,8228,22076,1365648,831898,2021-07-02,1625180400.0
18230,24,0,2021-07-03,4171,10521,1369819,842419,2021-07-03,1625266800.0
18231,24,0,2021-07-04,499,2698,1370318,845117,2021-07-04,1625353200.0
18232,24,0,2021-07-05,6669,17596,1376987,862713,2021-07-05,1625439600.0
18233,24,0,2021-07-06,7963,22271,1384950,884984,2021-07-06,1625526000.0
18234,24,0,2021-07-07,7797,21473,1392747,906457,2021-07-07,1625612400.0
18235,24,0,2021-07-08,9058,20772,1401805,927229,2021-07-08,1625698800.0
18236,27,0,2020-12-27,4,0,4,0,2020-12-27,1609023600.0
18237,27,0,2020-12-28,0,0,4,0,2020-12-28,1609110000.0
18238,27,0,2020-12-29,19,0,23,0,2020-12-29,1609196400.0
18239,27,0,2020-12-30,20,0,43,0,2020-12-30,1609282800.0
18240,27,0,2020-12-31,2,0,45,0,2020-12-31,1609369200.0
18241,27,0,2021-01-01,0,0,45,0,2021-01-01,1609455600.0
18242,27,0,2021-01-02,1,0,46,0,2021-01-02,1609542000.0
18243,27,0,2021-01-03,1,0,47,0,2021-01-03,1609628400.0
18244,27,0,2021-01-04,28,0,75,0,2021-01-04,1609714800.0
18245,27,0,2021-01-05,263,0,338,0,2021-01-05,1609801200.0
18246,27,0,2021-01-06,718,0,1056,0,2021-01-06,1609887600.0
18247,27,0,2021-01-07,1582,0,2638,0,2021-01-07,1609974000.0
18248,27,0,2021-01-08,1896,0,4534,0,2021-01-08,1610060400.0
18249,27,0,2021-01-09,688,0,5222,0,2021-01-09,1610146800.0
18250,27,0,2021-01-10,3,0,5225,0,2021-01-10,1610233200.0
18251,27,0,2021-01-11,2420,0,7645,0,2021-01-11,1610319600.0
18252,27,0,2021-01-12,3824,0,11469,0,2021-01-12,1610406000.0
18253,27,0,2021-01-13,3849,0,15318,0,2021-01-13,1610492400.0
18254,27,0,2021-01-14,4752,0,20070,0,2021-01-14,1610578800.0
18255,27,0,2021-01-15,3603,0,23673,0,2021-01-15,1610665200.0
18256,27,0,2021-01-16,795,5,24468,5,2021-01-16,1610751600.0
18257,27,0,2021-01-17,116,1,24584,6,2021-01-17,1610838000.0
18258,27,0,2021-01-18,6256,10,30840,16,2021-01-18,1610924400.0
18259,27,0,2021-01-19,8402,8,39242,24,2021-01-19,1611010800.0
18260,27,0,2021-01-20,7910,48,47152,72,2021-01-20,1611097200.0
18261,27,0,2021-01-21,9461,8,56613,80,2021-01-21,1611183600.0
18262,27,0,2021-01-22,7711,6,64324,86,2021-01-22,1611270000.0
18263,27,0,2021-01-23,2986,6,67310,92,2021-01-23,1611356400.0
18264,27,0,2021-01-24,347,0,67657,92,2021-01-24,1611442800.0
18265,27,0,2021-01-25,5222,24,72879,116,2021-01-25,1611529200.0
18266,27,0,2021-01-26,7390,223,80269,339,2021-01-26,1611615600.0
18267,27,0,2021-01-27,7098,339,87367,678,2021-01-27,1611702000.0
18268,27,0,2021-01-28,6337,886,93704,1564,2021-01-28,1611788400.0
18269,27,0,2021-01-29,5932,1255,99636,2819,2021-01-29,1611874800.0
18270,27,0,2021-01-30,2496,347,102132,3166,2021-01-30,1611961200.0
18271,27,0,2021-01-31,252,22,102384,3188,2021-01-31,1612047600.0
18272,27,0,2021-02-01,3359,1389,105743,4577,2021-02-01,1612134000.0
18273,27,0,2021-02-02,4040,2216,109783,6793,2021-02-02,1612220400.0
18274,27,0,2021-02-03,3618,2378,113401,9171,2021-02-03,1612306800.0
18275,27,0,2021-02-04,3702,3150,117103,12321,2021-02-04,1612393200.0
18276,27,0,2021-02-05,3239,2587,120342,14908,2021-02-05,1612479600.0
18277,27,0,2021-02-06,1608,669,121950,15577,2021-02-06,1612566000.0
18278,27,0,2021-02-07,5,87,121955,15664,2021-02-07,1612652400.0
18279,27,0,2021-02-08,2910,2678,124865,18342,2021-02-08,1612738800.0
18280,27,0,2021-02-09,3018,3611,127883,21953,2021-02-09,1612825200.0
18281,27,0,2021-02-10,3054,3374,130937,25327,2021-02-10,1612911600.0
18282,27,0,2021-02-11,3316,4628,134253,29955,2021-02-11,1612998000.0
18283,27,0,2021-02-12,2727,4434,136980,34389,2021-02-12,1613084400.0
18284,27,0,2021-02-13,986,1451,137966,35840,2021-02-13,1613170800.0
18285,27,0,2021-02-14,258,289,138224,36129,2021-02-14,1613257200.0
18286,27,0,2021-02-15,1239,5735,139463,41864,2021-02-15,1613343600.0
18287,27,0,2021-02-16,1507,7413,140970,49277,2021-02-16,1613430000.0
18288,27,0,2021-02-17,1806,6879,142776,56156,2021-02-17,1613516400.0
18289,27,0,2021-02-18,2146,6411,144922,62567,2021-02-18,1613602800.0
18290,27,0,2021-02-19,1736,5633,146658,68200,2021-02-19,1613689200.0
18291,27,0,2021-02-20,712,2176,147370,70376,2021-02-20,1613775600.0
18292,27,0,2021-02-21,2,280,147372,70656,2021-02-21,1613862000.0
18293,27,0,2021-02-22,979,4843,148351,75499,2021-02-22,1613948400.0
18294,27,0,2021-02-23,1203,5405,149554,80904,2021-02-23,1614034800.0
18295,27,0,2021-02-24,1508,4810,151062,85714,2021-02-24,1614121200.0
18296,27,0,2021-02-25,2921,5001,153983,90715,2021-02-25,1614207600.0
18297,27,0,2021-02-26,3683,4144,157666,94859,2021-02-26,1614294000.0
18298,27,0,2021-02-27,1911,1933,159577,96792,2021-02-27,1614380400.0
18299,27,0,2021-02-28,107,279,159684,97071,2021-02-28,1614466800.0
18300,27,0,2021-03-01,3673,3453,163357,100524,2021-03-01,1614553200.0
18301,27,0,2021-03-02,5421,4240,168778,104764,2021-03-02,1614639600.0
18302,27,0,2021-03-03,5977,3485,174755,108249,2021-03-03,1614726000.0
18303,27,0,2021-03-04,7717,3415,182472,111664,2021-03-04,1614812400.0
18304,27,0,2021-03-05,9702,3009,192174,114673,2021-03-05,1614898800.0
18305,27,0,2021-03-06,6231,1008,198405,115681,2021-03-06,1614985200.0
18306,27,0,2021-03-07,872,179,199277,115860,2021-03-07,1615071600.0
18307,27,0,2021-03-08,4552,3343,203829,119203,2021-03-08,1615158000.0
18308,27,0,2021-03-09,8425,3244,212254,122447,2021-03-09,1615244400.0
18309,27,0,2021-03-10,8727,2640,220981,125087,2021-03-10,1615330800.0
18310,27,0,2021-03-11,10266,3043,231247,128130,2021-03-11,1615417200.0
18311,27,0,2021-03-12,11897,2275,243144,130405,2021-03-12,1615503600.0
18312,27,0,2021-03-13,7050,601,250194,131006,2021-03-13,1615590000.0
18313,27,0,2021-03-14,214,59,250408,131065,2021-03-14,1615676400.0
18314,27,0,2021-03-15,7320,1238,257728,132303,2021-03-15,1615762800.0
18315,27,0,2021-03-16,8246,894,265974,133197,2021-03-16,1615849200.0
18316,27,0,2021-03-17,8540,936,274514,134133,2021-03-17,1615935600.0
18317,27,0,2021-03-18,8626,1189,283140,135322,2021-03-18,1616022000.0
18318,27,0,2021-03-19,9448,828,292588,136150,2021-03-19,1616108400.0
18319,27,0,2021-03-20,5670,280,298258,136430,2021-03-20,1616194800.0
18320,27,0,2021-03-21,238,4,298496,136434,2021-03-21,1616281200.0
18321,27,0,2021-03-22,9347,728,307843,137162,2021-03-22,1616367600.0
18322,27,0,2021-03-23,14727,844,322570,138006,2021-03-23,1616454000.0
18323,27,0,2021-03-24,15193,845,337763,138851,2021-03-24,1616540400.0
18324,27,0,2021-03-25,18385,1015,356148,139866,2021-03-25,1616626800.0
18325,27,0,2021-03-26,18390,794,374538,140660,2021-03-26,1616713200.0
18326,27,0,2021-03-27,7690,235,382228,140895,2021-03-27,1616799600.0
18327,27,0,2021-03-28,492,116,382720,141011,2021-03-28,1616886000.0
18328,27,0,2021-03-29,10033,3147,392753,144158,2021-03-29,1616972400.0
18329,27,0,2021-03-30,12976,3633,405729,147791,2021-03-30,1617058800.0
18330,27,0,2021-03-31,12843,3758,418572,151549,2021-03-31,1617145200.0
18331,27,0,2021-04-01,14560,3687,433132,155236,2021-04-01,1617231600.0
18332,27,0,2021-04-02,12952,3635,446084,158871,2021-04-02,1617318000.0
18333,27,0,2021-04-03,4481,1020,450565,159891,2021-04-03,1617404400.0
18334,27,0,2021-04-04,70,33,450635,159924,2021-04-04,1617490800.0
18335,27,0,2021-04-05,345,1,450980,159925,2021-04-05,1617577200.0
18336,27,0,2021-04-06,9567,5795,460547,165720,2021-04-06,1617663600.0
18337,27,0,2021-04-07,10199,6048,470746,171768,2021-04-07,1617750000.0
18338,27,0,2021-04-08,15737,5493,486483,177261,2021-04-08,1617836400.0
18339,27,0,2021-04-09,17854,5301,504337,182562,2021-04-09,1617922800.0
18340,27,0,2021-04-10,6073,1751,510410,184313,2021-04-10,1618009200.0
18341,27,0,2021-04-11,422,74,510832,184387,2021-04-11,1618095600.0
18342,27,0,2021-04-12,9070,6451,519902,190838,2021-04-12,1618185600.0
18343,27,0,2021-04-13,11747,8033,531649,198871,2021-04-13,1618272000.0
18344,27,0,2021-04-14,10306,7335,541955,206206,2021-04-14,1618358400.0
18345,27,0,2021-04-15,12965,7103,554920,213309,2021-04-15,1618444800.0
18346,27,0,2021-04-16,12765,5887,567685,219196,2021-04-16,1618531200.0
18347,27,0,2021-04-17,5923,2747,573608,221943,2021-04-17,1618617600.0
18348,27,0,2021-04-18,358,170,573966,222113,2021-04-18,1618704000.0
18349,27,0,2021-04-19,6969,8556,580935,230669,2021-04-19,1618790400.0
18350,27,0,2021-04-20,8485,10186,589420,240855,2021-04-20,1618876800.0
18351,27,0,2021-04-21,8342,9689,597762,250544,2021-04-21,1618963200.0
18352,27,0,2021-04-22,9857,10938,607619,261482,2021-04-22,1619049600.0
18353,27,0,2021-04-23,11345,9686,618964,271168,2021-04-23,1619136000.0
18354,27,0,2021-04-24,5172,3749,624136,274917,2021-04-24,1619222400.0
18355,27,0,2021-04-25,440,269,624576,275186,2021-04-25,1619308800.0
18356,27,0,2021-04-26,9539,8291,634115,283477,2021-04-26,1619395200.0
18357,27,0,2021-04-27,13461,9338,647576,292815,2021-04-27,1619481600.0
18358,27,0,2021-04-28,14195,9280,661771,302095,2021-04-28,1619568000.0
18359,27,0,2021-04-29,17877,9563,679648,311658,2021-04-29,1619654400.0
18360,27,0,2021-04-30,18736,7533,698384,319191,2021-04-30,1619740800.0
18361,27,0,2021-05-01,5429,1122,703813,320313,2021-05-01,1619827200.0
18362,27,0,2021-05-02,604,28,704417,320341,2021-05-02,1619913600.0
18363,27,0,2021-05-03,14907,5260,719324,325601,2021-05-03,1620000000.0
18364,27,0,2021-05-04,13948,9495,733272,335096,2021-05-04,1620086400.0
18365,27,0,2021-05-05,15561,8823,748833,343919,2021-05-05,1620172800.0
18366,27,0,2021-05-06,18280,10633,767113,354552,2021-05-06,1620259200.0
18367,27,0,2021-05-07,17217,9861,784330,364413,2021-05-07,1620345600.0
18368,27,0,2021-05-08,5950,1040,790280,365453,2021-05-08,1620432000.0
18369,27,0,2021-05-09,534,402,790814,365855,2021-05-09,1620518400.0
18370,27,0,2021-05-10,15284,8596,806098,374451,2021-05-10,1620604800.0
18371,27,0,2021-05-11,20755,11009,826853,385460,2021-05-11,1620691200.0
18372,27,0,2021-05-12,19672,10094,846525,395554,2021-05-12,1620777600.0
18373,27,0,2021-05-13,12298,1168,858823,396722,2021-05-13,1620864000.0
18374,27,0,2021-05-14,22926,6621,881749,403343,2021-05-14,1620950400.0
18375,27,0,2021-05-15,15419,2478,897168,405821,2021-05-15,1621036800.0
18376,27,0,2021-05-16,1892,89,899060,405910,2021-05-16,1621123200.0
18377,27,0,2021-05-17,18970,5392,918030,411302,2021-05-17,1621206000.0
18378,27,0,2021-05-18,20703,7566,938733,418868,2021-05-18,1621292400.0
18379,27,0,2021-05-19,22261,5532,960994,424400,2021-05-19,1621378800.0
18380,27,0,2021-05-20,23251,6181,984245,430581,2021-05-20,1621465200.0
18381,27,0,2021-05-21,21169,7931,1005414,438512,2021-05-21,1621551600.0
18382,27,0,2021-05-22,8286,2742,1013700,441254,2021-05-22,1621638000.0
18383,27,0,2021-05-23,914,218,1014614,441472,2021-05-23,1621724400.0
18384,27,0,2021-05-24,4245,759,1018859,442231,2021-05-24,1621810800.0
18385,27,0,2021-05-25,14977,10166,1033836,452397,2021-05-25,1621897200.0
18386,27,0,2021-05-26,15498,9060,1049334,461457,2021-05-26,1621983600.0
18387,27,0,2021-05-27,18461,9590,1067795,471047,2021-05-27,1622070000.0
18388,27,0,2021-05-28,16095,11617,1083890,482664,2021-05-28,1622156400.0
18389,27,0,2021-05-29,6817,4171,1090707,486835,2021-05-29,1622242800.0
18390,27,0,2021-05-30,393,198,1091100,487033,2021-05-30,1622329200.0
18391,27,0,2021-05-31,13311,9411,1104411,496444,2021-05-31,1622415600.0
18392,27,0,2021-06-01,16580,11121,1120991,507565,2021-06-01,1622502000.0
18393,27,0,2021-06-02,16182,9581,1137173,517146,2021-06-02,1622588400.0
18394,27,0,2021-06-03,17744,9540,1154917,526686,2021-06-03,1622674800.0
18395,27,0,2021-06-04,16186,12332,1171103,539018,2021-06-04,1622761200.0
18396,27,0,2021-06-05,8345,5679,1179448,544697,2021-06-05,1622847600.0
18397,27,0,2021-06-06,1723,467,1181171,545164,2021-06-06,1622934000.0
18398,27,0,2021-06-07,17432,11191,1198603,556355,2021-06-07,1623020400.0
18399,27,0,2021-06-08,19703,13128,1218306,569483,2021-06-08,1623106800.0
18400,27,0,2021-06-09,19064,10515,1237370,579998,2021-06-09,1623193200.0
18401,27,0,2021-06-10,19026,11606,1256396,591604,2021-06-10,1623279600.0
18402,27,0,2021-06-11,18118,14773,1274514,606377,2021-06-11,1623366000.0
18403,27,0,2021-06-12,9475,6720,1283989,613097,2021-06-12,1623452400.0
18404,27,0,2021-06-13,956,795,1284945,613892,2021-06-13,1623538800.0
18405,27,0,2021-06-14,11062,15666,1296007,629558,2021-06-14,1623625200.0
18406,27,0,2021-06-15,14135,15822,1310142,645380,2021-06-15,1623711600.0
18407,27,0,2021-06-16,14694,13844,1324836,659224,2021-06-16,1623798000.0
18408,27,0,2021-06-17,15162,15294,1339998,674518,2021-06-17,1623884400.0
18409,27,0,2021-06-18,14783,18177,1354781,692695,2021-06-18,1623970800.0
18410,27,0,2021-06-19,7669,7630,1362450,700325,2021-06-19,1624057200.0
18411,27,0,2021-06-20,173,420,1362623,700745,2021-06-20,1624143600.0
18412,27,0,2021-06-21,7755,17947,1370378,718692,2021-06-21,1624230000.0
18413,27,0,2021-06-22,9559,22825,1379937,741517,2021-06-22,1624316400.0
18414,27,0,2021-06-23,11259,17780,1391196,759297,2021-06-23,1624402800.0
18415,27,0,2021-06-24,10505,16380,1401701,775677,2021-06-24,1624489200.0
18416,27,0,2021-06-25,9356,25409,1411057,801086,2021-06-25,1624575600.0
18417,27,0,2021-06-26,5075,14977,1416132,816063,2021-06-26,1624662000.0
18418,27,0,2021-06-27,663,1803,1416795,817866,2021-06-27,1624748400.0
18419,27,0,2021-06-28,6236,20961,1423031,838827,2021-06-28,1624834800.0
18420,27,0,2021-06-29,7158,23373,1430189,862200,2021-06-29,1624921200.0
18421,27,0,2021-06-30,9011,21400,1439200,883600,2021-06-30,1625007600.0
18422,27,0,2021-07-01,9185,20878,1448385,904478,2021-07-01,1625094000.0
18423,27,0,2021-07-02,10590,19067,1458975,923545,2021-07-02,1625180400.0
18424,27,0,2021-07-03,4612,8523,1463587,932068,2021-07-03,1625266800.0
18425,27,0,2021-07-04,521,977,1464108,933045,2021-07-04,1625353200.0
18426,27,0,2021-07-05,8666,16272,1472774,949317,2021-07-05,1625439600.0
18427,27,0,2021-07-06,9060,19828,1481834,969145,2021-07-06,1625526000.0
18428,27,0,2021-07-07,8308,16404,1490142,985549,2021-07-07,1625612400.0
18429,27,0,2021-07-08,8961,16304,1499103,1001853,2021-07-08,1625698800.0
18430,28,0,2020-12-27,0,0,0,0,2020-12-27,1609023600.0
18431,28,0,2020-12-28,1,0,1,0,2020-12-28,1609110000.0
18432,28,0,2020-12-29,2,0,3,0,2020-12-29,1609196400.0
18433,28,0,2020-12-30,0,0,3,0,2020-12-30,1609282800.0
18434,28,0,2020-12-31,1,0,4,0,2020-12-31,1609369200.0
18435,28,0,2021-01-01,1,0,5,0,2021-01-01,1609455600.0
18436,28,0,2021-01-02,1,0,6,0,2021-01-02,1609542000.0
18437,28,0,2021-01-03,1,0,7,0,2021-01-03,1609628400.0
18438,28,0,2021-01-04,16,0,23,0,2021-01-04,1609714800.0
18439,28,0,2021-01-05,169,0,192,0,2021-01-05,1609801200.0
18440,28,0,2021-01-06,1393,0,1585,0,2021-01-06,1609887600.0
18441,28,0,2021-01-07,2600,0,4185,0,2021-01-07,1609974000.0
18442,28,0,2021-01-08,3428,0,7613,0,2021-01-08,1610060400.0
18443,28,0,2021-01-09,1333,0,8946,0,2021-01-09,1610146800.0
18444,28,0,2021-01-10,705,0,9651,0,2021-01-10,1610233200.0
18445,28,0,2021-01-11,3178,0,12829,0,2021-01-11,1610319600.0
18446,28,0,2021-01-12,3978,0,16807,0,2021-01-12,1610406000.0
18447,28,0,2021-01-13,4302,0,21109,0,2021-01-13,1610492400.0
18448,28,0,2021-01-14,8098,0,29207,0,2021-01-14,1610578800.0
18449,28,0,2021-01-15,6219,0,35426,0,2021-01-15,1610665200.0
18450,28,0,2021-01-16,2087,8,37513,8,2021-01-16,1610751600.0
18451,28,0,2021-01-17,4073,16,41586,24,2021-01-17,1610838000.0
18452,28,0,2021-01-18,8785,8,50371,32,2021-01-18,1610924400.0
18453,28,0,2021-01-19,7142,2,57513,34,2021-01-19,1611010800.0
18454,28,0,2021-01-20,6509,4,64022,38,2021-01-20,1611097200.0
18455,28,0,2021-01-21,5992,3,70014,41,2021-01-21,1611183600.0
18456,28,0,2021-01-22,5440,7,75454,48,2021-01-22,1611270000.0
18457,28,0,2021-01-23,2019,6,77473,54,2021-01-23,1611356400.0
18458,28,0,2021-01-24,1447,11,78920,65,2021-01-24,1611442800.0
18459,28,0,2021-01-25,6242,173,85162,238,2021-01-25,1611529200.0
18460,28,0,2021-01-26,4577,391,89739,629,2021-01-26,1611615600.0
18461,28,0,2021-01-27,4034,762,93773,1391,2021-01-27,1611702000.0
18462,28,0,2021-01-28,3755,1044,97528,2435,2021-01-28,1611788400.0
18463,28,0,2021-01-29,3489,1298,101017,3733,2021-01-29,1611874800.0
18464,28,0,2021-01-30,1386,516,102403,4249,2021-01-30,1611961200.0
18465,28,0,2021-01-31,195,124,102598,4373,2021-01-31,1612047600.0
18466,28,0,2021-02-01,2782,1659,105380,6032,2021-02-01,1612134000.0
18467,28,0,2021-02-02,2985,2388,108365,8420,2021-02-02,1612220400.0
18468,28,0,2021-02-03,2950,2665,111315,11085,2021-02-03,1612306800.0
18469,28,0,2021-02-04,3725,5199,115040,16284,2021-02-04,1612393200.0
18470,28,0,2021-02-05,3887,4380,118927,20664,2021-02-05,1612479600.0
18471,28,0,2021-02-06,1140,1546,120067,22210,2021-02-06,1612566000.0
18472,28,0,2021-02-07,715,1971,120782,24181,2021-02-07,1612652400.0
18473,28,0,2021-02-08,3802,6841,124584,31022,2021-02-08,1612738800.0
18474,28,0,2021-02-09,3462,6004,128046,37026,2021-02-09,1612825200.0
18475,28,0,2021-02-10,3455,5049,131501,42075,2021-02-10,1612911600.0
18476,28,0,2021-02-11,4211,4848,135712,46923,2021-02-11,1612998000.0
18477,28,0,2021-02-12,4043,4579,139755,51502,2021-02-12,1613084400.0
18478,28,0,2021-02-13,1124,1570,140879,53072,2021-02-13,1613170800.0
18479,28,0,2021-02-14,285,1385,141164,54457,2021-02-14,1613257200.0
18480,28,0,2021-02-15,2211,6248,143375,60705,2021-02-15,1613343600.0
18481,28,0,2021-02-16,2655,5617,146030,66322,2021-02-16,1613430000.0
18482,28,0,2021-02-17,1949,4548,147979,70870,2021-02-17,1613516400.0
18483,28,0,2021-02-18,2569,4256,150548,75126,2021-02-18,1613602800.0
18484,28,0,2021-02-19,2548,3660,153096,78786,2021-02-19,1613689200.0
18485,28,0,2021-02-20,945,1253,154041,80039,2021-02-20,1613775600.0
18486,28,0,2021-02-21,103,416,154144,80455,2021-02-21,1613862000.0
18487,28,0,2021-02-22,1666,4175,155810,84630,2021-02-22,1613948400.0
18488,28,0,2021-02-23,2171,3804,157981,88434,2021-02-23,1614034800.0
18489,28,0,2021-02-24,2374,3869,160355,92303,2021-02-24,1614121200.0
18490,28,0,2021-02-25,4772,4129,165127,96432,2021-02-25,1614207600.0
18491,28,0,2021-02-26,5961,3663,171088,100095,2021-02-26,1614294000.0
18492,28,0,2021-02-27,3008,1011,174096,101106,2021-02-27,1614380400.0
18493,28,0,2021-02-28,340,383,174436,101489,2021-02-28,1614466800.0
18494,28,0,2021-03-01,2526,4624,176962,106113,2021-03-01,1614553200.0
18495,28,0,2021-03-02,3900,4043,180862,110156,2021-03-02,1614639600.0
18496,28,0,2021-03-03,4793,3452,185655,113608,2021-03-03,1614726000.0
18497,28,0,2021-03-04,7303,2799,192958,116407,2021-03-04,1614812400.0
18498,28,0,2021-03-05,10148,2352,203106,118759,2021-03-05,1614898800.0
18499,28,0,2021-03-06,9810,714,212916,119473,2021-03-06,1614985200.0
18500,28,0,2021-03-07,3773,117,216689,119590,2021-03-07,1615071600.0
18501,28,0,2021-03-08,5867,3224,222556,122814,2021-03-08,1615158000.0
18502,28,0,2021-03-09,9283,2727,231839,125541,2021-03-09,1615244400.0
18503,28,0,2021-03-10,9804,2369,241643,127910,2021-03-10,1615330800.0
18504,28,0,2021-03-11,13964,1904,255607,129814,2021-03-11,1615417200.0
18505,28,0,2021-03-12,17993,1381,273600,131195,2021-03-12,1615503600.0
18506,28,0,2021-03-13,11154,469,284754,131664,2021-03-13,1615590000.0
18507,28,0,2021-03-14,2259,80,287013,131744,2021-03-14,1615676400.0
18508,28,0,2021-03-15,8651,800,295664,132544,2021-03-15,1615762800.0
18509,28,0,2021-03-16,7490,1143,303154,133687,2021-03-16,1615849200.0
18510,28,0,2021-03-17,7719,1124,310873,134811,2021-03-17,1615935600.0
18511,28,0,2021-03-18,8165,1301,319038,136112,2021-03-18,1616022000.0
18512,28,0,2021-03-19,11564,1321,330602,137433,2021-03-19,1616108400.0
18513,28,0,2021-03-20,9670,449,340272,137882,2021-03-20,1616194800.0
18514,28,0,2021-03-21,2410,7,342682,137889,2021-03-21,1616281200.0
18515,28,0,2021-03-22,9385,1489,352067,139378,2021-03-22,1616367600.0
18516,28,0,2021-03-23,12484,1347,364551,140725,2021-03-23,1616454000.0
18517,28,0,2021-03-24,13259,1428,377810,142153,2021-03-24,1616540400.0
18518,28,0,2021-03-25,17619,1599,395429,143752,2021-03-25,1616626800.0
18519,28,0,2021-03-26,20830,1635,416259,145387,2021-03-26,1616713200.0
18520,28,0,2021-03-27,11498,986,427757,146373,2021-03-27,1616799600.0
18521,28,0,2021-03-28,2966,50,430723,146423,2021-03-28,1616886000.0
18522,28,0,2021-03-29,11772,2789,442495,149212,2021-03-29,1616972400.0
18523,28,0,2021-03-30,14420,2817,456915,152029,2021-03-30,1617058800.0
18524,28,0,2021-03-31,14393,3155,471308,155184,2021-03-31,1617145200.0
18525,28,0,2021-04-01,18037,5082,489345,160266,2021-04-01,1617231600.0
18526,28,0,2021-04-02,16816,6001,506161,166267,2021-04-02,1617318000.0
18527,28,0,2021-04-03,7007,3845,513168,170112,2021-04-03,1617404400.0
18528,28,0,2021-04-04,1778,766,514946,170878,2021-04-04,1617490800.0
18529,28,0,2021-04-05,3290,699,518236,171577,2021-04-05,1617577200.0
18530,28,0,2021-04-06,10816,7167,529052,178744,2021-04-06,1617663600.0
18531,28,0,2021-04-07,12694,6706,541746,185450,2021-04-07,1617750000.0
18532,28,0,2021-04-08,17674,7220,559420,192670,2021-04-08,1617836400.0
18533,28,0,2021-04-09,23821,7434,583241,200104,2021-04-09,1617922800.0
18534,28,0,2021-04-10,13842,3913,597083,204017,2021-04-10,1618009200.0
18535,28,0,2021-04-11,3028,1130,600111,205147,2021-04-11,1618095600.0
18536,28,0,2021-04-12,13788,7755,613899,212902,2021-04-12,1618185600.0
18537,28,0,2021-04-13,16184,7743,630083,220645,2021-04-13,1618272000.0
18538,28,0,2021-04-14,14329,7686,644412,228331,2021-04-14,1618358400.0
18539,28,0,2021-04-15,17232,8009,661644,236340,2021-04-15,1618444800.0
18540,28,0,2021-04-16,20281,7362,681925,243702,2021-04-16,1618531200.0
18541,28,0,2021-04-17,12750,4717,694675,248419,2021-04-17,1618617600.0
18542,28,0,2021-04-18,2289,1148,696964,249567,2021-04-18,1618704000.0
18543,28,0,2021-04-19,10866,8604,707830,258171,2021-04-19,1618790400.0
18544,28,0,2021-04-20,13903,9411,721733,267582,2021-04-20,1618876800.0
18545,28,0,2021-04-21,13285,9641,735018,277223,2021-04-21,1618963200.0
18546,28,0,2021-04-22,15297,11480,750315,288703,2021-04-22,1619049600.0
18547,28,0,2021-04-23,16447,11687,766762,300390,2021-04-23,1619136000.0
18548,28,0,2021-04-24,12586,6787,779348,307177,2021-04-24,1619222400.0
18549,28,0,2021-04-25,3293,1821,782641,308998,2021-04-25,1619308800.0
18550,28,0,2021-04-26,12540,9617,795181,318615,2021-04-26,1619395200.0
18551,28,0,2021-04-27,14865,10679,810046,329294,2021-04-27,1619481600.0
18552,28,0,2021-04-28,15048,9708,825094,339002,2021-04-28,1619568000.0
18553,28,0,2021-04-29,18454,10252,843548,349254,2021-04-29,1619654400.0
18554,28,0,2021-04-30,20391,9966,863939,359220,2021-04-30,1619740800.0
18555,28,0,2021-05-01,12812,2419,876751,361639,2021-05-01,1619827200.0
18556,28,0,2021-05-02,5991,1636,882742,363275,2021-05-02,1619913600.0
18557,28,0,2021-05-03,12855,9314,895597,372589,2021-05-03,1620000000.0
18558,28,0,2021-05-04,13816,12076,909413,384665,2021-05-04,1620086400.0
18559,28,0,2021-05-05,13948,13654,923361,398319,2021-05-05,1620172800.0
18560,28,0,2021-05-06,18326,13726,941687,412045,2021-05-06,1620259200.0
18561,28,0,2021-05-07,17840,15406,959527,427451,2021-05-07,1620345600.0
18562,28,0,2021-05-08,12632,4210,972159,431661,2021-05-08,1620432000.0
18563,28,0,2021-05-09,7154,1548,979313,433209,2021-05-09,1620518400.0
18564,28,0,2021-05-10,14205,13847,993518,447056,2021-05-10,1620604800.0
18565,28,0,2021-05-11,18112,13876,1011630,460932,2021-05-11,1620691200.0
18566,28,0,2021-05-12,18795,12743,1030425,473675,2021-05-12,1620777600.0
18567,28,0,2021-05-13,19679,2953,1050104,476628,2021-05-13,1620864000.0
18568,28,0,2021-05-14,26361,10882,1076465,487510,2021-05-14,1620950400.0
18569,28,0,2021-05-15,26942,5851,1103407,493361,2021-05-15,1621036800.0
18570,28,0,2021-05-16,14143,978,1117550,494339,2021-05-16,1621123200.0
18571,28,0,2021-05-17,16218,8591,1133768,502930,2021-05-17,1621206000.0
18572,28,0,2021-05-18,21094,7504,1154862,510434,2021-05-18,1621292400.0
18573,28,0,2021-05-19,20911,7352,1175773,517786,2021-05-19,1621378800.0
18574,28,0,2021-05-20,23145,8131,1198918,525917,2021-05-20,1621465200.0
18575,28,0,2021-05-21,21448,10299,1220366,536216,2021-05-21,1621551600.0
18576,28,0,2021-05-22,17600,4909,1237966,541125,2021-05-22,1621638000.0
18577,28,0,2021-05-23,9137,561,1247103,541686,2021-05-23,1621724400.0
18578,28,0,2021-05-24,13437,2495,1260540,544181,2021-05-24,1621810800.0
18579,28,0,2021-05-25,19201,10242,1279741,554423,2021-05-25,1621897200.0
18580,28,0,2021-05-26,19480,8613,1299221,563036,2021-05-26,1621983600.0
18581,28,0,2021-05-27,21776,10192,1320997,573228,2021-05-27,1622070000.0
18582,28,0,2021-05-28,21639,13694,1342636,586922,2021-05-28,1622156400.0
18583,28,0,2021-05-29,17569,8685,1360205,595607,2021-05-29,1622242800.0
18584,28,0,2021-05-30,6277,906,1366482,596513,2021-05-30,1622329200.0
18585,28,0,2021-05-31,19868,10353,1386350,606866,2021-05-31,1622415600.0
18586,28,0,2021-06-01,23738,11551,1410088,618417,2021-06-01,1622502000.0
18587,28,0,2021-06-02,20822,10440,1430910,628857,2021-06-02,1622588400.0
18588,28,0,2021-06-03,26453,12339,1457363,641196,2021-06-03,1622674800.0
18589,28,0,2021-06-04,24586,16108,1481949,657304,2021-06-04,1622761200.0
18590,28,0,2021-06-05,18361,10458,1500310,667762,2021-06-05,1622847600.0
18591,28,0,2021-06-06,7675,1952,1507985,669714,2021-06-06,1622934000.0
18592,28,0,2021-06-07,19228,12522,1527213,682236,2021-06-07,1623020400.0
18593,28,0,2021-06-08,22642,13385,1549855,695621,2021-06-08,1623106800.0
18594,28,0,2021-06-09,19755,12907,1569610,708528,2021-06-09,1623193200.0
18595,28,0,2021-06-10,21262,12740,1590872,721268,2021-06-10,1623279600.0
18596,28,0,2021-06-11,21018,18891,1611890,740159,2021-06-11,1623366000.0
18597,28,0,2021-06-12,17911,15775,1629801,755934,2021-06-12,1623452400.0
18598,28,0,2021-06-13,6343,5463,1636144,761397,2021-06-13,1623538800.0
18599,28,0,2021-06-14,13900,16554,1650044,777951,2021-06-14,1623625200.0
18600,28,0,2021-06-15,16235,17127,1666279,795078,2021-06-15,1623711600.0
18601,28,0,2021-06-16,16691,17133,1682970,812211,2021-06-16,1623798000.0
18602,28,0,2021-06-17,17239,18660,1700209,830871,2021-06-17,1623884400.0
18603,28,0,2021-06-18,18510,22430,1718719,853301,2021-06-18,1623970800.0
18604,28,0,2021-06-19,14790,14581,1733509,867882,2021-06-19,1624057200.0
18605,28,0,2021-06-20,4981,4741,1738490,872623,2021-06-20,1624143600.0
18606,28,0,2021-06-21,11296,19667,1749786,892290,2021-06-21,1624230000.0
18607,28,0,2021-06-22,12730,22317,1762516,914607,2021-06-22,1624316400.0
18608,28,0,2021-06-23,11894,22312,1774410,936919,2021-06-23,1624402800.0
18609,28,0,2021-06-24,12636,22794,1787046,959713,2021-06-24,1624489200.0
18610,28,0,2021-06-25,12460,27669,1799506,987382,2021-06-25,1624575600.0
18611,28,0,2021-06-26,9214,22254,1808720,1009636,2021-06-26,1624662000.0
18612,28,0,2021-06-27,2906,9802,1811626,1019438,2021-06-27,1624748400.0
18613,28,0,2021-06-28,8287,21912,1819913,1041350,2021-06-28,1624834800.0
18614,28,0,2021-06-29,9801,24721,1829714,1066071,2021-06-29,1624921200.0
18615,28,0,2021-06-30,11122,22805,1840836,1088876,2021-06-30,1625007600.0
18616,28,0,2021-07-01,12156,21942,1852992,1110818,2021-07-01,1625094000.0
18617,28,0,2021-07-02,11077,27806,1864069,1138624,2021-07-02,1625180400.0
18618,28,0,2021-07-03,8093,19998,1872162,1158622,2021-07-03,1625266800.0
18619,28,0,2021-07-04,2908,8762,1875070,1167384,2021-07-04,1625353200.0
18620,28,0,2021-07-05,8433,21554,1883503,1188938,2021-07-05,1625439600.0
18621,28,0,2021-07-06,9830,25347,1893333,1214285,2021-07-06,1625526000.0
18622,28,0,2021-07-07,10390,23225,1903723,1237510,2021-07-07,1625612400.0
18623,28,0,2021-07-08,11515,23393,1915238,1260903,2021-07-08,1625698800.0
18624,32,0,2020-12-27,1,0,1,0,2020-12-27,1609023600.0
18625,32,0,2020-12-28,27,0,28,0,2020-12-28,1609110000.0
18626,32,0,2020-12-29,12,0,40,0,2020-12-29,1609196400.0
18627,32,0,2020-12-30,0,0,40,0,2020-12-30,1609282800.0
18628,32,0,2020-12-31,0,0,40,0,2020-12-31,1609369200.0
18629,32,0,2021-01-01,1,0,41,0,2021-01-01,1609455600.0
18630,32,0,2021-01-02,6,0,47,0,2021-01-02,1609542000.0
18631,32,0,2021-01-03,4,0,51,0,2021-01-03,1609628400.0
18632,32,0,2021-01-04,82,0,133,0,2021-01-04,1609714800.0
18633,32,0,2021-01-05,300,0,433,0,2021-01-05,1609801200.0
18634,32,0,2021-01-06,788,0,1221,0,2021-01-06,1609887600.0
18635,32,0,2021-01-07,2430,0,3651,0,2021-01-07,1609974000.0
18636,32,0,2021-01-08,3167,0,6818,0,2021-01-08,1610060400.0
18637,32,0,2021-01-09,957,0,7775,0,2021-01-09,1610146800.0
18638,32,0,2021-01-10,641,0,8416,0,2021-01-10,1610233200.0
18639,32,0,2021-01-11,3269,0,11685,0,2021-01-11,1610319600.0
18640,32,0,2021-01-12,5024,0,16709,0,2021-01-12,1610406000.0
18641,32,0,2021-01-13,4944,0,21653,0,2021-01-13,1610492400.0
18642,32,0,2021-01-14,5724,0,27377,0,2021-01-14,1610578800.0
18643,32,0,2021-01-15,5228,0,32605,0,2021-01-15,1610665200.0
18644,32,0,2021-01-16,1637,8,34242,8,2021-01-16,1610751600.0
18645,32,0,2021-01-17,860,2,35102,10,2021-01-17,1610838000.0
18646,32,0,2021-01-18,7234,16,42336,26,2021-01-18,1610924400.0
18647,32,0,2021-01-19,9902,26,52238,52,2021-01-19,1611010800.0
18648,32,0,2021-01-20,10370,15,62608,67,2021-01-20,1611097200.0
18649,32,0,2021-01-21,12719,29,75327,96,2021-01-21,1611183600.0
18650,32,0,2021-01-22,9884,11,85211,107,2021-01-22,1611270000.0
18651,32,0,2021-01-23,3413,1,88624,108,2021-01-23,1611356400.0
18652,32,0,2021-01-24,1119,2,89743,110,2021-01-24,1611442800.0
18653,32,0,2021-01-25,6867,68,96610,178,2021-01-25,1611529200.0
18654,32,0,2021-01-26,7447,163,104057,341,2021-01-26,1611615600.0
18655,32,0,2021-01-27,4837,506,108894,847,2021-01-27,1611702000.0
18656,32,0,2021-01-28,8598,1668,117492,2515,2021-01-28,1611788400.0
18657,32,0,2021-01-29,5385,1835,122877,4350,2021-01-29,1611874800.0
18658,32,0,2021-01-30,534,413,123411,4763,2021-01-30,1611961200.0
18659,32,0,2021-01-31,67,74,123478,4837,2021-01-31,1612047600.0
18660,32,0,2021-02-01,193,1814,123671,6651,2021-02-01,1612134000.0
18661,32,0,2021-02-02,787,3159,124458,9810,2021-02-02,1612220400.0
18662,32,0,2021-02-03,4077,3176,128535,12986,2021-02-03,1612306800.0
18663,32,0,2021-02-04,3687,3601,132222,16587,2021-02-04,1612393200.0
18664,32,0,2021-02-05,1962,3264,134184,19851,2021-02-05,1612479600.0
18665,32,0,2021-02-06,517,873,134701,20724,2021-02-06,1612566000.0
18666,32,0,2021-02-07,541,80,135242,20804,2021-02-07,1612652400.0
18667,32,0,2021-02-08,1865,3664,137107,24468,2021-02-08,1612738800.0
18668,32,0,2021-02-09,2550,4343,139657,28811,2021-02-09,1612825200.0
18669,32,0,2021-02-10,2984,5307,142641,34118,2021-02-10,1612911600.0
18670,32,0,2021-02-11,4781,6135,147422,40253,2021-02-11,1612998000.0
18671,32,0,2021-02-12,5094,4557,152516,44810,2021-02-12,1613084400.0
18672,32,0,2021-02-13,939,1891,153455,46701,2021-02-13,1613170800.0
18673,32,0,2021-02-14,116,710,153571,47411,2021-02-14,1613257200.0
18674,32,0,2021-02-15,3613,6871,157184,54282,2021-02-15,1613343600.0
18675,32,0,2021-02-16,4028,8191,161212,62473,2021-02-16,1613430000.0
18676,32,0,2021-02-17,4304,8623,165516,71096,2021-02-17,1613516400.0
18677,32,0,2021-02-18,7042,11289,172558,82385,2021-02-18,1613602800.0
18678,32,0,2021-02-19,7085,8180,179643,90565,2021-02-19,1613689200.0
18679,32,0,2021-02-20,2518,2982,182161,93547,2021-02-20,1613775600.0
18680,32,0,2021-02-21,434,484,182595,94031,2021-02-21,1613862000.0
18681,32,0,2021-02-22,3262,5292,185857,99323,2021-02-22,1613948400.0
18682,32,0,2021-02-23,5504,5854,191361,105177,2021-02-23,1614034800.0
18683,32,0,2021-02-24,7445,5975,198806,111152,2021-02-24,1614121200.0
18684,32,0,2021-02-25,12833,4836,211639,115988,2021-02-25,1614207600.0
18685,32,0,2021-02-26,12544,2673,224183,118661,2021-02-26,1614294000.0
18686,32,0,2021-02-27,6494,201,230677,118862,2021-02-27,1614380400.0
18687,32,0,2021-02-28,364,131,231041,118993,2021-02-28,1614466800.0
18688,32,0,2021-03-01,7249,787,238290,119780,2021-03-01,1614553200.0
18689,32,0,2021-03-02,10965,837,249255,120617,2021-03-02,1614639600.0
18690,32,0,2021-03-03,11998,1550,261253,122167,2021-03-03,1614726000.0
18691,32,0,2021-03-04,15113,2185,276366,124352,2021-03-04,1614812400.0
18692,32,0,2021-03-05,17135,1800,293501,126152,2021-03-05,1614898800.0
18693,32,0,2021-03-06,28104,718,321605,126870,2021-03-06,1614985200.0
18694,32,0,2021-03-07,19862,274,341467,127144,2021-03-07,1615071600.0
18695,32,0,2021-03-08,8927,2427,350394,129571,2021-03-08,1615158000.0
18696,32,0,2021-03-09,14300,3058,364694,132629,2021-03-09,1615244400.0
18697,32,0,2021-03-10,15774,2942,380468,135571,2021-03-10,1615330800.0
18698,32,0,2021-03-11,20928,4284,401396,139855,2021-03-11,1615417200.0
18699,32,0,2021-03-12,26074,3673,427470,143528,2021-03-12,1615503600.0
18700,32,0,2021-03-13,41632,1474,469102,145002,2021-03-13,1615590000.0
18701,32,0,2021-03-14,20099,328,489201,145330,2021-03-14,1615676400.0
18702,32,0,2021-03-15,13058,3259,502259,148589,2021-03-15,1615762800.0
18703,32,0,2021-03-16,9790,3318,512049,151907,2021-03-16,1615849200.0
18704,32,0,2021-03-17,9715,3920,521764,155827,2021-03-17,1615935600.0
18705,32,0,2021-03-18,10017,4773,531781,160600,2021-03-18,1616022000.0
18706,32,0,2021-03-19,17950,3436,549731,164036,2021-03-19,1616108400.0
18707,32,0,2021-03-20,36506,1267,586237,165303,2021-03-20,1616194800.0
18708,32,0,2021-03-21,19840,329,606077,165632,2021-03-21,1616281200.0
18709,32,0,2021-03-22,12154,3974,618231,169606,2021-03-22,1616367600.0
18710,32,0,2021-03-23,18933,5444,637164,175050,2021-03-23,1616454000.0
18711,32,0,2021-03-24,17931,5648,655095,180698,2021-03-24,1616540400.0
18712,32,0,2021-03-25,25306,5021,680401,185719,2021-03-25,1616626800.0
18713,32,0,2021-03-26,28989,5099,709390,190818,2021-03-26,1616713200.0
18714,32,0,2021-03-27,36685,1191,746075,192009,2021-03-27,1616799600.0
18715,32,0,2021-03-28,18645,137,764720,192146,2021-03-28,1616886000.0
18716,32,0,2021-03-29,14577,6612,779297,198758,2021-03-29,1616972400.0
18717,32,0,2021-03-30,18877,8105,798174,206863,2021-03-30,1617058800.0
18718,32,0,2021-03-31,15796,8738,813970,215601,2021-03-31,1617145200.0
18719,32,0,2021-04-01,18228,10348,832198,225949,2021-04-01,1617231600.0
18720,32,0,2021-04-02,19980,11922,852178,237871,2021-04-02,1617318000.0
18721,32,0,2021-04-03,30035,9170,882213,247041,2021-04-03,1617404400.0
18722,32,0,2021-04-04,11653,4334,893866,251375,2021-04-04,1617490800.0
18723,32,0,2021-04-05,9598,2012,903464,253387,2021-04-05,1617577200.0
18724,32,0,2021-04-06,14276,10309,917740,263696,2021-04-06,1617663600.0
18725,32,0,2021-04-07,18088,11640,935828,275336,2021-04-07,1617750000.0
18726,32,0,2021-04-08,23517,11824,959345,287160,2021-04-08,1617836400.0
18727,32,0,2021-04-09,29955,11896,989300,299056,2021-04-09,1617922800.0
18728,32,0,2021-04-10,26175,17822,1015475,316878,2021-04-10,1618009200.0
18729,32,0,2021-04-11,9151,11609,1024626,328487,2021-04-11,1618095600.0
18730,32,0,2021-04-12,15398,8887,1040024,337374,2021-04-12,1618185600.0
18731,32,0,2021-04-13,21796,10647,1061820,348021,2021-04-13,1618272000.0
18732,32,0,2021-04-14,22508,10198,1084328,358219,2021-04-14,1618358400.0
18733,32,0,2021-04-15,25760,9936,1110088,368155,2021-04-15,1618444800.0
18734,32,0,2021-04-16,25324,11331,1135412,379486,2021-04-16,1618531200.0
18735,32,0,2021-04-17,17999,22147,1153411,401633,2021-04-17,1618617600.0
18736,32,0,2021-04-18,6391,13677,1159802,415310,2021-04-18,1618704000.0
18737,32,0,2021-04-19,11658,9213,1171460,424523,2021-04-19,1618790400.0
18738,32,0,2021-04-20,16414,11566,1187874,436089,2021-04-20,1618876800.0
18739,32,0,2021-04-21,15788,11753,1203662,447842,2021-04-21,1618963200.0
18740,32,0,2021-04-22,19041,13903,1222703,461745,2021-04-22,1619049600.0
18741,32,0,2021-04-23,19649,14953,1242352,476698,2021-04-23,1619136000.0
18742,32,0,2021-04-24,15462,20051,1257814,496749,2021-04-24,1619222400.0
18743,32,0,2021-04-25,6965,11868,1264779,508617,2021-04-25,1619308800.0
18744,32,0,2021-04-26,13212,9652,1277991,518269,2021-04-26,1619395200.0
18745,32,0,2021-04-27,18692,11987,1296683,530256,2021-04-27,1619481600.0
18746,32,0,2021-04-28,20194,13688,1316877,543944,2021-04-28,1619568000.0
18747,32,0,2021-04-29,22406,17102,1339283,561046,2021-04-29,1619654400.0
18748,32,0,2021-04-30,25011,18049,1364294,579095,2021-04-30,1619740800.0
18749,32,0,2021-05-01,23036,12212,1387330,591307,2021-05-01,1619827200.0
18750,32,0,2021-05-02,20949,9090,1408279,600397,2021-05-02,1619913600.0
18751,32,0,2021-05-03,21933,9595,1430212,609992,2021-05-03,1620000000.0
18752,32,0,2021-05-04,23843,14036,1454055,624028,2021-05-04,1620086400.0
18753,32,0,2021-05-05,23948,15493,1478003,639521,2021-05-05,1620172800.0
18754,32,0,2021-05-06,25734,17241,1503737,656762,2021-05-06,1620259200.0
18755,32,0,2021-05-07,30733,17482,1534470,674244,2021-05-07,1620345600.0
18756,32,0,2021-05-08,34593,6757,1569063,681001,2021-05-08,1620432000.0
18757,32,0,2021-05-09,26800,4874,1595863,685875,2021-05-09,1620518400.0
18758,32,0,2021-05-10,24220,13679,1620083,699554,2021-05-10,1620604800.0
18759,32,0,2021-05-11,31310,15739,1651393,715293,2021-05-11,1620691200.0
18760,32,0,2021-05-12,37288,15402,1688681,730695,2021-05-12,1620777600.0
18761,32,0,2021-05-13,40528,4688,1729209,735383,2021-05-13,1620864000.0
18762,32,0,2021-05-14,41787,11007,1770996,746390,2021-05-14,1620950400.0
18763,32,0,2021-05-15,59656,7698,1830652,754088,2021-05-15,1621036800.0
18764,32,0,2021-05-16,47885,1721,1878537,755809,2021-05-16,1621123200.0
18765,32,0,2021-05-17,31468,8084,1910005,763893,2021-05-17,1621206000.0
18766,32,0,2021-05-18,36841,9085,1946846,772978,2021-05-18,1621292400.0
18767,32,0,2021-05-19,38853,8090,1985699,781068,2021-05-19,1621378800.0
18768,32,0,2021-05-20,39804,11029,2025503,792097,2021-05-20,1621465200.0
18769,32,0,2021-05-21,42402,12463,2067905,804560,2021-05-21,1621551600.0
18770,32,0,2021-05-22,57884,8326,2125789,812886,2021-05-22,1621638000.0
18771,32,0,2021-05-23,38987,1499,2164776,814385,2021-05-23,1621724400.0
18772,32,0,2021-05-24,28537,1515,2193313,815900,2021-05-24,1621810800.0
18773,32,0,2021-05-25,31206,11627,2224519,827527,2021-05-25,1621897200.0
18774,32,0,2021-05-26,34382,13452,2258901,840979,2021-05-26,1621983600.0
18775,32,0,2021-05-27,34737,16693,2293638,857672,2021-05-27,1622070000.0
18776,32,0,2021-05-28,34324,19685,2327962,877357,2021-05-28,1622156400.0
18777,32,0,2021-05-29,37478,15343,2365440,892700,2021-05-29,1622242800.0
18778,32,0,2021-05-30,16113,2113,2381553,894813,2021-05-30,1622329200.0
18779,32,0,2021-05-31,27902,13078,2409455,907891,2021-05-31,1622415600.0
18780,32,0,2021-06-01,32787,19562,2442242,927453,2021-06-01,1622502000.0
18781,32,0,2021-06-02,32280,17500,2474522,944953,2021-06-02,1622588400.0
18782,32,0,2021-06-03,34363,20462,2508885,965415,2021-06-03,1622674800.0
18783,32,0,2021-06-04,35912,22620,2544797,988035,2021-06-04,1622761200.0
18784,32,0,2021-06-05,34407,18778,2579204,1006813,2021-06-05,1622847600.0
18785,32,0,2021-06-06,16529,4184,2595733,1010997,2021-06-06,1622934000.0
18786,32,0,2021-06-07,21186,16705,2616919,1027702,2021-06-07,1623020400.0
18787,32,0,2021-06-08,26325,20613,2643244,1048315,2021-06-08,1623106800.0
18788,32,0,2021-06-09,24400,20877,2667644,1069192,2021-06-09,1623193200.0
18789,32,0,2021-06-10,24993,22574,2692637,1091766,2021-06-10,1623279600.0
18790,32,0,2021-06-11,26344,31771,2718981,1123537,2021-06-11,1623366000.0
18791,32,0,2021-06-12,25983,28033,2744964,1151570,2021-06-12,1623452400.0
18792,32,0,2021-06-13,11805,13425,2756769,1164995,2021-06-13,1623538800.0
18793,32,0,2021-06-14,13231,26069,2770000,1191064,2021-06-14,1623625200.0
18794,32,0,2021-06-15,19605,31730,2789605,1222794,2021-06-15,1623711600.0
18795,32,0,2021-06-16,20513,29548,2810118,1252342,2021-06-16,1623798000.0
18796,32,0,2021-06-17,21403,31764,2831521,1284106,2021-06-17,1623884400.0
18797,32,0,2021-06-18,21569,39141,2853090,1323247,2021-06-18,1623970800.0
18798,32,0,2021-06-19,22592,40709,2875682,1363956,2021-06-19,1624057200.0
18799,32,0,2021-06-20,9219,17872,2884901,1381828,2021-06-20,1624143600.0
18800,32,0,2021-06-21,11375,33013,2896276,1414841,2021-06-21,1624230000.0
18801,32,0,2021-06-22,13683,39267,2909959,1454108,2021-06-22,1624316400.0
18802,32,0,2021-06-23,14332,40988,2924291,1495096,2021-06-23,1624402800.0
18803,32,0,2021-06-24,15327,42743,2939618,1537839,2021-06-24,1624489200.0
18804,32,0,2021-06-25,14746,50298,2954364,1588137,2021-06-25,1624575600.0
18805,32,0,2021-06-26,15007,56698,2969371,1644835,2021-06-26,1624662000.0
18806,32,0,2021-06-27,7459,32376,2976830,1677211,2021-06-27,1624748400.0
18807,32,0,2021-06-28,10361,37000,2987191,1714211,2021-06-28,1624834800.0
18808,32,0,2021-06-29,13188,42227,3000379,1756438,2021-06-29,1624921200.0
18809,32,0,2021-06-30,14932,41081,3015311,1797519,2021-06-30,1625007600.0
18810,32,0,2021-07-01,15575,41305,3030886,1838824,2021-07-01,1625094000.0
18811,32,0,2021-07-02,16310,48302,3047196,1887126,2021-07-02,1625180400.0
18812,32,0,2021-07-03,13144,57031,3060340,1944157,2021-07-03,1625266800.0
18813,32,0,2021-07-04,7802,30202,3068142,1974359,2021-07-04,1625353200.0
18814,32,0,2021-07-05,11145,33200,3079287,2007559,2021-07-05,1625439600.0
18815,32,0,2021-07-06,14924,36962,3094211,2044521,2021-07-06,1625526000.0
18816,32,0,2021-07-07,15614,36327,3109825,2080848,2021-07-07,1625612400.0
18817,32,0,2021-07-08,19110,36133,3128935,2116981,2021-07-08,1625698800.0
18818,44,0,2020-12-27,0,0,0,0,2020-12-27,1609023600.0
18819,44,0,2020-12-28,0,0,0,0,2020-12-28,1609110000.0
18820,44,0,2020-12-29,0,0,0,0,2020-12-29,1609196400.0
18821,44,0,2020-12-30,1,0,1,0,2020-12-30,1609282800.0
18822,44,0,2020-12-31,11,0,12,0,2020-12-31,1609369200.0
18823,44,0,2021-01-01,2,0,14,0,2021-01-01,1609455600.0
18824,44,0,2021-01-02,3,0,17,0,2021-01-02,1609542000.0
18825,44,0,2021-01-03,3,0,20,0,2021-01-03,1609628400.0
18826,44,0,2021-01-04,243,0,263,0,2021-01-04,1609714800.0
18827,44,0,2021-01-05,773,0,1036,0,2021-01-05,1609801200.0
18828,44,0,2021-01-06,1247,0,2283,0,2021-01-06,1609887600.0
18829,44,0,2021-01-07,2431,0,4714,0,2021-01-07,1609974000.0
18830,44,0,2021-01-08,3144,0,7858,0,2021-01-08,1610060400.0
18831,44,0,2021-01-09,945,0,8803,0,2021-01-09,1610146800.0
18832,44,0,2021-01-10,242,0,9045,0,2021-01-10,1610233200.0
18833,44,0,2021-01-11,2992,0,12037,0,2021-01-11,1610319600.0
18834,44,0,2021-01-12,5279,0,17316,0,2021-01-12,1610406000.0
18835,44,0,2021-01-13,7668,0,24984,0,2021-01-13,1610492400.0
18836,44,0,2021-01-14,9556,0,34540,0,2021-01-14,1610578800.0
18837,44,0,2021-01-15,6714,0,41254,0,2021-01-15,1610665200.0
18838,44,0,2021-01-16,1918,7,43172,7,2021-01-16,1610751600.0
18839,44,0,2021-01-17,902,1,44074,8,2021-01-17,1610838000.0
18840,44,0,2021-01-18,8727,4,52801,12,2021-01-18,1610924400.0
18841,44,0,2021-01-19,10670,2,63471,14,2021-01-19,1611010800.0
18842,44,0,2021-01-20,11027,8,74498,22,2021-01-20,1611097200.0
18843,44,0,2021-01-21,11736,2,86234,24,2021-01-21,1611183600.0
18844,44,0,2021-01-22,9638,6,95872,30,2021-01-22,1611270000.0
18845,44,0,2021-01-23,3287,15,99159,45,2021-01-23,1611356400.0
18846,44,0,2021-01-24,1569,1,100728,46,2021-01-24,1611442800.0
18847,44,0,2021-01-25,6684,286,107412,332,2021-01-25,1611529200.0
18848,44,0,2021-01-26,5644,415,113056,747,2021-01-26,1611615600.0
18849,44,0,2021-01-27,7381,575,120437,1322,2021-01-27,1611702000.0
18850,44,0,2021-01-28,8837,1221,129274,2543,2021-01-28,1611788400.0
18851,44,0,2021-01-29,6761,1780,136035,4323,2021-01-29,1611874800.0
18852,44,0,2021-01-30,2549,488,138584,4811,2021-01-30,1611961200.0
18853,44,0,2021-01-31,1252,53,139836,4864,2021-01-31,1612047600.0
18854,44,0,2021-02-01,6385,2362,146221,7226,2021-02-01,1612134000.0
18855,44,0,2021-02-02,6216,3789,152437,11015,2021-02-02,1612220400.0
18856,44,0,2021-02-03,5603,4527,158040,15542,2021-02-03,1612306800.0
18857,44,0,2021-02-04,6443,6929,164483,22471,2021-02-04,1612393200.0
18858,44,0,2021-02-05,6390,5208,170873,27679,2021-02-05,1612479600.0
18859,44,0,2021-02-06,1971,1204,172844,28883,2021-02-06,1612566000.0
18860,44,0,2021-02-07,406,591,173250,29474,2021-02-07,1612652400.0
18861,44,0,2021-02-08,3833,4435,177083,33909,2021-02-08,1612738800.0
18862,44,0,2021-02-09,5721,5769,182804,39678,2021-02-09,1612825200.0
18863,44,0,2021-02-10,6252,5955,189056,45633,2021-02-10,1612911600.0
18864,44,0,2021-02-11,7068,6451,196124,52084,2021-02-11,1612998000.0
18865,44,0,2021-02-12,7278,5455,203402,57539,2021-02-12,1613084400.0
18866,44,0,2021-02-13,2544,1239,205946,58778,2021-02-13,1613170800.0
18867,44,0,2021-02-14,1612,815,207558,59593,2021-02-14,1613257200.0
18868,44,0,2021-02-15,4005,7144,211563,66737,2021-02-15,1613343600.0
18869,44,0,2021-02-16,4564,7905,216127,74642,2021-02-16,1613430000.0
18870,44,0,2021-02-17,4712,8454,220839,83096,2021-02-17,1613516400.0
18871,44,0,2021-02-18,6071,9161,226910,92257,2021-02-18,1613602800.0
18872,44,0,2021-02-19,5549,7406,232459,99663,2021-02-19,1613689200.0
18873,44,0,2021-02-20,2339,2815,234798,102478,2021-02-20,1613775600.0
18874,44,0,2021-02-21,542,1387,235340,103865,2021-02-21,1613862000.0
18875,44,0,2021-02-22,4487,6967,239827,110832,2021-02-22,1613948400.0
18876,44,0,2021-02-23,6031,7155,245858,117987,2021-02-23,1614034800.0
18877,44,0,2021-02-24,6603,5799,252461,123786,2021-02-24,1614121200.0
18878,44,0,2021-02-25,10545,7328,263006,131114,2021-02-25,1614207600.0
18879,44,0,2021-02-26,12381,6093,275387,137207,2021-02-26,1614294000.0
18880,44,0,2021-02-27,7892,2061,283279,139268,2021-02-27,1614380400.0
18881,44,0,2021-02-28,2118,498,285397,139766,2021-02-28,1614466800.0
18882,44,0,2021-03-01,6081,4579,291478,144345,2021-03-01,1614553200.0
18883,44,0,2021-03-02,9395,5539,300873,149884,2021-03-02,1614639600.0
18884,44,0,2021-03-03,11276,5384,312149,155268,2021-03-03,1614726000.0
18885,44,0,2021-03-04,13273,5530,325422,160798,2021-03-04,1614812400.0
18886,44,0,2021-03-05,17901,5335,343323,166133,2021-03-05,1614898800.0
18887,44,0,2021-03-06,21372,1795,364695,167928,2021-03-06,1614985200.0
18888,44,0,2021-03-07,12206,552,376901,168480,2021-03-07,1615071600.0
18889,44,0,2021-03-08,9424,4071,386325,172551,2021-03-08,1615158000.0
18890,44,0,2021-03-09,15202,4668,401527,177219,2021-03-09,1615244400.0
18891,44,0,2021-03-10,16603,4917,418130,182136,2021-03-10,1615330800.0
18892,44,0,2021-03-11,20357,5271,438487,187407,2021-03-11,1615417200.0
18893,44,0,2021-03-12,26820,5012,465307,192419,2021-03-12,1615503600.0
18894,44,0,2021-03-13,24221,2018,489528,194437,2021-03-13,1615590000.0
18895,44,0,2021-03-14,6765,741,496293,195178,2021-03-14,1615676400.0
18896,44,0,2021-03-15,12959,3208,509252,198386,2021-03-15,1615762800.0
18897,44,0,2021-03-16,12839,3713,522091,202099,2021-03-16,1615849200.0
18898,44,0,2021-03-17,14195,3325,536286,205424,2021-03-17,1615935600.0
18899,44,0,2021-03-18,15411,3418,551697,208842,2021-03-18,1616022000.0
18900,44,0,2021-03-19,21416,3373,573113,212215,2021-03-19,1616108400.0
18901,44,0,2021-03-20,15568,1674,588681,213889,2021-03-20,1616194800.0
18902,44,0,2021-03-21,4620,218,593301,214107,2021-03-21,1616281200.0
18903,44,0,2021-03-22,12524,3595,605825,217702,2021-03-22,1616367600.0
18904,44,0,2021-03-23,19448,4617,625273,222319,2021-03-23,1616454000.0
18905,44,0,2021-03-24,22047,4610,647320,226929,2021-03-24,1616540400.0
18906,44,0,2021-03-25,28211,5050,675531,231979,2021-03-25,1616626800.0
18907,44,0,2021-03-26,30555,4654,706086,236633,2021-03-26,1616713200.0
18908,44,0,2021-03-27,16232,4256,722318,240889,2021-03-27,1616799600.0
18909,44,0,2021-03-28,4079,1892,726397,242781,2021-03-28,1616886000.0
18910,44,0,2021-03-29,14309,5642,740706,248423,2021-03-29,1616972400.0
18911,44,0,2021-03-30,21414,7115,762120,255538,2021-03-30,1617058800.0
18912,44,0,2021-03-31,20128,7293,782248,262831,2021-03-31,1617145200.0
18913,44,0,2021-04-01,23571,8392,805819,271223,2021-04-01,1617231600.0
18914,44,0,2021-04-02,16235,6282,822054,277505,2021-04-02,1617318000.0
18915,44,0,2021-04-03,10190,5514,832244,283019,2021-04-03,1617404400.0
18916,44,0,2021-04-04,3133,1588,835377,284607,2021-04-04,1617490800.0
18917,44,0,2021-04-05,4425,1304,839802,285911,2021-04-05,1617577200.0
18918,44,0,2021-04-06,13424,10034,853226,295945,2021-04-06,1617663600.0
18919,44,0,2021-04-07,17673,11331,870899,307276,2021-04-07,1617750000.0
18920,44,0,2021-04-08,26070,11056,896969,318332,2021-04-08,1617836400.0
18921,44,0,2021-04-09,32278,11431,929247,329763,2021-04-09,1617922800.0
18922,44,0,2021-04-10,18279,9398,947526,339161,2021-04-10,1618009200.0
18923,44,0,2021-04-11,3030,5810,950556,344971,2021-04-11,1618095600.0
18924,44,0,2021-04-12,16955,10573,967511,355544,2021-04-12,1618185600.0
18925,44,0,2021-04-13,21989,12873,989500,368417,2021-04-13,1618272000.0
18926,44,0,2021-04-14,23139,12912,1012639,381329,2021-04-14,1618358400.0
18927,44,0,2021-04-15,26304,14071,1038943,395400,2021-04-15,1618444800.0
18928,44,0,2021-04-16,28124,14001,1067067,409401,2021-04-16,1618531200.0
18929,44,0,2021-04-17,19835,8343,1086902,417744,2021-04-17,1618617600.0
18930,44,0,2021-04-18,5055,4430,1091957,422174,2021-04-18,1618704000.0
18931,44,0,2021-04-19,16928,10933,1108885,433107,2021-04-19,1618790400.0
18932,44,0,2021-04-20,19107,13352,1127992,446459,2021-04-20,1618876800.0
18933,44,0,2021-04-21,21158,13930,1149150,460389,2021-04-21,1618963200.0
18934,44,0,2021-04-22,23708,14702,1172858,475091,2021-04-22,1619049600.0
18935,44,0,2021-04-23,27816,15056,1200674,490147,2021-04-23,1619136000.0
18936,44,0,2021-04-24,16981,8431,1217655,498578,2021-04-24,1619222400.0
18937,44,0,2021-04-25,4827,3337,1222482,501915,2021-04-25,1619308800.0
18938,44,0,2021-04-26,16711,11184,1239193,513099,2021-04-26,1619395200.0
18939,44,0,2021-04-27,21163,13079,1260356,526178,2021-04-27,1619481600.0
18940,44,0,2021-04-28,23818,12805,1284174,538983,2021-04-28,1619568000.0
18941,44,0,2021-04-29,28175,14057,1312349,553040,2021-04-29,1619654400.0
18942,44,0,2021-04-30,33119,12328,1345468,565368,2021-04-30,1619740800.0
18943,44,0,2021-05-01,14852,5941,1360320,571309,2021-05-01,1619827200.0
18944,44,0,2021-05-02,7903,3477,1368223,574786,2021-05-02,1619913600.0
18945,44,0,2021-05-03,24011,10553,1392234,585339,2021-05-03,1620000000.0
18946,44,0,2021-05-04,26970,15064,1419204,600403,2021-05-04,1620086400.0
18947,44,0,2021-05-05,30818,16883,1450022,617286,2021-05-05,1620172800.0
18948,44,0,2021-05-06,37992,17708,1488014,634994,2021-05-06,1620259200.0
18949,44,0,2021-05-07,36141,20788,1524155,655782,2021-05-07,1620345600.0
18950,44,0,2021-05-08,19569,5424,1543724,661206,2021-05-08,1620432000.0
18951,44,0,2021-05-09,11305,2222,1555029,663428,2021-05-09,1620518400.0
18952,44,0,2021-05-10,24500,18764,1579529,682192,2021-05-10,1620604800.0
18953,44,0,2021-05-11,34425,19986,1613954,702178,2021-05-11,1620691200.0
18954,44,0,2021-05-12,37113,20812,1651067,722990,2021-05-12,1620777600.0
18955,44,0,2021-05-13,27889,4563,1678956,727553,2021-05-13,1620864000.0
18956,44,0,2021-05-14,44206,15521,1723162,743074,2021-05-14,1620950400.0
18957,44,0,2021-05-15,34028,11638,1757190,754712,2021-05-15,1621036800.0
18958,44,0,2021-05-16,15604,2521,1772794,757233,2021-05-16,1621123200.0
18959,44,0,2021-05-17,27205,12540,1799999,769773,2021-05-17,1621206000.0
18960,44,0,2021-05-18,35285,12468,1835284,782241,2021-05-18,1621292400.0
18961,44,0,2021-05-19,36929,13387,1872213,795628,2021-05-19,1621378800.0
18962,44,0,2021-05-20,40945,12948,1913158,808576,2021-05-20,1621465200.0
18963,44,0,2021-05-21,42917,16925,1956075,825501,2021-05-21,1621551600.0
18964,44,0,2021-05-22,27771,9336,1983846,834837,2021-05-22,1621638000.0
18965,44,0,2021-05-23,8694,1083,1992540,835920,2021-05-23,1621724400.0
18966,44,0,2021-05-24,17964,3393,2010504,839313,2021-05-24,1621810800.0
18967,44,0,2021-05-25,30477,14940,2040981,854253,2021-05-25,1621897200.0
18968,44,0,2021-05-26,32768,16563,2073749,870816,2021-05-26,1621983600.0
18969,44,0,2021-05-27,34645,16956,2108394,887772,2021-05-27,1622070000.0
18970,44,0,2021-05-28,37571,22595,2145965,910367,2021-05-28,1622156400.0
18971,44,0,2021-05-29,26804,16821,2172769,927188,2021-05-29,1622242800.0
18972,44,0,2021-05-30,6132,3615,2178901,930803,2021-05-30,1622329200.0
18973,44,0,2021-05-31,27040,16619,2205941,947422,2021-05-31,1622415600.0
18974,44,0,2021-06-01,31562,19061,2237503,966483,2021-06-01,1622502000.0
18975,44,0,2021-06-02,33621,19135,2271124,985618,2021-06-02,1622588400.0
18976,44,0,2021-06-03,34601,21070,2305725,1006688,2021-06-03,1622674800.0
18977,44,0,2021-06-04,40002,27332,2345727,1034020,2021-06-04,1622761200.0
18978,44,0,2021-06-05,23068,17255,2368795,1051275,2021-06-05,1622847600.0
18979,44,0,2021-06-06,8330,3642,2377125,1054917,2021-06-06,1622934000.0
18980,44,0,2021-06-07,28136,19171,2405261,1074088,2021-06-07,1623020400.0
18981,44,0,2021-06-08,33090,22807,2438351,1096895,2021-06-08,1623106800.0
18982,44,0,2021-06-09,35650,20943,2474001,1117838,2021-06-09,1623193200.0
18983,44,0,2021-06-10,34616,21516,2508617,1139354,2021-06-10,1623279600.0
18984,44,0,2021-06-11,32348,31206,2540965,1170560,2021-06-11,1623366000.0
18985,44,0,2021-06-12,25705,20388,2566670,1190948,2021-06-12,1623452400.0
18986,44,0,2021-06-13,6773,5304,2573443,1196252,2021-06-13,1623538800.0
18987,44,0,2021-06-14,17616,27353,2591059,1223605,2021-06-14,1623625200.0
18988,44,0,2021-06-15,23606,32072,2614665,1255677,2021-06-15,1623711600.0
18989,44,0,2021-06-16,24309,33640,2638974,1289317,2021-06-16,1623798000.0
18990,44,0,2021-06-17,23772,36124,2662746,1325441,2021-06-17,1623884400.0
18991,44,0,2021-06-18,26439,39449,2689185,1364890,2021-06-18,1623970800.0
18992,44,0,2021-06-19,21021,25732,2710206,1390622,2021-06-19,1624057200.0
18993,44,0,2021-06-20,3672,6070,2713878,1396692,2021-06-20,1624143600.0
18994,44,0,2021-06-21,14783,32184,2728661,1428876,2021-06-21,1624230000.0
18995,44,0,2021-06-22,15433,39303,2744094,1468179,2021-06-22,1624316400.0
18996,44,0,2021-06-23,20073,38547,2764167,1506726,2021-06-23,1624402800.0
18997,44,0,2021-06-24,16536,31784,2780703,1538510,2021-06-24,1624489200.0
18998,44,0,2021-06-25,18895,46473,2799598,1584983,2021-06-25,1624575600.0
18999,44,0,2021-06-26,14146,35276,2813744,1620259,2021-06-26,1624662000.0
19000,44,0,2021-06-27,3418,11098,2817162,1631357,2021-06-27,1624748400.0
19001,44,0,2021-06-28,11379,35633,2828541,1666990,2021-06-28,1624834800.0
19002,44,0,2021-06-29,11889,39954,2840430,1706944,2021-06-29,1624921200.0
19003,44,0,2021-06-30,14674,41123,2855104,1748067,2021-06-30,1625007600.0
19004,44,0,2021-07-01,15380,36671,2870484,1784738,2021-07-01,1625094000.0
19005,44,0,2021-07-02,16330,48395,2886814,1833133,2021-07-02,1625180400.0
19006,44,0,2021-07-03,13157,28979,2899971,1862112,2021-07-03,1625266800.0
19007,44,0,2021-07-04,3088,8218,2903059,1870330,2021-07-04,1625353200.0
19008,44,0,2021-07-05,10257,34688,2913316,1905018,2021-07-05,1625439600.0
19009,44,0,2021-07-06,13263,36870,2926579,1941888,2021-07-06,1625526000.0
19010,44,0,2021-07-07,15004,36833,2941583,1978721,2021-07-07,1625612400.0
19011,44,0,2021-07-08,15902,31181,2957485,2009902,2021-07-08,1625698800.0
19012,52,0,2020-12-27,0,0,0,0,2020-12-27,1609023600.0
19013,52,0,2020-12-28,2,0,2,0,2020-12-28,1609110000.0
19014,52,0,2020-12-29,0,0,2,0,2020-12-29,1609196400.0
19015,52,0,2020-12-30,0,0,2,0,2020-12-30,1609282800.0
19016,52,0,2020-12-31,0,0,2,0,2020-12-31,1609369200.0
19017,52,0,2021-01-01,5,0,7,0,2021-01-01,1609455600.0
19018,52,0,2021-01-02,1,0,8,0,2021-01-02,1609542000.0
19019,52,0,2021-01-03,1,0,9,0,2021-01-03,1609628400.0
19020,52,0,2021-01-04,34,0,43,0,2021-01-04,1609714800.0
19021,52,0,2021-01-05,168,0,211,0,2021-01-05,1609801200.0
19022,52,0,2021-01-06,384,0,595,0,2021-01-06,1609887600.0
19023,52,0,2021-01-07,964,0,1559,0,2021-01-07,1609974000.0
19024,52,0,2021-01-08,1664,0,3223,0,2021-01-08,1610060400.0
19025,52,0,2021-01-09,1049,0,4272,0,2021-01-09,1610146800.0
19026,52,0,2021-01-10,643,0,4915,0,2021-01-10,1610233200.0
19027,52,0,2021-01-11,2197,0,7112,0,2021-01-11,1610319600.0
19028,52,0,2021-01-12,3170,0,10282,0,2021-01-12,1610406000.0
19029,52,0,2021-01-13,2983,0,13265,0,2021-01-13,1610492400.0
19030,52,0,2021-01-14,3304,0,16569,0,2021-01-14,1610578800.0
19031,52,0,2021-01-15,3016,0,19585,0,2021-01-15,1610665200.0
19032,52,0,2021-01-16,896,3,20481,3,2021-01-16,1610751600.0
19033,52,0,2021-01-17,499,3,20980,6,2021-01-17,1610838000.0
19034,52,0,2021-01-18,3199,5,24179,11,2021-01-18,1610924400.0
19035,52,0,2021-01-19,6556,4,30735,15,2021-01-19,1611010800.0
19036,52,0,2021-01-20,8343,6,39078,21,2021-01-20,1611097200.0
19037,52,0,2021-01-21,12174,3,51252,24,2021-01-21,1611183600.0
19038,52,0,2021-01-22,7273,21,58525,45,2021-01-22,1611270000.0
19039,52,0,2021-01-23,1678,3,60203,48,2021-01-23,1611356400.0
19040,52,0,2021-01-24,174,0,60377,48,2021-01-24,1611442800.0
19041,52,0,2021-01-25,3006,9,63383,57,2021-01-25,1611529200.0
19042,52,0,2021-01-26,6738,148,70121,205,2021-01-26,1611615600.0
19043,52,0,2021-01-27,7285,143,77406,348,2021-01-27,1611702000.0
19044,52,0,2021-01-28,9728,456,87134,804,2021-01-28,1611788400.0
19045,52,0,2021-01-29,5956,903,93090,1707,2021-01-29,1611874800.0
19046,52,0,2021-01-30,1259,271,94349,1978,2021-01-30,1611961200.0
19047,52,0,2021-01-31,79,314,94428,2292,2021-01-31,1612047600.0
19048,52,0,2021-02-01,2523,1189,96951,3481,2021-02-01,1612134000.0
19049,52,0,2021-02-02,2970,1857,99921,5338,2021-02-02,1612220400.0
19050,52,0,2021-02-03,2687,2159,102608,7497,2021-02-03,1612306800.0
19051,52,0,2021-02-04,2963,2110,105571,9607,2021-02-04,1612393200.0
19052,52,0,2021-02-05,2964,2203,108535,11810,2021-02-05,1612479600.0
19053,52,0,2021-02-06,1076,661,109611,12471,2021-02-06,1612566000.0
19054,52,0,2021-02-07,151,294,109762,12765,2021-02-07,1612652400.0
19055,52,0,2021-02-08,1929,2108,111691,14873,2021-02-08,1612738800.0
19056,52,0,2021-02-09,3174,3698,114865,18571,2021-02-09,1612825200.0
19057,52,0,2021-02-10,3324,4746,118189,23317,2021-02-10,1612911600.0
19058,52,0,2021-02-11,6100,9258,124289,32575,2021-02-11,1612998000.0
19059,52,0,2021-02-12,4705,5121,128994,37696,2021-02-12,1613084400.0
19060,52,0,2021-02-13,1149,1238,130143,38934,2021-02-13,1613170800.0
19061,52,0,2021-02-14,22,541,130165,39475,2021-02-14,1613257200.0
19062,52,0,2021-02-15,2028,3514,132193,42989,2021-02-15,1613343600.0
19063,52,0,2021-02-16,4127,6703,136320,49692,2021-02-16,1613430000.0
19064,52,0,2021-02-17,3876,6918,140196,56610,2021-02-17,1613516400.0
19065,52,0,2021-02-18,6140,9229,146336,65839,2021-02-18,1613602800.0
19066,52,0,2021-02-19,5333,5767,151669,71606,2021-02-19,1613689200.0
19067,52,0,2021-02-20,1028,1468,152697,73074,2021-02-20,1613775600.0
19068,52,0,2021-02-21,7,274,152704,73348,2021-02-21,1613862000.0
19069,52,0,2021-02-22,2647,3464,155351,76812,2021-02-22,1613948400.0
19070,52,0,2021-02-23,3425,3679,158776,80491,2021-02-23,1614034800.0
19071,52,0,2021-02-24,3307,3018,162083,83509,2021-02-24,1614121200.0
19072,52,0,2021-02-25,6345,3162,168428,86671,2021-02-25,1614207600.0
19073,52,0,2021-02-26,6214,2874,174642,89545,2021-02-26,1614294000.0
19074,52,0,2021-02-27,2216,1037,176858,90582,2021-02-27,1614380400.0
19075,52,0,2021-02-28,76,87,176934,90669,2021-02-28,1614466800.0
19076,52,0,2021-03-01,3114,2307,180048,92976,2021-03-01,1614553200.0
19077,52,0,2021-03-02,4723,3404,184771,96380,2021-03-02,1614639600.0
19078,52,0,2021-03-03,5284,3369,190055,99749,2021-03-03,1614726000.0
19079,52,0,2021-03-04,7795,4690,197850,104439,2021-03-04,1614812400.0
19080,52,0,2021-03-05,9008,3821,206858,108260,2021-03-05,1614898800.0
19081,52,0,2021-03-06,5637,1095,212495,109355,2021-03-06,1614985200.0
19082,52,0,2021-03-07,2661,105,215156,109460,2021-03-07,1615071600.0
19083,52,0,2021-03-08,5846,2366,221002,111826,2021-03-08,1615158000.0
19084,52,0,2021-03-09,9546,3227,230548,115053,2021-03-09,1615244400.0
19085,52,0,2021-03-10,9388,3313,239936,118366,2021-03-10,1615330800.0
19086,52,0,2021-03-11,13575,4905,253511,123271,2021-03-11,1615417200.0
19087,52,0,2021-03-12,15332,3612,268843,126883,2021-03-12,1615503600.0
19088,52,0,2021-03-13,8288,699,277131,127582,2021-03-13,1615590000.0
19089,52,0,2021-03-14,624,72,277755,127654,2021-03-14,1615676400.0
19090,52,0,2021-03-15,8832,1827,286587,129481,2021-03-15,1615762800.0
19091,52,0,2021-03-16,7576,2544,294163,132025,2021-03-16,1615849200.0
19092,52,0,2021-03-17,6457,2337,300620,134362,2021-03-17,1615935600.0
19093,52,0,2021-03-18,8304,2403,308924,136765,2021-03-18,1616022000.0
19094,52,0,2021-03-19,11891,2007,320815,138772,2021-03-19,1616108400.0
19095,52,0,2021-03-20,7087,696,327902,139468,2021-03-20,1616194800.0
19096,52,0,2021-03-21,1688,26,329590,139494,2021-03-21,1616281200.0
19097,52,0,2021-03-22,9013,1933,338603,141427,2021-03-22,1616367600.0
19098,52,0,2021-03-23,13180,2426,351783,143853,2021-03-23,1616454000.0
19099,52,0,2021-03-24,13258,1918,365041,145771,2021-03-24,1616540400.0
19100,52,0,2021-03-25,18202,2612,383243,148383,2021-03-25,1616626800.0
19101,52,0,2021-03-26,18941,2163,402184,150546,2021-03-26,1616713200.0
19102,52,0,2021-03-27,7553,583,409737,151129,2021-03-27,1616799600.0
19103,52,0,2021-03-28,2195,53,411932,151182,2021-03-28,1616886000.0
19104,52,0,2021-03-29,10971,2620,422903,153802,2021-03-29,1616972400.0
19105,52,0,2021-03-30,15680,3396,438583,157198,2021-03-30,1617058800.0
19106,52,0,2021-03-31,13693,3031,452276,160229,2021-03-31,1617145200.0
19107,52,0,2021-04-01,18873,3371,471149,163600,2021-04-01,1617231600.0
19108,52,0,2021-04-02,17088,3227,488237,166827,2021-04-02,1617318000.0
19109,52,0,2021-04-03,5516,1161,493753,167988,2021-04-03,1617404400.0
19110,52,0,2021-04-04,1324,43,495077,168031,2021-04-04,1617490800.0
19111,52,0,2021-04-05,1787,508,496864,168539,2021-04-05,1617577200.0
19112,52,0,2021-04-06,11787,5073,508651,173612,2021-04-06,1617663600.0
19113,52,0,2021-04-07,15188,5403,523839,179015,2021-04-07,1617750000.0
19114,52,0,2021-04-08,21239,5994,545078,185009,2021-04-08,1617836400.0
19115,52,0,2021-04-09,26663,4829,571741,189838,2021-04-09,1617922800.0
19116,52,0,2021-04-10,10125,2221,581866,192059,2021-04-10,1618009200.0
19117,52,0,2021-04-11,2570,406,584436,192465,2021-04-11,1618095600.0
19118,52,0,2021-04-12,16340,6301,600776,198766,2021-04-12,1618185600.0
19119,52,0,2021-04-13,20740,7794,621516,206560,2021-04-13,1618272000.0
19120,52,0,2021-04-14,17656,6539,639172,213099,2021-04-14,1618358400.0
19121,52,0,2021-04-15,21161,7612,660333,220711,2021-04-15,1618444800.0
19122,52,0,2021-04-16,22591,7022,682924,227733,2021-04-16,1618531200.0
19123,52,0,2021-04-17,9982,2884,692906,230617,2021-04-17,1618617600.0
19124,52,0,2021-04-18,3037,1247,695943,231864,2021-04-18,1618704000.0
19125,52,0,2021-04-19,14175,7560,710118,239424,2021-04-19,1618790400.0
19126,52,0,2021-04-20,18265,9057,728383,248481,2021-04-20,1618876800.0
19127,52,0,2021-04-21,15986,8756,744369,257237,2021-04-21,1618963200.0
19128,52,0,2021-04-22,19431,9728,763800,266965,2021-04-22,1619049600.0
19129,52,0,2021-04-23,20524,9482,784324,276447,2021-04-23,1619136000.0
19130,52,0,2021-04-24,10022,4658,794346,281105,2021-04-24,1619222400.0
19131,52,0,2021-04-25,3979,1841,798325,282946,2021-04-25,1619308800.0
19132,52,0,2021-04-26,16829,9270,815154,292216,2021-04-26,1619395200.0
19133,52,0,2021-04-27,21063,11350,836217,303566,2021-04-27,1619481600.0
19134,52,0,2021-04-28,22759,9508,858976,313074,2021-04-28,1619568000.0
19135,52,0,2021-04-29,25001,10912,883977,323986,2021-04-29,1619654400.0
19136,52,0,2021-04-30,25642,10733,909619,334719,2021-04-30,1619740800.0
19137,52,0,2021-05-01,8618,2155,918237,336874,2021-05-01,1619827200.0
19138,52,0,2021-05-02,4300,1134,922537,338008,2021-05-02,1619913600.0
19139,52,0,2021-05-03,19066,9894,941603,347902,2021-05-03,1620000000.0
19140,52,0,2021-05-04,20078,13366,961681,361268,2021-05-04,1620086400.0
19141,52,0,2021-05-05,20851,11722,982532,372990,2021-05-05,1620172800.0
19142,52,0,2021-05-06,22470,12443,1005002,385433,2021-05-06,1620259200.0
19143,52,0,2021-05-07,20688,16253,1025690,401686,2021-05-07,1620345600.0
19144,52,0,2021-05-08,11228,1713,1036918,403399,2021-05-08,1620432000.0
19145,52,0,2021-05-09,5406,2067,1042324,405466,2021-05-09,1620518400.0
19146,52,0,2021-05-10,20786,16255,1063110,421721,2021-05-10,1620604800.0
19147,52,0,2021-05-11,24882,17887,1087992,439608,2021-05-11,1620691200.0
19148,52,0,2021-05-12,24816,15719,1112808,455327,2021-05-12,1620777600.0
19149,52,0,2021-05-13,18579,2144,1131387,457471,2021-05-13,1620864000.0
19150,52,0,2021-05-14,22776,11433,1154163,468904,2021-05-14,1620950400.0
19151,52,0,2021-05-15,15651,4547,1169814,473451,2021-05-15,1621036800.0
19152,52,0,2021-05-16,10290,832,1180104,474283,2021-05-16,1621123200.0
19153,52,0,2021-05-17,21127,13608,1201231,487891,2021-05-17,1621206000.0
19154,52,0,2021-05-18,24840,13543,1226071,501434,2021-05-18,1621292400.0
19155,52,0,2021-05-19,26823,10038,1252894,511472,2021-05-19,1621378800.0
19156,52,0,2021-05-20,29352,10303,1282246,521775,2021-05-20,1621465200.0
19157,52,0,2021-05-21,27365,11949,1309611,533724,2021-05-21,1621551600.0
19158,52,0,2021-05-22,15427,3955,1325038,537679,2021-05-22,1621638000.0
19159,52,0,2021-05-23,4480,976,1329518,538655,2021-05-23,1621724400.0
19160,52,0,2021-05-24,16028,2106,1345546,540761,2021-05-24,1621810800.0
19161,52,0,2021-05-25,24467,13034,1370013,553795,2021-05-25,1621897200.0
19162,52,0,2021-05-26,25309,11256,1395322,565051,2021-05-26,1621983600.0
19163,52,0,2021-05-27,29115,12611,1424437,577662,2021-05-27,1622070000.0
19164,52,0,2021-05-28,27945,14854,1452382,592516,2021-05-28,1622156400.0
19165,52,0,2021-05-29,18353,6469,1470735,598985,2021-05-29,1622242800.0
19166,52,0,2021-05-30,4232,1534,1474967,600519,2021-05-30,1622329200.0
19167,52,0,2021-05-31,24419,13972,1499386,614491,2021-05-31,1622415600.0
19168,52,0,2021-06-01,28827,15337,1528213,629828,2021-06-01,1622502000.0
19169,52,0,2021-06-02,27493,13134,1555706,642962,2021-06-02,1622588400.0
19170,52,0,2021-06-03,31739,13707,1587445,656669,2021-06-03,1622674800.0
19171,52,0,2021-06-04,29229,17941,1616674,674610,2021-06-04,1622761200.0
19172,52,0,2021-06-05,14540,10795,1631214,685405,2021-06-05,1622847600.0
19173,52,0,2021-06-06,4782,3280,1635996,688685,2021-06-06,1622934000.0
19174,52,0,2021-06-07,21726,19273,1657722,707958,2021-06-07,1623020400.0
19175,52,0,2021-06-08,26470,19891,1684192,727849,2021-06-08,1623106800.0
19176,52,0,2021-06-09,25673,16542,1709865,744391,2021-06-09,1623193200.0
19177,52,0,2021-06-10,28739,15222,1738604,759613,2021-06-10,1623279600.0
19178,52,0,2021-06-11,26971,21877,1765575,781490,2021-06-11,1623366000.0
19179,52,0,2021-06-12,14600,10729,1780175,792219,2021-06-12,1623452400.0
19180,52,0,2021-06-13,4391,4300,1784566,796519,2021-06-13,1623538800.0
19181,52,0,2021-06-14,17611,23941,1802177,820460,2021-06-14,1623625200.0
19182,52,0,2021-06-15,23706,23259,1825883,843719,2021-06-15,1623711600.0
19183,52,0,2021-06-16,23278,20551,1849161,864270,2021-06-16,1623798000.0
19184,52,0,2021-06-17,25912,20980,1875073,885250,2021-06-17,1623884400.0
19185,52,0,2021-06-18,23244,26643,1898317,911893,2021-06-18,1623970800.0
19186,52,0,2021-06-19,12437,13302,1910754,925195,2021-06-19,1624057200.0
19187,52,0,2021-06-20,3015,4262,1913769,929457,2021-06-20,1624143600.0
19188,52,0,2021-06-21,14817,27614,1928586,957071,2021-06-21,1624230000.0
19189,52,0,2021-06-22,17387,30224,1945973,987295,2021-06-22,1624316400.0
19190,52,0,2021-06-23,18409,25296,1964382,1012591,2021-06-23,1624402800.0
19191,52,0,2021-06-24,20985,22056,1985367,1034647,2021-06-24,1624489200.0
19192,52,0,2021-06-25,16638,29490,2002005,1064137,2021-06-25,1624575600.0
19193,52,0,2021-06-26,8439,17224,2010444,1081361,2021-06-26,1624662000.0
19194,52,0,2021-06-27,1336,7278,2011780,1088639,2021-06-27,1624748400.0
19195,52,0,2021-06-28,10618,29998,2022398,1118637,2021-06-28,1624834800.0
19196,52,0,2021-06-29,13438,32928,2035836,1151565,2021-06-29,1624921200.0
19197,52,0,2021-06-30,13669,27495,2049505,1179060,2021-06-30,1625007600.0
19198,52,0,2021-07-01,16016,27774,2065521,1206834,2021-07-01,1625094000.0
19199,52,0,2021-07-02,14769,32225,2080290,1239059,2021-07-02,1625180400.0
19200,52,0,2021-07-03,7268,18408,2087558,1257467,2021-07-03,1625266800.0
19201,52,0,2021-07-04,1698,5152,2089256,1262619,2021-07-04,1625353200.0
19202,52,0,2021-07-05,9559,30421,2098815,1293040,2021-07-05,1625439600.0
19203,52,0,2021-07-06,11563,33689,2110378,1326729,2021-07-06,1625526000.0
19204,52,0,2021-07-07,12575,29117,2122953,1355846,2021-07-07,1625612400.0
19205,52,0,2021-07-08,14713,29144,2137666,1384990,2021-07-08,1625698800.0
19206,53,0,2020-12-27,0,0,0,0,2020-12-27,1609023600.0
19207,53,0,2020-12-28,1,0,1,0,2020-12-28,1609110000.0
19208,53,0,2020-12-29,0,0,1,0,2020-12-29,1609196400.0
19209,53,0,2020-12-30,0,0,1,0,2020-12-30,1609282800.0
19210,53,0,2020-12-31,0,0,1,0,2020-12-31,1609369200.0
19211,53,0,2021-01-01,2,0,3,0,2021-01-01,1609455600.0
19212,53,0,2021-01-02,4,0,7,0,2021-01-02,1609542000.0
19213,53,0,2021-01-03,1,0,8,0,2021-01-03,1609628400.0
19214,53,0,2021-01-04,43,0,51,0,2021-01-04,1609714800.0
19215,53,0,2021-01-05,200,0,251,0,2021-01-05,1609801200.0
19216,53,0,2021-01-06,331,0,582,0,2021-01-06,1609887600.0
19217,53,0,2021-01-07,835,0,1417,0,2021-01-07,1609974000.0
19218,53,0,2021-01-08,1214,0,2631,0,2021-01-08,1610060400.0
19219,53,0,2021-01-09,34,0,2665,0,2021-01-09,1610146800.0
19220,53,0,2021-01-10,4,0,2669,0,2021-01-10,1610233200.0
19221,53,0,2021-01-11,1663,0,4332,0,2021-01-11,1610319600.0
19222,53,0,2021-01-12,3381,0,7713,0,2021-01-12,1610406000.0
19223,53,0,2021-01-13,3355,0,11068,0,2021-01-13,1610492400.0
19224,53,0,2021-01-14,3813,0,14881,0,2021-01-14,1610578800.0
19225,53,0,2021-01-15,3299,0,18180,0,2021-01-15,1610665200.0
19226,53,0,2021-01-16,684,3,18864,3,2021-01-16,1610751600.0
19227,53,0,2021-01-17,180,1,19044,4,2021-01-17,1610838000.0
19228,53,0,2021-01-18,3363,4,22407,8,2021-01-18,1610924400.0
19229,53,0,2021-01-19,8177,3,30584,11,2021-01-19,1611010800.0
19230,53,0,2021-01-20,7060,2,37644,13,2021-01-20,1611097200.0
19231,53,0,2021-01-21,11493,2,49137,15,2021-01-21,1611183600.0
19232,53,0,2021-01-22,7824,0,56961,15,2021-01-22,1611270000.0
19233,53,0,2021-01-23,1493,2,58454,17,2021-01-23,1611356400.0
19234,53,0,2021-01-24,255,1,58709,18,2021-01-24,1611442800.0
19235,53,0,2021-01-25,3056,34,61765,52,2021-01-25,1611529200.0
19236,53,0,2021-01-26,4116,231,65881,283,2021-01-26,1611615600.0
19237,53,0,2021-01-27,7240,319,73121,602,2021-01-27,1611702000.0
19238,53,0,2021-01-28,7138,634,80259,1236,2021-01-28,1611788400.0
19239,53,0,2021-01-29,4232,727,84491,1963,2021-01-29,1611874800.0
19240,53,0,2021-01-30,844,42,85335,2005,2021-01-30,1611961200.0
19241,53,0,2021-01-31,80,3,85415,2008,2021-01-31,1612047600.0
19242,53,0,2021-02-01,2211,1026,87626,3034,2021-02-01,1612134000.0
19243,53,0,2021-02-02,3436,2006,91062,5040,2021-02-02,1612220400.0
19244,53,0,2021-02-03,3174,2168,94236,7208,2021-02-03,1612306800.0
19245,53,0,2021-02-04,7098,2259,101334,9467,2021-02-04,1612393200.0
19246,53,0,2021-02-05,5588,2131,106922,11598,2021-02-05,1612479600.0
19247,53,0,2021-02-06,1204,275,108126,11873,2021-02-06,1612566000.0
19248,53,0,2021-02-07,214,132,108340,12005,2021-02-07,1612652400.0
19249,53,0,2021-02-08,1651,1527,109991,13532,2021-02-08,1612738800.0
19250,53,0,2021-02-09,3978,5239,113969,18771,2021-02-09,1612825200.0
19251,53,0,2021-02-10,3793,4626,117762,23397,2021-02-10,1612911600.0
19252,53,0,2021-02-11,5740,8765,123502,32162,2021-02-11,1612998000.0
19253,53,0,2021-02-12,5662,5229,129164,37391,2021-02-12,1613084400.0
19254,53,0,2021-02-13,1232,847,130396,38238,2021-02-13,1613170800.0
19255,53,0,2021-02-14,25,348,130421,38586,2021-02-14,1613257200.0
19256,53,0,2021-02-15,2326,3575,132747,42161,2021-02-15,1613343600.0
19257,53,0,2021-02-16,4052,3533,136799,45694,2021-02-16,1613430000.0
19258,53,0,2021-02-17,4076,5361,140875,51055,2021-02-17,1613516400.0
19259,53,0,2021-02-18,5954,5718,146829,56773,2021-02-18,1613602800.0
19260,53,0,2021-02-19,5355,4825,152184,61598,2021-02-19,1613689200.0
19261,53,0,2021-02-20,1189,884,153373,62482,2021-02-20,1613775600.0
19262,53,0,2021-02-21,166,218,153539,62700,2021-02-21,1613862000.0
19263,53,0,2021-02-22,2318,2816,155857,65516,2021-02-22,1613948400.0
19264,53,0,2021-02-23,3947,3659,159804,69175,2021-02-23,1614034800.0
19265,53,0,2021-02-24,4474,3760,164278,72935,2021-02-24,1614121200.0
19266,53,0,2021-02-25,7951,7102,172229,80037,2021-02-25,1614207600.0
19267,53,0,2021-02-26,8677,4364,180906,84401,2021-02-26,1614294000.0
19268,53,0,2021-02-27,3448,1093,184354,85494,2021-02-27,1614380400.0
19269,53,0,2021-02-28,228,194,184582,85688,2021-02-28,1614466800.0
19270,53,0,2021-03-01,3480,2256,188062,87944,2021-03-01,1614553200.0
19271,53,0,2021-03-02,5617,4442,193679,92386,2021-03-02,1614639600.0
19272,53,0,2021-03-03,6447,3763,200126,96149,2021-03-03,1614726000.0
19273,53,0,2021-03-04,9290,4875,209416,101024,2021-03-04,1614812400.0
19274,53,0,2021-03-05,11913,5135,221329,106159,2021-03-05,1614898800.0
19275,53,0,2021-03-06,5639,988,226968,107147,2021-03-06,1614985200.0
19276,53,0,2021-03-07,913,138,227881,107285,2021-03-07,1615071600.0
19277,53,0,2021-03-08,5168,2177,233049,109462,2021-03-08,1615158000.0
19278,53,0,2021-03-09,9664,2871,242713,112333,2021-03-09,1615244400.0
19279,53,0,2021-03-10,9277,3311,251990,115644,2021-03-10,1615330800.0
19280,53,0,2021-03-11,14305,3958,266295,119602,2021-03-11,1615417200.0
19281,53,0,2021-03-12,18602,3092,284897,122694,2021-03-12,1615503600.0
19282,53,0,2021-03-13,8816,906,293713,123600,2021-03-13,1615590000.0
19283,53,0,2021-03-14,812,50,294525,123650,2021-03-14,1615676400.0
19284,53,0,2021-03-15,6891,1995,301416,125645,2021-03-15,1615762800.0
19285,53,0,2021-03-16,6986,3348,308402,128993,2021-03-16,1615849200.0
19286,53,0,2021-03-17,8227,2755,316629,131748,2021-03-17,1615935600.0
19287,53,0,2021-03-18,8717,4575,325346,136323,2021-03-18,1616022000.0
19288,53,0,2021-03-19,12993,3565,338339,139888,2021-03-19,1616108400.0
19289,53,0,2021-03-20,7128,770,345467,140658,2021-03-20,1616194800.0
19290,53,0,2021-03-21,383,30,345850,140688,2021-03-21,1616281200.0
19291,53,0,2021-03-22,7348,2112,353198,142800,2021-03-22,1616367600.0
19292,53,0,2021-03-23,12990,3586,366188,146386,2021-03-23,1616454000.0
19293,53,0,2021-03-24,14403,3169,380591,149555,2021-03-24,1616540400.0
19294,53,0,2021-03-25,18291,3228,398882,152783,2021-03-25,1616626800.0
19295,53,0,2021-03-26,20325,3047,419207,155830,2021-03-26,1616713200.0
19296,53,0,2021-03-27,7409,983,426616,156813,2021-03-27,1616799600.0
19297,53,0,2021-03-28,529,84,427145,156897,2021-03-28,1616886000.0
19298,53,0,2021-03-29,9800,3100,436945,159997,2021-03-29,1616972400.0
19299,53,0,2021-03-30,15314,4493,452259,164490,2021-03-30,1617058800.0
19300,53,0,2021-03-31,14152,4142,466411,168632,2021-03-31,1617145200.0
19301,53,0,2021-04-01,18208,4093,484619,172725,2021-04-01,1617231600.0
19302,53,0,2021-04-02,17904,4187,502523,176912,2021-04-02,1617318000.0
19303,53,0,2021-04-03,6439,1388,508962,178300,2021-04-03,1617404400.0
19304,53,0,2021-04-04,414,31,509376,178331,2021-04-04,1617490800.0
19305,53,0,2021-04-05,1233,325,510609,178656,2021-04-05,1617577200.0
19306,53,0,2021-04-06,12529,5561,523138,184217,2021-04-06,1617663600.0
19307,53,0,2021-04-07,15022,5211,538160,189428,2021-04-07,1617750000.0
19308,53,0,2021-04-08,20719,5903,558879,195331,2021-04-08,1617836400.0
19309,53,0,2021-04-09,26681,5312,585560,200643,2021-04-09,1617922800.0
19310,53,0,2021-04-10,10353,1641,595913,202284,2021-04-10,1618009200.0
19311,53,0,2021-04-11,817,206,596730,202490,2021-04-11,1618095600.0
19312,53,0,2021-04-12,15843,4775,612573,207265,2021-04-12,1618185600.0
19313,53,0,2021-04-13,22710,6950,635283,214215,2021-04-13,1618272000.0
19314,53,0,2021-04-14,19361,7709,654644,221924,2021-04-14,1618358400.0
19315,53,0,2021-04-15,25405,7791,680049,229715,2021-04-15,1618444800.0
19316,53,0,2021-04-16,26189,7256,706238,236971,2021-04-16,1618531200.0
19317,53,0,2021-04-17,10402,3498,716640,240469,2021-04-17,1618617600.0
19318,53,0,2021-04-18,1034,139,717674,240608,2021-04-18,1618704000.0
19319,53,0,2021-04-19,15409,6361,733083,246969,2021-04-19,1618790400.0
19320,53,0,2021-04-20,16928,9285,750011,256254,2021-04-20,1618876800.0
19321,53,0,2021-04-21,16748,9222,766759,265476,2021-04-21,1618963200.0
19322,53,0,2021-04-22,21776,9868,788535,275344,2021-04-22,1619049600.0
19323,53,0,2021-04-23,21661,9712,810196,285056,2021-04-23,1619136000.0
19324,53,0,2021-04-24,9988,3887,820184,288943,2021-04-24,1619222400.0
19325,53,0,2021-04-25,911,319,821095,289262,2021-04-25,1619308800.0
19326,53,0,2021-04-26,18235,7962,839330,297224,2021-04-26,1619395200.0
19327,53,0,2021-04-27,19859,11141,859189,308365,2021-04-27,1619481600.0
19328,53,0,2021-04-28,19948,9904,879137,318269,2021-04-28,1619568000.0
19329,53,0,2021-04-29,23565,10918,902702,329187,2021-04-29,1619654400.0
19330,53,0,2021-04-30,23906,10903,926608,340090,2021-04-30,1619740800.0
19331,53,0,2021-05-01,5125,1460,931733,341550,2021-05-01,1619827200.0
19332,53,0,2021-05-02,2798,448,934531,341998,2021-05-02,1619913600.0
19333,53,0,2021-05-03,15716,8819,950247,350817,2021-05-03,1620000000.0
19334,53,0,2021-05-04,15699,15030,965946,365847,2021-05-04,1620086400.0
19335,53,0,2021-05-05,14946,14173,980892,380020,2021-05-05,1620172800.0
19336,53,0,2021-05-06,19262,16836,1000154,396856,2021-05-06,1620259200.0
19337,53,0,2021-05-07,18644,16541,1018798,413397,2021-05-07,1620345600.0
19338,53,0,2021-05-08,5486,953,1024284,414350,2021-05-08,1620432000.0
19339,53,0,2021-05-09,3512,809,1027796,415159,2021-05-09,1620518400.0
19340,53,0,2021-05-10,16681,14548,1044477,429707,2021-05-10,1620604800.0
19341,53,0,2021-05-11,18678,17455,1063155,447162,2021-05-11,1620691200.0
19342,53,0,2021-05-12,21199,14395,1084354,461557,2021-05-12,1620777600.0
19343,53,0,2021-05-13,9027,3749,1093381,465306,2021-05-13,1620864000.0
19344,53,0,2021-05-14,21713,12545,1115094,477851,2021-05-14,1620950400.0
19345,53,0,2021-05-15,13430,4798,1128524,482649,2021-05-15,1621036800.0
19346,53,0,2021-05-16,3225,800,1131749,483449,2021-05-16,1621123200.0
19347,53,0,2021-05-17,18193,10437,1149942,493886,2021-05-17,1621206000.0
19348,53,0,2021-05-18,21056,11145,1170998,505031,2021-05-18,1621292400.0
19349,53,0,2021-05-19,21692,9711,1192690,514742,2021-05-19,1621378800.0
19350,53,0,2021-05-20,23952,13226,1216642,527968,2021-05-20,1621465200.0
19351,53,0,2021-05-21,22934,13513,1239576,541481,2021-05-21,1621551600.0
19352,53,0,2021-05-22,13201,5223,1252777,546704,2021-05-22,1621638000.0
19353,53,0,2021-05-23,2999,257,1255776,546961,2021-05-23,1621724400.0
19354,53,0,2021-05-24,14035,2133,1269811,549094,2021-05-24,1621810800.0
19355,53,0,2021-05-25,20099,11827,1289910,560921,2021-05-25,1621897200.0
19356,53,0,2021-05-26,19505,12809,1309415,573730,2021-05-26,1621983600.0
19357,53,0,2021-05-27,22162,15564,1331577,589294,2021-05-27,1622070000.0
19358,53,0,2021-05-28,21797,17767,1353374,607061,2021-05-28,1622156400.0
19359,53,0,2021-05-29,12149,6380,1365523,613441,2021-05-29,1622242800.0
19360,53,0,2021-05-30,2316,388,1367839,613829,2021-05-30,1622329200.0
19361,53,0,2021-05-31,20708,12756,1388547,626585,2021-05-31,1622415600.0
19362,53,0,2021-06-01,22980,14846,1411527,641431,2021-06-01,1622502000.0
19363,53,0,2021-06-02,21825,12827,1433352,654258,2021-06-02,1622588400.0
19364,53,0,2021-06-03,25062,14928,1458414,669186,2021-06-03,1622674800.0
19365,53,0,2021-06-04,23114,20307,1481528,689493,2021-06-04,1622761200.0
19366,53,0,2021-06-05,17320,7919,1498848,697412,2021-06-05,1622847600.0
19367,53,0,2021-06-06,5013,1133,1503861,698545,2021-06-06,1622934000.0
19368,53,0,2021-06-07,18403,16666,1522264,715211,2021-06-07,1623020400.0
19369,53,0,2021-06-08,23389,16353,1545653,731564,2021-06-08,1623106800.0
19370,53,0,2021-06-09,23640,14411,1569293,745975,2021-06-09,1623193200.0
19371,53,0,2021-06-10,26821,14912,1596114,760887,2021-06-10,1623279600.0
19372,53,0,2021-06-11,26216,19427,1622330,780314,2021-06-11,1623366000.0
19373,53,0,2021-06-12,18608,6621,1640938,786935,2021-06-12,1623452400.0
19374,53,0,2021-06-13,7796,2832,1648734,789767,2021-06-13,1623538800.0
19375,53,0,2021-06-14,16033,18751,1664767,808518,2021-06-14,1623625200.0
19376,53,0,2021-06-15,20078,19605,1684845,828123,2021-06-15,1623711600.0
19377,53,0,2021-06-16,21181,17174,1706026,845297,2021-06-16,1623798000.0
19378,53,0,2021-06-17,21894,18687,1727920,863984,2021-06-17,1623884400.0
19379,53,0,2021-06-18,22231,23945,1750151,887929,2021-06-18,1623970800.0
19380,53,0,2021-06-19,12833,8812,1762984,896741,2021-06-19,1624057200.0
19381,53,0,2021-06-20,5453,2460,1768437,899201,2021-06-20,1624143600.0
19382,53,0,2021-06-21,14586,21374,1783023,920575,2021-06-21,1624230000.0
19383,53,0,2021-06-22,16988,23535,1800011,944110,2021-06-22,1624316400.0
19384,53,0,2021-06-23,16739,22366,1816750,966476,2021-06-23,1624402800.0
19385,53,0,2021-06-24,19030,20339,1835780,986815,2021-06-24,1624489200.0
19386,53,0,2021-06-25,15512,27660,1851292,1014475,2021-06-25,1624575600.0
19387,53,0,2021-06-26,7136,13409,1858428,1027884,2021-06-26,1624662000.0
19388,53,0,2021-06-27,3882,3135,1862310,1031019,2021-06-27,1624748400.0
19389,53,0,2021-06-28,9636,23458,1871946,1054477,2021-06-28,1624834800.0
19390,53,0,2021-06-29,11475,26106,1883421,1080583,2021-06-29,1624921200.0
19391,53,0,2021-06-30,12080,25437,1895501,1106020,2021-06-30,1625007600.0
19392,53,0,2021-07-01,14096,25412,1909597,1131432,2021-07-01,1625094000.0
19393,53,0,2021-07-02,13126,30261,1922723,1161693,2021-07-02,1625180400.0
19394,53,0,2021-07-03,6524,14802,1929247,1176495,2021-07-03,1625266800.0
19395,53,0,2021-07-04,3850,4241,1933097,1180736,2021-07-04,1625353200.0
19396,53,0,2021-07-05,8945,25668,1942042,1206404,2021-07-05,1625439600.0
19397,53,0,2021-07-06,10635,28096,1952677,1234500,2021-07-06,1625526000.0
19398,53,0,2021-07-07,11691,24666,1964368,1259166,2021-07-07,1625612400.0
19399,53,0,2021-07-08,13029,26169,1977397,1285335,2021-07-08,1625698800.0
19400,75,0,2020-12-27,1,0,1,0,2020-12-27,1609023600.0
19401,75,0,2020-12-28,3,0,4,0,2020-12-28,1609110000.0
19402,75,0,2020-12-29,3,0,7,0,2020-12-29,1609196400.0
19403,75,0,2020-12-30,2,0,9,0,2020-12-30,1609282800.0
19404,75,0,2020-12-31,0,0,9,0,2020-12-31,1609369200.0
19405,75,0,2021-01-01,4,0,13,0,2021-01-01,1609455600.0
19406,75,0,2021-01-02,2,0,15,0,2021-01-02,1609542000.0
19407,75,0,2021-01-03,0,0,15,0,2021-01-03,1609628400.0
19408,75,0,2021-01-04,90,0,105,0,2021-01-04,1609714800.0
19409,75,0,2021-01-05,125,0,230,0,2021-01-05,1609801200.0
19410,75,0,2021-01-06,736,0,966,0,2021-01-06,1609887600.0
19411,75,0,2021-01-07,4923,0,5889,0,2021-01-07,1609974000.0
19412,75,0,2021-01-08,5470,0,11359,0,2021-01-08,1610060400.0
19413,75,0,2021-01-09,845,0,12204,0,2021-01-09,1610146800.0
19414,75,0,2021-01-10,478,0,12682,0,2021-01-10,1610233200.0
19415,75,0,2021-01-11,3585,0,16267,0,2021-01-11,1610319600.0
19416,75,0,2021-01-12,5947,0,22214,0,2021-01-12,1610406000.0
19417,75,0,2021-01-13,6553,0,28767,0,2021-01-13,1610492400.0
19418,75,0,2021-01-14,8127,0,36894,0,2021-01-14,1610578800.0
19419,75,0,2021-01-15,7631,0,44525,0,2021-01-15,1610665200.0
19420,75,0,2021-01-16,1609,12,46134,12,2021-01-16,1610751600.0
19421,75,0,2021-01-17,426,3,46560,15,2021-01-17,1610838000.0
19422,75,0,2021-01-18,6893,24,53453,39,2021-01-18,1610924400.0
19423,75,0,2021-01-19,14055,8,67508,47,2021-01-19,1611010800.0
19424,75,0,2021-01-20,15538,5,83046,52,2021-01-20,1611097200.0
19425,75,0,2021-01-21,16967,16,100013,68,2021-01-21,1611183600.0
19426,75,0,2021-01-22,12975,14,112988,82,2021-01-22,1611270000.0
19427,75,0,2021-01-23,4421,2,117409,84,2021-01-23,1611356400.0
19428,75,0,2021-01-24,701,1,118110,85,2021-01-24,1611442800.0
19429,75,0,2021-01-25,8873,212,126983,297,2021-01-25,1611529200.0
19430,75,0,2021-01-26,11725,446,138708,743,2021-01-26,1611615600.0
19431,75,0,2021-01-27,12300,759,151008,1502,2021-01-27,1611702000.0
19432,75,0,2021-01-28,12942,2636,163950,4138,2021-01-28,1611788400.0
19433,75,0,2021-01-29,10009,2978,173959,7116,2021-01-29,1611874800.0
19434,75,0,2021-01-30,3379,515,177338,7631,2021-01-30,1611961200.0
19435,75,0,2021-01-31,646,418,177984,8049,2021-01-31,1612047600.0
19436,75,0,2021-02-01,5716,2638,183700,10687,2021-02-01,1612134000.0
19437,75,0,2021-02-02,9617,4342,193317,15029,2021-02-02,1612220400.0
19438,75,0,2021-02-03,9596,4356,202913,19385,2021-02-03,1612306800.0
19439,75,0,2021-02-04,10767,5667,213680,25052,2021-02-04,1612393200.0
19440,75,0,2021-02-05,7490,5629,221170,30681,2021-02-05,1612479600.0
19441,75,0,2021-02-06,2382,1104,223552,31785,2021-02-06,1612566000.0
19442,75,0,2021-02-07,674,245,224226,32030,2021-02-07,1612652400.0
19443,75,0,2021-02-08,5136,3646,229362,35676,2021-02-08,1612738800.0
19444,75,0,2021-02-09,7316,8048,236678,43724,2021-02-09,1612825200.0
19445,75,0,2021-02-10,7543,8734,244221,52458,2021-02-10,1612911600.0
19446,75,0,2021-02-11,8872,10245,253093,62703,2021-02-11,1612998000.0
19447,75,0,2021-02-12,7412,8749,260505,71452,2021-02-12,1613084400.0
19448,75,0,2021-02-13,1953,1753,262458,73205,2021-02-13,1613170800.0
19449,75,0,2021-02-14,274,363,262732,73568,2021-02-14,1613257200.0
19450,75,0,2021-02-15,3191,7829,265923,81397,2021-02-15,1613343600.0
19451,75,0,2021-02-16,4629,10492,270552,91889,2021-02-16,1613430000.0
19452,75,0,2021-02-17,4759,11270,275311,103159,2021-02-17,1613516400.0
19453,75,0,2021-02-18,5456,12772,280767,115931,2021-02-18,1613602800.0
19454,75,0,2021-02-19,5418,9581,286185,125512,2021-02-19,1613689200.0
19455,75,0,2021-02-20,989,2627,287174,128139,2021-02-20,1613775600.0
19456,75,0,2021-02-21,188,665,287362,128804,2021-02-21,1613862000.0
19457,75,0,2021-02-22,3648,8486,291010,137290,2021-02-22,1613948400.0
19458,75,0,2021-02-23,5361,10885,296371,148175,2021-02-23,1614034800.0
19459,75,0,2021-02-24,6132,10249,302503,158424,2021-02-24,1614121200.0
19460,75,0,2021-02-25,10046,11617,312549,170041,2021-02-25,1614207600.0
19461,75,0,2021-02-26,12270,8749,324819,178790,2021-02-26,1614294000.0
19462,75,0,2021-02-27,5787,2461,330606,181251,2021-02-27,1614380400.0
19463,75,0,2021-02-28,314,691,330920,181942,2021-02-28,1614466800.0
19464,75,0,2021-03-01,5095,6965,336015,188907,2021-03-01,1614553200.0
19465,75,0,2021-03-02,9355,8076,345370,196983,2021-03-02,1614639600.0
19466,75,0,2021-03-03,10826,7706,356196,204689,2021-03-03,1614726000.0
19467,75,0,2021-03-04,16741,8023,372937,212712,2021-03-04,1614812400.0
19468,75,0,2021-03-05,20817,7247,393754,219959,2021-03-05,1614898800.0
19469,75,0,2021-03-06,13412,2137,407166,222096,2021-03-06,1614985200.0
19470,75,0,2021-03-07,3722,428,410888,222524,2021-03-07,1615071600.0
19471,75,0,2021-03-08,9998,5313,420886,227837,2021-03-08,1615158000.0
19472,75,0,2021-03-09,16864,6375,437750,234212,2021-03-09,1615244400.0
19473,75,0,2021-03-10,18265,6188,456015,240400,2021-03-10,1615330800.0
19474,75,0,2021-03-11,26446,6482,482461,246882,2021-03-11,1615417200.0
19475,75,0,2021-03-12,31325,5025,513786,251907,2021-03-12,1615503600.0
19476,75,0,2021-03-13,17876,1111,531662,253018,2021-03-13,1615590000.0
19477,75,0,2021-03-14,1713,234,533375,253252,2021-03-14,1615676400.0
19478,75,0,2021-03-15,14082,3337,547457,256589,2021-03-15,1615762800.0
19479,75,0,2021-03-16,13686,3625,561143,260214,2021-03-16,1615849200.0
19480,75,0,2021-03-17,14756,3754,575899,263968,2021-03-17,1615935600.0
19481,75,0,2021-03-18,16387,4477,592286,268445,2021-03-18,1616022000.0
19482,75,0,2021-03-19,22450,4086,614736,272531,2021-03-19,1616108400.0
19483,75,0,2021-03-20,14033,726,628769,273257,2021-03-20,1616194800.0
19484,75,0,2021-03-21,2478,86,631247,273343,2021-03-21,1616281200.0
19485,75,0,2021-03-22,16799,3348,648046,276691,2021-03-22,1616367600.0
19486,75,0,2021-03-23,25285,3679,673331,280370,2021-03-23,1616454000.0
19487,75,0,2021-03-24,27173,4094,700504,284464,2021-03-24,1616540400.0
19488,75,0,2021-03-25,35676,4352,736180,288816,2021-03-25,1616626800.0
19489,75,0,2021-03-26,38641,3830,774821,292646,2021-03-26,1616713200.0
19490,75,0,2021-03-27,15732,1107,790553,293753,2021-03-27,1616799600.0
19491,75,0,2021-03-28,2727,366,793280,294119,2021-03-28,1616886000.0
19492,75,0,2021-03-29,22843,3885,816123,298004,2021-03-29,1616972400.0
19493,75,0,2021-03-30,31659,5604,847782,303608,2021-03-30,1617058800.0
19494,75,0,2021-03-31,29764,5619,877546,309227,2021-03-31,1617145200.0
19495,75,0,2021-04-01,35048,6442,912594,315669,2021-04-01,1617231600.0
19496,75,0,2021-04-02,32366,6469,944960,322138,2021-04-02,1617318000.0
19497,75,0,2021-04-03,12851,2505,957811,324643,2021-04-03,1617404400.0
19498,75,0,2021-04-04,2140,319,959951,324962,2021-04-04,1617490800.0
19499,75,0,2021-04-05,6372,537,966323,325499,2021-04-05,1617577200.0
19500,75,0,2021-04-06,26401,10524,992724,336023,2021-04-06,1617663600.0
19501,75,0,2021-04-07,32388,10569,1025112,346592,2021-04-07,1617750000.0
19502,75,0,2021-04-08,39640,11739,1064752,358331,2021-04-08,1617836400.0
19503,75,0,2021-04-09,49304,10266,1114056,368597,2021-04-09,1617922800.0
19504,75,0,2021-04-10,24500,4639,1138556,373236,2021-04-10,1618009200.0
19505,75,0,2021-04-11,4978,668,1143534,373904,2021-04-11,1618095600.0
19506,75,0,2021-04-12,27400,11450,1170934,385354,2021-04-12,1618185600.0
19507,75,0,2021-04-13,35766,13802,1206700,399156,2021-04-13,1618272000.0
19508,75,0,2021-04-14,35482,13936,1242182,413092,2021-04-14,1618358400.0
19509,75,0,2021-04-15,37727,14405,1279909,427497,2021-04-15,1618444800.0
19510,75,0,2021-04-16,37176,14602,1317085,442099,2021-04-16,1618531200.0
19511,75,0,2021-04-17,19590,7121,1336675,449220,2021-04-17,1618617600.0
19512,75,0,2021-04-18,4077,1992,1340752,451212,2021-04-18,1618704000.0
19513,75,0,2021-04-19,20902,14607,1361654,465819,2021-04-19,1618790400.0
19514,75,0,2021-04-20,28515,18627,1390169,484446,2021-04-20,1618876800.0
19515,75,0,2021-04-21,27853,17579,1418022,502025,2021-04-21,1618963200.0
19516,75,0,2021-04-22,30415,19111,1448437,521136,2021-04-22,1619049600.0
19517,75,0,2021-04-23,29087,19623,1477524,540759,2021-04-23,1619136000.0
19518,75,0,2021-04-24,17031,8662,1494555,549421,2021-04-24,1619222400.0
19519,75,0,2021-04-25,4598,1414,1499153,550835,2021-04-25,1619308800.0
19520,75,0,2021-04-26,22332,18543,1521485,569378,2021-04-26,1619395200.0
19521,75,0,2021-04-27,29207,22691,1550692,592069,2021-04-27,1619481600.0
19522,75,0,2021-04-28,31153,22317,1581845,614386,2021-04-28,1619568000.0
19523,75,0,2021-04-29,37285,23874,1619130,638260,2021-04-29,1619654400.0
19524,75,0,2021-04-30,37767,22733,1656897,660993,2021-04-30,1619740800.0
19525,75,0,2021-05-01,15696,5185,1672593,666178,2021-05-01,1619827200.0
19526,75,0,2021-05-02,7264,2392,1679857,668570,2021-05-02,1619913600.0
19527,75,0,2021-05-03,27272,19893,1707129,688463,2021-05-03,1620000000.0
19528,75,0,2021-05-04,30367,27536,1737496,715999,2021-05-04,1620086400.0
19529,75,0,2021-05-05,31517,29334,1769013,745333,2021-05-05,1620172800.0
19530,75,0,2021-05-06,35977,29839,1804990,775172,2021-05-06,1620259200.0
19531,75,0,2021-05-07,37455,30954,1842445,806126,2021-05-07,1620345600.0
19532,75,0,2021-05-08,17732,7441,1860177,813567,2021-05-08,1620432000.0
19533,75,0,2021-05-09,7313,3919,1867490,817486,2021-05-09,1620518400.0
19534,75,0,2021-05-10,25220,27487,1892710,844973,2021-05-10,1620604800.0
19535,75,0,2021-05-11,35613,30246,1928323,875219,2021-05-11,1620691200.0
19536,75,0,2021-05-12,35640,27904,1963963,903123,2021-05-12,1620777600.0
19537,75,0,2021-05-13,22707,6627,1986670,909750,2021-05-13,1620864000.0
19538,75,0,2021-05-14,33907,19054,2020577,928804,2021-05-14,1620950400.0
19539,75,0,2021-05-15,22960,10070,2043537,938874,2021-05-15,1621036800.0
19540,75,0,2021-05-16,7430,1822,2050967,940696,2021-05-16,1621123200.0
19541,75,0,2021-05-17,33943,17538,2084910,958234,2021-05-17,1621206000.0
19542,75,0,2021-05-18,42886,17599,2127796,975833,2021-05-18,1621292400.0
19543,75,0,2021-05-19,42821,15760,2170617,991593,2021-05-19,1621378800.0
19544,75,0,2021-05-20,46039,17876,2216656,1009469,2021-05-20,1621465200.0
19545,75,0,2021-05-21,43012,18482,2259668,1027951,2021-05-21,1621551600.0
19546,75,0,2021-05-22,23321,8575,2282989,1036526,2021-05-22,1621638000.0
19547,75,0,2021-05-23,7844,1121,2290833,1037647,2021-05-23,1621724400.0
19548,75,0,2021-05-24,18902,3283,2309735,1040930,2021-05-24,1621810800.0
19549,75,0,2021-05-25,36980,18938,2346715,1059868,2021-05-25,1621897200.0
19550,75,0,2021-05-26,38784,19119,2385499,1078987,2021-05-26,1621983600.0
19551,75,0,2021-05-27,43045,23988,2428544,1102975,2021-05-27,1622070000.0
19552,75,0,2021-05-28,38976,27596,2467520,1130571,2021-05-28,1622156400.0
19553,75,0,2021-05-29,19679,16184,2487199,1146755,2021-05-29,1622242800.0
19554,75,0,2021-05-30,5798,2031,2492997,1148786,2021-05-30,1622329200.0
19555,75,0,2021-05-31,31648,20441,2524645,1169227,2021-05-31,1622415600.0
19556,75,0,2021-06-01,41071,25665,2565716,1194892,2021-06-01,1622502000.0
19557,75,0,2021-06-02,41491,24666,2607207,1219558,2021-06-02,1622588400.0
19558,75,0,2021-06-03,47652,26916,2654859,1246474,2021-06-03,1622674800.0
19559,75,0,2021-06-04,44439,32439,2699298,1278913,2021-06-04,1622761200.0
19560,75,0,2021-06-05,24431,16387,2723729,1295300,2021-06-05,1622847600.0
19561,75,0,2021-06-06,8752,3836,2732481,1299136,2021-06-06,1622934000.0
19562,75,0,2021-06-07,31439,29068,2763920,1328204,2021-06-07,1623020400.0
19563,75,0,2021-06-08,38506,32561,2802426,1360765,2021-06-08,1623106800.0
19564,75,0,2021-06-09,39371,29654,2841797,1390419,2021-06-09,1623193200.0
19565,75,0,2021-06-10,43048,27869,2884845,1418288,2021-06-10,1623279600.0
19566,75,0,2021-06-11,40300,36179,2925145,1454467,2021-06-11,1623366000.0
19567,75,0,2021-06-12,23213,19605,2948358,1474072,2021-06-12,1623452400.0
19568,75,0,2021-06-13,8109,5232,2956467,1479304,2021-06-13,1623538800.0
19569,75,0,2021-06-14,23970,35816,2980437,1515120,2021-06-14,1623625200.0
19570,75,0,2021-06-15,33144,38439,3013581,1553559,2021-06-15,1623711600.0
19571,75,0,2021-06-16,34692,34409,3048273,1587968,2021-06-16,1623798000.0
19572,75,0,2021-06-17,36092,35045,3084365,1623013,2021-06-17,1623884400.0
19573,75,0,2021-06-18,34711,41902,3119076,1664915,2021-06-18,1623970800.0
19574,75,0,2021-06-19,20138,21530,3139214,1686445,2021-06-19,1624057200.0
19575,75,0,2021-06-20,6219,5302,3145433,1691747,2021-06-20,1624143600.0
19576,75,0,2021-06-21,21414,35356,3166847,1727103,2021-06-21,1624230000.0
19577,75,0,2021-06-22,25238,41057,3192085,1768160,2021-06-22,1624316400.0
19578,75,0,2021-06-23,26166,38264,3218251,1806424,2021-06-23,1624402800.0
19579,75,0,2021-06-24,27877,32694,3246128,1839118,2021-06-24,1624489200.0
19580,75,0,2021-06-25,24002,45694,3270130,1884812,2021-06-25,1624575600.0
19581,75,0,2021-06-26,13606,25448,3283736,1910260,2021-06-26,1624662000.0
19582,75,0,2021-06-27,4571,8245,3288307,1918505,2021-06-27,1624748400.0
19583,75,0,2021-06-28,14808,42988,3303115,1961493,2021-06-28,1624834800.0
19584,75,0,2021-06-29,18551,49575,3321666,2011068,2021-06-29,1624921200.0
19585,75,0,2021-06-30,20073,45597,3341739,2056665,2021-06-30,1625007600.0
19586,75,0,2021-07-01,22326,43690,3364065,2100355,2021-07-01,1625094000.0
19587,75,0,2021-07-02,21037,50572,3385102,2150927,2021-07-02,1625180400.0
19588,75,0,2021-07-03,9946,27776,3395048,2178703,2021-07-03,1625266800.0
19589,75,0,2021-07-04,3375,7501,3398423,2186204,2021-07-04,1625353200.0
19590,75,0,2021-07-05,14087,40575,3412510,2226779,2021-07-05,1625439600.0
19591,75,0,2021-07-06,18090,49606,3430600,2276385,2021-07-06,1625526000.0
19592,75,0,2021-07-07,20453,45968,3451053,2322353,2021-07-07,1625612400.0
19593,75,0,2021-07-08,22836,43509,3473889,2365862,2021-07-08,1625698800.0
19594,76,0,2020-12-27,0,0,0,0,2020-12-27,1609023600.0
19595,76,0,2020-12-28,5,0,5,0,2020-12-28,1609110000.0
19596,76,0,2020-12-29,0,0,5,0,2020-12-29,1609196400.0
19597,76,0,2020-12-30,0,0,5,0,2020-12-30,1609282800.0
19598,76,0,2020-12-31,1,0,6,0,2020-12-31,1609369200.0
19599,76,0,2021-01-01,3,0,9,0,2021-01-01,1609455600.0
19600,76,0,2021-01-02,2,0,11,0,2021-01-02,1609542000.0
19601,76,0,2021-01-03,2,0,13,0,2021-01-03,1609628400.0
19602,76,0,2021-01-04,59,0,72,0,2021-01-04,1609714800.0
19603,76,0,2021-01-05,473,0,545,0,2021-01-05,1609801200.0
19604,76,0,2021-01-06,784,0,1329,0,2021-01-06,1609887600.0
19605,76,0,2021-01-07,2555,0,3884,0,2021-01-07,1609974000.0
19606,76,0,2021-01-08,3218,0,7102,0,2021-01-08,1610060400.0
19607,76,0,2021-01-09,1539,0,8641,0,2021-01-09,1610146800.0
19608,76,0,2021-01-10,517,0,9158,0,2021-01-10,1610233200.0
19609,76,0,2021-01-11,3524,0,12682,0,2021-01-11,1610319600.0
19610,76,0,2021-01-12,5752,0,18434,0,2021-01-12,1610406000.0
19611,76,0,2021-01-13,6477,0,24911,0,2021-01-13,1610492400.0
19612,76,0,2021-01-14,8999,0,33910,0,2021-01-14,1610578800.0
19613,76,0,2021-01-15,7255,0,41165,0,2021-01-15,1610665200.0
19614,76,0,2021-01-16,1954,16,43119,16,2021-01-16,1610751600.0
19615,76,0,2021-01-17,710,2,43829,18,2021-01-17,1610838000.0
19616,76,0,2021-01-18,7708,12,51537,30,2021-01-18,1610924400.0
19617,76,0,2021-01-19,11211,10,62748,40,2021-01-19,1611010800.0
19618,76,0,2021-01-20,13727,9,76475,49,2021-01-20,1611097200.0
19619,76,0,2021-01-21,16726,6,93201,55,2021-01-21,1611183600.0
19620,76,0,2021-01-22,11928,15,105129,70,2021-01-22,1611270000.0
19621,76,0,2021-01-23,3898,5,109027,75,2021-01-23,1611356400.0
19622,76,0,2021-01-24,771,10,109798,85,2021-01-24,1611442800.0
19623,76,0,2021-01-25,7831,85,117629,170,2021-01-25,1611529200.0
19624,76,0,2021-01-26,10350,266,127979,436,2021-01-26,1611615600.0
19625,76,0,2021-01-27,10850,461,138829,897,2021-01-27,1611702000.0
19626,76,0,2021-01-28,10141,1681,148970,2578,2021-01-28,1611788400.0
19627,76,0,2021-01-29,8092,1980,157062,4558,2021-01-29,1611874800.0
19628,76,0,2021-01-30,3187,769,160249,5327,2021-01-30,1611961200.0
19629,76,0,2021-01-31,521,267,160770,5594,2021-01-31,1612047600.0
19630,76,0,2021-02-01,5857,2596,166627,8190,2021-02-01,1612134000.0
19631,76,0,2021-02-02,10064,3987,176691,12177,2021-02-02,1612220400.0
19632,76,0,2021-02-03,9523,4048,186214,16225,2021-02-03,1612306800.0
19633,76,0,2021-02-04,10107,5925,196321,22150,2021-02-04,1612393200.0
19634,76,0,2021-02-05,7775,4985,204096,27135,2021-02-05,1612479600.0
19635,76,0,2021-02-06,2700,1047,206796,28182,2021-02-06,1612566000.0
19636,76,0,2021-02-07,542,494,207338,28676,2021-02-07,1612652400.0
19637,76,0,2021-02-08,4843,4515,212181,33191,2021-02-08,1612738800.0
19638,76,0,2021-02-09,6331,6789,218512,39980,2021-02-09,1612825200.0
19639,76,0,2021-02-10,7181,9197,225693,49177,2021-02-10,1612911600.0
19640,76,0,2021-02-11,9147,10666,234840,59843,2021-02-11,1612998000.0
19641,76,0,2021-02-12,8050,7630,242890,67473,2021-02-12,1613084400.0
19642,76,0,2021-02-13,2649,2260,245539,69733,2021-02-13,1613170800.0
19643,76,0,2021-02-14,358,993,245897,70726,2021-02-14,1613257200.0
19644,76,0,2021-02-15,3379,6445,249276,77171,2021-02-15,1613343600.0
19645,76,0,2021-02-16,4242,8660,253518,85831,2021-02-16,1613430000.0
19646,76,0,2021-02-17,4376,9605,257894,95436,2021-02-17,1613516400.0
19647,76,0,2021-02-18,5871,9929,263765,105365,2021-02-18,1613602800.0
19648,76,0,2021-02-19,4844,8078,268609,113443,2021-02-19,1613689200.0
19649,76,0,2021-02-20,1530,3024,270139,116467,2021-02-20,1613775600.0
19650,76,0,2021-02-21,265,589,270404,117056,2021-02-21,1613862000.0
19651,76,0,2021-02-22,3280,7615,273684,124671,2021-02-22,1613948400.0
19652,76,0,2021-02-23,4919,10190,278603,134861,2021-02-23,1614034800.0
19653,76,0,2021-02-24,4648,10375,283251,145236,2021-02-24,1614121200.0
19654,76,0,2021-02-25,8320,9803,291571,155039,2021-02-25,1614207600.0
19655,76,0,2021-02-26,9640,8296,301211,163335,2021-02-26,1614294000.0
19656,76,0,2021-02-27,3734,3069,304945,166404,2021-02-27,1614380400.0
19657,76,0,2021-02-28,431,449,305376,166853,2021-02-28,1614466800.0
19658,76,0,2021-03-01,5325,6078,310701,172931,2021-03-01,1614553200.0
19659,76,0,2021-03-02,8217,7478,318918,180409,2021-03-02,1614639600.0
19660,76,0,2021-03-03,9251,7364,328169,187773,2021-03-03,1614726000.0
19661,76,0,2021-03-04,14326,7701,342495,195474,2021-03-04,1614812400.0
19662,76,0,2021-03-05,16874,6905,359369,202379,2021-03-05,1614898800.0
19663,76,0,2021-03-06,15889,2019,375258,204398,2021-03-06,1614985200.0
19664,76,0,2021-03-07,11378,361,386636,204759,2021-03-07,1615071600.0
19665,76,0,2021-03-08,9981,5393,396617,210152,2021-03-08,1615158000.0
19666,76,0,2021-03-09,16235,6256,412852,216408,2021-03-09,1615244400.0
19667,76,0,2021-03-10,16425,6287,429277,222695,2021-03-10,1615330800.0
19668,76,0,2021-03-11,22606,6127,451883,228822,2021-03-11,1615417200.0
19669,76,0,2021-03-12,26450,5006,478333,233828,2021-03-12,1615503600.0
19670,76,0,2021-03-13,14929,2046,493262,235874,2021-03-13,1615590000.0
19671,76,0,2021-03-14,2323,333,495585,236207,2021-03-14,1615676400.0
19672,76,0,2021-03-15,13531,3157,509116,239364,2021-03-15,1615762800.0
19673,76,0,2021-03-16,11763,4353,520879,243717,2021-03-16,1615849200.0
19674,76,0,2021-03-17,12841,3783,533720,247500,2021-03-17,1615935600.0
19675,76,0,2021-03-18,13703,4766,547423,252266,2021-03-18,1616022000.0
19676,76,0,2021-03-19,18655,3674,566078,255940,2021-03-19,1616108400.0
19677,76,0,2021-03-20,10665,1023,576743,256963,2021-03-20,1616194800.0
19678,76,0,2021-03-21,3196,188,579939,257151,2021-03-21,1616281200.0
19679,76,0,2021-03-22,14683,3360,594622,260511,2021-03-22,1616367600.0
19680,76,0,2021-03-23,22252,4017,616874,264528,2021-03-23,1616454000.0
19681,76,0,2021-03-24,23609,3891,640483,268419,2021-03-24,1616540400.0
19682,76,0,2021-03-25,32020,4157,672503,272576,2021-03-25,1616626800.0
19683,76,0,2021-03-26,30860,3684,703363,276260,2021-03-26,1616713200.0
19684,76,0,2021-03-27,16255,1195,719618,277455,2021-03-27,1616799600.0
19685,76,0,2021-03-28,4865,145,724483,277600,2021-03-28,1616886000.0
19686,76,0,2021-03-29,22305,4583,746788,282183,2021-03-29,1616972400.0
19687,76,0,2021-03-30,29720,5255,776508,287438,2021-03-30,1617058800.0
19688,76,0,2021-03-31,26900,5173,803408,292611,2021-03-31,1617145200.0
19689,76,0,2021-04-01,34476,5239,837884,297850,2021-04-01,1617231600.0
19690,76,0,2021-04-02,29350,5244,867234,303094,2021-04-02,1617318000.0
19691,76,0,2021-04-03,12156,2662,879390,305756,2021-04-03,1617404400.0
19692,76,0,2021-04-04,4354,581,883744,306337,2021-04-04,1617490800.0
19693,76,0,2021-04-05,4291,612,888035,306949,2021-04-05,1617577200.0
19694,76,0,2021-04-06,22864,9335,910899,316284,2021-04-06,1617663600.0
19695,76,0,2021-04-07,25284,9315,936183,325599,2021-04-07,1617750000.0
19696,76,0,2021-04-08,33125,9558,969308,335157,2021-04-08,1617836400.0
19697,76,0,2021-04-09,38933,8866,1008241,344023,2021-04-09,1617922800.0
19698,76,0,2021-04-10,22707,4704,1030948,348727,2021-04-10,1618009200.0
19699,76,0,2021-04-11,8861,1255,1039809,349982,2021-04-11,1618095600.0
19700,76,0,2021-04-12,26056,9967,1065865,359949,2021-04-12,1618185600.0
19701,76,0,2021-04-13,35795,12083,1101660,372032,2021-04-13,1618272000.0
19702,76,0,2021-04-14,32895,12399,1134555,384431,2021-04-14,1618358400.0
19703,76,0,2021-04-15,37481,12844,1172036,397275,2021-04-15,1618444800.0
19704,76,0,2021-04-16,34464,12299,1206500,409574,2021-04-16,1618531200.0
19705,76,0,2021-04-17,21400,6202,1227900,415776,2021-04-17,1618617600.0
19706,76,0,2021-04-18,7713,2489,1235613,418265,2021-04-18,1618704000.0
19707,76,0,2021-04-19,22055,12402,1257668,430667,2021-04-19,1618790400.0
19708,76,0,2021-04-20,27983,15942,1285651,446609,2021-04-20,1618876800.0
19709,76,0,2021-04-21,27035,16202,1312686,462811,2021-04-21,1618963200.0
19710,76,0,2021-04-22,30354,17061,1343040,479872,2021-04-22,1619049600.0
19711,76,0,2021-04-23,28709,15453,1371749,495325,2021-04-23,1619136000.0
19712,76,0,2021-04-24,18493,9868,1390242,505193,2021-04-24,1619222400.0
19713,76,0,2021-04-25,6912,4005,1397154,509198,2021-04-25,1619308800.0
19714,76,0,2021-04-26,19948,17573,1417102,526771,2021-04-26,1619395200.0
19715,76,0,2021-04-27,26731,19786,1443833,546557,2021-04-27,1619481600.0
19716,76,0,2021-04-28,25899,19235,1469732,565792,2021-04-28,1619568000.0
19717,76,0,2021-04-29,29737,20658,1499469,586450,2021-04-29,1619654400.0
19718,76,0,2021-04-30,30778,17317,1530247,603767,2021-04-30,1619740800.0
19719,76,0,2021-05-01,17426,6264,1547673,610031,2021-05-01,1619827200.0
19720,76,0,2021-05-02,9492,4384,1557165,614415,2021-05-02,1619913600.0
19721,76,0,2021-05-03,26528,15248,1583693,629663,2021-05-03,1620000000.0
19722,76,0,2021-05-04,30010,23695,1613703,653358,2021-05-04,1620086400.0
19723,76,0,2021-05-05,28210,24661,1641913,678019,2021-05-05,1620172800.0
19724,76,0,2021-05-06,31045,28423,1672958,706442,2021-05-06,1620259200.0
19725,76,0,2021-05-07,31629,27776,1704587,734218,2021-05-07,1620345600.0
19726,76,0,2021-05-08,17360,9708,1721947,743926,2021-05-08,1620432000.0
19727,76,0,2021-05-09,9708,8231,1731655,752157,2021-05-09,1620518400.0
19728,76,0,2021-05-10,24084,26507,1755739,778664,2021-05-10,1620604800.0
19729,76,0,2021-05-11,31656,30049,1787395,808713,2021-05-11,1620691200.0
19730,76,0,2021-05-12,33341,26890,1820736,835603,2021-05-12,1620777600.0
19731,76,0,2021-05-13,25952,8635,1846688,844238,2021-05-13,1620864000.0
19732,76,0,2021-05-14,34538,19219,1881226,863457,2021-05-14,1620950400.0
19733,76,0,2021-05-15,24490,10931,1905716,874388,2021-05-15,1621036800.0
19734,76,0,2021-05-16,15457,3098,1921173,877486,2021-05-16,1621123200.0
19735,76,0,2021-05-17,27838,17329,1949011,894815,2021-05-17,1621206000.0
19736,76,0,2021-05-18,35430,16815,1984441,911630,2021-05-18,1621292400.0
19737,76,0,2021-05-19,36837,14408,2021278,926038,2021-05-19,1621378800.0
19738,76,0,2021-05-20,41003,15651,2062281,941689,2021-05-20,1621465200.0
19739,76,0,2021-05-21,37785,16763,2100066,958452,2021-05-21,1621551600.0
19740,76,0,2021-05-22,26989,7519,2127055,965971,2021-05-22,1621638000.0
19741,76,0,2021-05-23,13314,1103,2140369,967074,2021-05-23,1621724400.0
19742,76,0,2021-05-24,15421,3240,2155790,970314,2021-05-24,1621810800.0
19743,76,0,2021-05-25,31701,18225,2187491,988539,2021-05-25,1621897200.0
19744,76,0,2021-05-26,33685,16686,2221176,1005225,2021-05-26,1621983600.0
19745,76,0,2021-05-27,36412,21158,2257588,1026383,2021-05-27,1622070000.0
19746,76,0,2021-05-28,32494,24260,2290082,1050643,2021-05-28,1622156400.0
19747,76,0,2021-05-29,19827,14964,2309909,1065607,2021-05-29,1622242800.0
19748,76,0,2021-05-30,6350,5874,2316259,1071481,2021-05-30,1622329200.0
19749,76,0,2021-05-31,25733,20139,2341992,1091620,2021-05-31,1622415600.0
19750,76,0,2021-06-01,31179,25814,2373171,1117434,2021-06-01,1622502000.0
19751,76,0,2021-06-02,30811,24241,2403982,1141675,2021-06-02,1622588400.0
19752,76,0,2021-06-03,34194,28782,2438176,1170457,2021-06-03,1622674800.0
19753,76,0,2021-06-04,35103,30021,2473279,1200478,2021-06-04,1622761200.0
19754,76,0,2021-06-05,26021,17607,2499300,1218085,2021-06-05,1622847600.0
19755,76,0,2021-06-06,14100,5518,2513400,1223603,2021-06-06,1622934000.0
19756,76,0,2021-06-07,25745,25088,2539145,1248691,2021-06-07,1623020400.0
19757,76,0,2021-06-08,32423,27947,2571568,1276638,2021-06-08,1623106800.0
19758,76,0,2021-06-09,32289,25744,2603857,1302382,2021-06-09,1623193200.0
19759,76,0,2021-06-10,31974,25516,2635831,1327898,2021-06-10,1623279600.0
19760,76,0,2021-06-11,33543,32012,2669374,1359910,2021-06-11,1623366000.0
19761,76,0,2021-06-12,23191,19819,2692565,1379729,2021-06-12,1623452400.0
19762,76,0,2021-06-13,12037,6277,2704602,1386006,2021-06-13,1623538800.0
19763,76,0,2021-06-14,21559,31302,2726161,1417308,2021-06-14,1623625200.0
19764,76,0,2021-06-15,28734,36433,2754895,1453741,2021-06-15,1623711600.0
19765,76,0,2021-06-16,27005,33401,2781900,1487142,2021-06-16,1623798000.0
19766,76,0,2021-06-17,26781,30841,2808681,1517983,2021-06-17,1623884400.0
19767,76,0,2021-06-18,27398,37600,2836079,1555583,2021-06-18,1623970800.0
19768,76,0,2021-06-19,20796,21348,2856875,1576931,2021-06-19,1624057200.0
19769,76,0,2021-06-20,8911,9617,2865786,1586548,2021-06-20,1624143600.0
19770,76,0,2021-06-21,15031,33337,2880817,1619885,2021-06-21,1624230000.0
19771,76,0,2021-06-22,18229,38070,2899046,1657955,2021-06-22,1624316400.0
19772,76,0,2021-06-23,18950,35333,2917996,1693288,2021-06-23,1624402800.0
19773,76,0,2021-06-24,17444,32520,2935440,1725808,2021-06-24,1624489200.0
19774,76,0,2021-06-25,18316,41808,2953756,1767616,2021-06-25,1624575600.0
19775,76,0,2021-06-26,12243,27278,2965999,1794894,2021-06-26,1624662000.0
19776,76,0,2021-06-27,5712,13988,2971711,1808882,2021-06-27,1624748400.0
19777,76,0,2021-06-28,12562,36282,2984273,1845164,2021-06-28,1624834800.0
19778,76,0,2021-06-29,14835,41415,2999108,1886579,2021-06-29,1624921200.0
19779,76,0,2021-06-30,17029,40780,3016137,1927359,2021-06-30,1625007600.0
19780,76,0,2021-07-01,16378,37446,3032515,1964805,2021-07-01,1625094000.0
19781,76,0,2021-07-02,17767,41151,3050282,2005956,2021-07-02,1625180400.0
19782,76,0,2021-07-03,11891,30885,3062173,2036841,2021-07-03,1625266800.0
19783,76,0,2021-07-04,5507,12157,3067680,2048998,2021-07-04,1625353200.0
19784,76,0,2021-07-05,13713,31887,3081393,2080885,2021-07-05,1625439600.0
19785,76,0,2021-07-06,16862,40807,3098255,2121692,2021-07-06,1625526000.0
19786,76,0,2021-07-07,17190,37959,3115445,2159651,2021-07-07,1625612400.0
19787,76,0,2021-07-08,15961,33994,3131406,2193645,2021-07-08,1625698800.0
19788,84,0,2020-12-27,1,0,1,0,2020-12-27,1609023600.0
19789,84,0,2020-12-28,7,0,8,0,2020-12-28,1609110000.0
19790,84,0,2020-12-29,5,0,13,0,2020-12-29,1609196400.0
19791,84,0,2020-12-30,6,0,19,0,2020-12-30,1609282800.0
19792,84,0,2020-12-31,15,0,34,0,2020-12-31,1609369200.0
19793,84,0,2021-01-01,10,0,44,0,2021-01-01,1609455600.0
19794,84,0,2021-01-02,2,0,46,0,2021-01-02,1609542000.0
19795,84,0,2021-01-03,0,0,46,0,2021-01-03,1609628400.0
19796,84,0,2021-01-04,174,0,220,0,2021-01-04,1609714800.0
19797,84,0,2021-01-05,470,0,690,0,2021-01-05,1609801200.0
19798,84,0,2021-01-06,1136,0,1826,0,2021-01-06,1609887600.0
19799,84,0,2021-01-07,2892,0,4718,0,2021-01-07,1609974000.0
19800,84,0,2021-01-08,3083,0,7801,0,2021-01-08,1610060400.0
19801,84,0,2021-01-09,514,0,8315,0,2021-01-09,1610146800.0
19802,84,0,2021-01-10,161,0,8476,0,2021-01-10,1610233200.0
19803,84,0,2021-01-11,4303,0,12779,0,2021-01-11,1610319600.0
19804,84,0,2021-01-12,6369,0,19148,0,2021-01-12,1610406000.0
19805,84,0,2021-01-13,6855,0,26003,0,2021-01-13,1610492400.0
19806,84,0,2021-01-14,9076,0,35079,0,2021-01-14,1610578800.0
19807,84,0,2021-01-15,7765,0,42844,0,2021-01-15,1610665200.0
19808,84,0,2021-01-16,2948,2,45792,2,2021-01-16,1610751600.0
19809,84,0,2021-01-17,917,2,46709,4,2021-01-17,1610838000.0
19810,84,0,2021-01-18,8970,20,55679,24,2021-01-18,1610924400.0
19811,84,0,2021-01-19,15046,16,70725,40,2021-01-19,1611010800.0
19812,84,0,2021-01-20,15502,16,86227,56,2021-01-20,1611097200.0
19813,84,0,2021-01-21,14606,19,100833,75,2021-01-21,1611183600.0
19814,84,0,2021-01-22,12421,19,113254,94,2021-01-22,1611270000.0
19815,84,0,2021-01-23,4764,1,118018,95,2021-01-23,1611356400.0
19816,84,0,2021-01-24,810,0,118828,95,2021-01-24,1611442800.0
19817,84,0,2021-01-25,8772,136,127600,231,2021-01-25,1611529200.0
19818,84,0,2021-01-26,11905,294,139505,525,2021-01-26,1611615600.0
19819,84,0,2021-01-27,12086,588,151591,1113,2021-01-27,1611702000.0
19820,84,0,2021-01-28,13858,1502,165449,2615,2021-01-28,1611788400.0
19821,84,0,2021-01-29,10806,1286,176255,3901,2021-01-29,1611874800.0
19822,84,0,2021-01-30,4142,142,180397,4043,2021-01-30,1611961200.0
19823,84,0,2021-01-31,499,1,180896,4044,2021-01-31,1612047600.0
19824,84,0,2021-02-01,6555,1861,187451,5905,2021-02-01,1612134000.0
19825,84,0,2021-02-02,10607,3459,198058,9364,2021-02-02,1612220400.0
19826,84,0,2021-02-03,11532,3870,209590,13234,2021-02-03,1612306800.0
19827,84,0,2021-02-04,12573,5447,222163,18681,2021-02-04,1612393200.0
19828,84,0,2021-02-05,8622,4643,230785,23324,2021-02-05,1612479600.0
19829,84,0,2021-02-06,2658,931,233443,24255,2021-02-06,1612566000.0
19830,84,0,2021-02-07,452,435,233895,24690,2021-02-07,1612652400.0
19831,84,0,2021-02-08,6220,4913,240115,29603,2021-02-08,1612738800.0
19832,84,0,2021-02-09,9338,8136,249453,37739,2021-02-09,1612825200.0
19833,84,0,2021-02-10,9686,8472,259139,46211,2021-02-10,1612911600.0
19834,84,0,2021-02-11,10697,9684,269836,55895,2021-02-11,1612998000.0
19835,84,0,2021-02-12,9722,7761,279558,63656,2021-02-12,1613084400.0
19836,84,0,2021-02-13,3497,2288,283055,65944,2021-02-13,1613170800.0
19837,84,0,2021-02-14,623,445,283678,66389,2021-02-14,1613257200.0
19838,84,0,2021-02-15,4884,8224,288562,74613,2021-02-15,1613343600.0
19839,84,0,2021-02-16,6110,10637,294672,85250,2021-02-16,1613430000.0
19840,84,0,2021-02-17,6089,11449,300761,96699,2021-02-17,1613516400.0
19841,84,0,2021-02-18,7113,11582,307874,108281,2021-02-18,1613602800.0
19842,84,0,2021-02-19,6648,9178,314522,117459,2021-02-19,1613689200.0
19843,84,0,2021-02-20,1838,3235,316360,120694,2021-02-20,1613775600.0
19844,84,0,2021-02-21,180,504,316540,121198,2021-02-21,1613862000.0
19845,84,0,2021-02-22,4288,8737,320828,129935,2021-02-22,1613948400.0
19846,84,0,2021-02-23,7288,11232,328116,141167,2021-02-23,1614034800.0
19847,84,0,2021-02-24,7805,11834,335921,153001,2021-02-24,1614121200.0
19848,84,0,2021-02-25,12732,13391,348653,166392,2021-02-25,1614207600.0
19849,84,0,2021-02-26,14878,9984,363531,176376,2021-02-26,1614294000.0
19850,84,0,2021-02-27,5563,2812,369094,179188,2021-02-27,1614380400.0
19851,84,0,2021-02-28,501,498,369595,179686,2021-02-28,1614466800.0
19852,84,0,2021-03-01,9294,6266,378889,185952,2021-03-01,1614553200.0
19853,84,0,2021-03-02,14973,8477,393862,194429,2021-03-02,1614639600.0
19854,84,0,2021-03-03,14804,8319,408666,202748,2021-03-03,1614726000.0
19855,84,0,2021-03-04,21044,7919,429710,210667,2021-03-04,1614812400.0
19856,84,0,2021-03-05,25783,7066,455493,217733,2021-03-05,1614898800.0
19857,84,0,2021-03-06,19502,2080,474995,219813,2021-03-06,1614985200.0
19858,84,0,2021-03-07,8420,330,483415,220143,2021-03-07,1615071600.0
19859,84,0,2021-03-08,12215,6566,495630,226709,2021-03-08,1615158000.0
19860,84,0,2021-03-09,20686,7304,516316,234013,2021-03-09,1615244400.0
19861,84,0,2021-03-10,20247,7134,536563,241147,2021-03-10,1615330800.0
19862,84,0,2021-03-11,29489,7491,566052,248638,2021-03-11,1615417200.0
19863,84,0,2021-03-12,36191,6905,602243,255543,2021-03-12,1615503600.0
19864,84,0,2021-03-13,21435,1520,623678,257063,2021-03-13,1615590000.0
19865,84,0,2021-03-14,4689,392,628367,257455,2021-03-14,1615676400.0
19866,84,0,2021-03-15,18881,4363,647248,261818,2021-03-15,1615762800.0
19867,84,0,2021-03-16,17063,5712,664311,267530,2021-03-16,1615849200.0
19868,84,0,2021-03-17,17585,5996,681896,273526,2021-03-17,1615935600.0
19869,84,0,2021-03-18,21513,6255,703409,279781,2021-03-18,1616022000.0
19870,84,0,2021-03-19,29007,4734,732416,284515,2021-03-19,1616108400.0
19871,84,0,2021-03-20,14537,1047,746953,285562,2021-03-20,1616194800.0
19872,84,0,2021-03-21,3240,171,750193,285733,2021-03-21,1616281200.0
19873,84,0,2021-03-22,19739,4620,769932,290353,2021-03-22,1616367600.0
19874,84,0,2021-03-23,30808,5072,800740,295425,2021-03-23,1616454000.0
19875,84,0,2021-03-24,29980,4962,830720,300387,2021-03-24,1616540400.0
19876,84,0,2021-03-25,41573,5156,872293,305543,2021-03-25,1616626800.0
19877,84,0,2021-03-26,42986,5324,915279,310867,2021-03-26,1616713200.0
19878,84,0,2021-03-27,18220,2328,933499,313195,2021-03-27,1616799600.0
19879,84,0,2021-03-28,6514,375,940013,313570,2021-03-28,1616886000.0
19880,84,0,2021-03-29,22957,7146,962970,320716,2021-03-29,1616972400.0
19881,84,0,2021-03-30,34974,8918,997944,329634,2021-03-30,1617058800.0
19882,84,0,2021-03-31,29592,9772,1027536,339406,2021-03-31,1617145200.0
19883,84,0,2021-04-01,37290,9760,1064826,349166,2021-04-01,1617231600.0
19884,84,0,2021-04-02,34908,9808,1099734,358974,2021-04-02,1617318000.0
19885,84,0,2021-04-03,14801,5625,1114535,364599,2021-04-03,1617404400.0
19886,84,0,2021-04-04,9935,1539,1124470,366138,2021-04-04,1617490800.0
19887,84,0,2021-04-05,13539,1001,1138009,367139,2021-04-05,1617577200.0
19888,84,0,2021-04-06,26312,12043,1164321,379182,2021-04-06,1617663600.0
19889,84,0,2021-04-07,29523,13302,1193844,392484,2021-04-07,1617750000.0
19890,84,0,2021-04-08,39727,13487,1233571,405971,2021-04-08,1617836400.0
19891,84,0,2021-04-09,49510,12894,1283081,418865,2021-04-09,1617922800.0
19892,84,0,2021-04-10,20482,7192,1303563,426057,2021-04-10,1618009200.0
19893,84,0,2021-04-11,7233,2252,1310796,428309,2021-04-11,1618095600.0
19894,84,0,2021-04-12,27326,14246,1338122,442555,2021-04-12,1618185600.0
19895,84,0,2021-04-13,36164,17519,1374286,460074,2021-04-13,1618272000.0
19896,84,0,2021-04-14,34658,16418,1408944,476492,2021-04-14,1618358400.0
19897,84,0,2021-04-15,40151,17474,1449095,493966,2021-04-15,1618444800.0
19898,84,0,2021-04-16,38246,18066,1487341,512032,2021-04-16,1618531200.0
19899,84,0,2021-04-17,20478,7971,1507819,520003,2021-04-17,1618617600.0
19900,84,0,2021-04-18,6839,2376,1514658,522379,2021-04-18,1618704000.0
19901,84,0,2021-04-19,26236,17081,1540894,539460,2021-04-19,1618790400.0
19902,84,0,2021-04-20,31212,20649,1572106,560109,2021-04-20,1618876800.0
19903,84,0,2021-04-21,28057,19751,1600163,579860,2021-04-21,1618963200.0
19904,84,0,2021-04-22,32264,20536,1632427,600396,2021-04-22,1619049600.0
19905,84,0,2021-04-23,32714,20871,1665141,621267,2021-04-23,1619136000.0
19906,84,0,2021-04-24,17868,10735,1683009,632002,2021-04-24,1619222400.0
19907,84,0,2021-04-25,7138,3824,1690147,635826,2021-04-25,1619308800.0
19908,84,0,2021-04-26,23723,18299,1713870,654125,2021-04-26,1619395200.0
19909,84,0,2021-04-27,31770,22265,1745640,676390,2021-04-27,1619481600.0
19910,84,0,2021-04-28,32475,21639,1778115,698029,2021-04-28,1619568000.0
19911,84,0,2021-04-29,39646,22164,1817761,720193,2021-04-29,1619654400.0
19912,84,0,2021-04-30,38131,22555,1855892,742748,2021-04-30,1619740800.0
19913,84,0,2021-05-01,17180,4073,1873072,746821,2021-05-01,1619827200.0
19914,84,0,2021-05-02,7990,7989,1881062,754810,2021-05-02,1619913600.0
19915,84,0,2021-05-03,30382,24712,1911444,779522,2021-05-03,1620000000.0
19916,84,0,2021-05-04,37155,29879,1948599,809401,2021-05-04,1620086400.0
19917,84,0,2021-05-05,40258,26312,1988857,835713,2021-05-05,1620172800.0
19918,84,0,2021-05-06,46647,27560,2035504,863273,2021-05-06,1620259200.0
19919,84,0,2021-05-07,47070,30916,2082574,894189,2021-05-07,1620345600.0
19920,84,0,2021-05-08,22471,5896,2105045,900085,2021-05-08,1620432000.0
19921,84,0,2021-05-09,15926,7620,2120971,907705,2021-05-09,1620518400.0
19922,84,0,2021-05-10,36099,28384,2157070,936089,2021-05-10,1620604800.0
19923,84,0,2021-05-11,52649,30403,2209719,966492,2021-05-11,1620691200.0
19924,84,0,2021-05-12,56964,26549,2266683,993041,2021-05-12,1620777600.0
19925,84,0,2021-05-13,47431,6911,2314114,999952,2021-05-13,1620864000.0
19926,84,0,2021-05-14,57518,19520,2371632,1019472,2021-05-14,1620950400.0
19927,84,0,2021-05-15,44360,10003,2415992,1029475,2021-05-15,1621036800.0
19928,84,0,2021-05-16,30626,2564,2446618,1032039,2021-05-16,1621123200.0
19929,84,0,2021-05-17,48480,20191,2495098,1052230,2021-05-17,1621206000.0
19930,84,0,2021-05-18,59420,21419,2554518,1073649,2021-05-18,1621292400.0
19931,84,0,2021-05-19,58675,17733,2613193,1091382,2021-05-19,1621378800.0
19932,84,0,2021-05-20,62019,20750,2675212,1112132,2021-05-20,1621465200.0
19933,84,0,2021-05-21,61355,22791,2736567,1134923,2021-05-21,1621551600.0
19934,84,0,2021-05-22,40643,9169,2777210,1144092,2021-05-22,1621638000.0
19935,84,0,2021-05-23,21514,2066,2798724,1146158,2021-05-23,1621724400.0
19936,84,0,2021-05-24,40182,4900,2838906,1151058,2021-05-24,1621810800.0
19937,84,0,2021-05-25,50602,26181,2889508,1177239,2021-05-25,1621897200.0
19938,84,0,2021-05-26,50401,23522,2939909,1200761,2021-05-26,1621983600.0
19939,84,0,2021-05-27,55991,25375,2995900,1226136,2021-05-27,1622070000.0
19940,84,0,2021-05-28,55046,32633,3050946,1258769,2021-05-28,1622156400.0
19941,84,0,2021-05-29,37803,18197,3088749,1276966,2021-05-29,1622242800.0
19942,84,0,2021-05-30,16170,5671,3104919,1282637,2021-05-30,1622329200.0
19943,84,0,2021-05-31,44425,23864,3149344,1306501,2021-05-31,1622415600.0
19944,84,0,2021-06-01,48559,29574,3197903,1336075,2021-06-01,1622502000.0
19945,84,0,2021-06-02,47977,24900,3245880,1360975,2021-06-02,1622588400.0
19946,84,0,2021-06-03,56261,28742,3302141,1389717,2021-06-03,1622674800.0
19947,84,0,2021-06-04,54846,34488,3356987,1424205,2021-06-04,1622761200.0
19948,84,0,2021-06-05,38236,17125,3395223,1441330,2021-06-05,1622847600.0
19949,84,0,2021-06-06,15942,4663,3411165,1445993,2021-06-06,1622934000.0
19950,84,0,2021-06-07,41397,29579,3452562,1475572,2021-06-07,1623020400.0
19951,84,0,2021-06-08,45130,31459,3497692,1507031,2021-06-08,1623106800.0
19952,84,0,2021-06-09,40640,28285,3538332,1535316,2021-06-09,1623193200.0
19953,84,0,2021-06-10,41340,27739,3579672,1563055,2021-06-10,1623279600.0
19954,84,0,2021-06-11,43416,39618,3623088,1602673,2021-06-11,1623366000.0
19955,84,0,2021-06-12,28178,19365,3651266,1622038,2021-06-12,1623452400.0
19956,84,0,2021-06-13,8638,6131,3659904,1628169,2021-06-13,1623538800.0
19957,84,0,2021-06-14,25529,40735,3685433,1668904,2021-06-14,1623625200.0
19958,84,0,2021-06-15,31610,44452,3717043,1713356,2021-06-15,1623711600.0
19959,84,0,2021-06-16,33383,40679,3750426,1754035,2021-06-16,1623798000.0
19960,84,0,2021-06-17,30495,42169,3780921,1796204,2021-06-17,1623884400.0
19961,84,0,2021-06-18,34873,54311,3815794,1850515,2021-06-18,1623970800.0
19962,84,0,2021-06-19,22757,32555,3838551,1883070,2021-06-19,1624057200.0
19963,84,0,2021-06-20,8675,13076,3847226,1896146,2021-06-20,1624143600.0
19964,84,0,2021-06-21,19936,52838,3867162,1948984,2021-06-21,1624230000.0
19965,84,0,2021-06-22,20992,58951,3888154,2007935,2021-06-22,1624316400.0
19966,84,0,2021-06-23,22261,53449,3910415,2061384,2021-06-23,1624402800.0
19967,84,0,2021-06-24,23134,50853,3933549,2112237,2021-06-24,1624489200.0
19968,84,0,2021-06-25,23529,65265,3957078,2177502,2021-06-25,1624575600.0
19969,84,0,2021-06-26,14043,43727,3971121,2221229,2021-06-26,1624662000.0
19970,84,0,2021-06-27,6844,22275,3977965,2243504,2021-06-27,1624748400.0
19971,84,0,2021-06-28,15642,61610,3993607,2305114,2021-06-28,1624834800.0
19972,84,0,2021-06-29,18789,63294,4012396,2368408,2021-06-29,1624921200.0
19973,84,0,2021-06-30,21500,58413,4033896,2426821,2021-06-30,1625007600.0
19974,84,0,2021-07-01,22526,53493,4056422,2480314,2021-07-01,1625094000.0
19975,84,0,2021-07-02,22472,63760,4078894,2544074,2021-07-02,1625180400.0
19976,84,0,2021-07-03,15524,41822,4094418,2585896,2021-07-03,1625266800.0
19977,84,0,2021-07-04,7701,15801,4102119,2601697,2021-07-04,1625353200.0
19978,84,0,2021-07-05,18557,58113,4120676,2659810,2021-07-05,1625439600.0
19979,84,0,2021-07-06,20727,57342,4141403,2717152,2021-07-06,1625526000.0
19980,84,0,2021-07-07,23997,49748,4165400,2766900,2021-07-07,1625612400.0
19981,84,0,2021-07-08,26905,46167,4192305,2813067,2021-07-08,1625698800.0
19982,93,0,2020-12-27,1,0,1,0,2020-12-27,1609023600.0
19983,93,0,2020-12-28,2,0,3,0,2020-12-28,1609110000.0
19984,93,0,2020-12-29,1,0,4,0,2020-12-29,1609196400.0
19985,93,0,2020-12-30,3,0,7,0,2020-12-30,1609282800.0
19986,93,0,2020-12-31,19,0,26,0,2020-12-31,1609369200.0
19987,93,0,2021-01-01,13,0,39,0,2021-01-01,1609455600.0
19988,93,0,2021-01-02,5,0,44,0,2021-01-02,1609542000.0
19989,93,0,2021-01-03,3,0,47,0,2021-01-03,1609628400.0
19990,93,0,2021-01-04,133,0,180,0,2021-01-04,1609714800.0
19991,93,0,2021-01-05,252,0,432,0,2021-01-05,1609801200.0
19992,93,0,2021-01-06,412,0,844,0,2021-01-06,1609887600.0
19993,93,0,2021-01-07,1245,0,2089,0,2021-01-07,1609974000.0
19994,93,0,2021-01-08,1566,0,3655,0,2021-01-08,1610060400.0
19995,93,0,2021-01-09,543,0,4198,0,2021-01-09,1610146800.0
19996,93,0,2021-01-10,74,0,4272,0,2021-01-10,1610233200.0
19997,93,0,2021-01-11,2414,0,6686,0,2021-01-11,1610319600.0
19998,93,0,2021-01-12,5097,0,11783,0,2021-01-12,1610406000.0
19999,93,0,2021-01-13,4476,0,16259,0,2021-01-13,1610492400.0
20000,93,0,2021-01-14,5583,0,21842,0,2021-01-14,1610578800.0
20001,93,0,2021-01-15,4942,0,26784,0,2021-01-15,1610665200.0
20002,93,0,2021-01-16,1682,2,28466,2,2021-01-16,1610751600.0
20003,93,0,2021-01-17,303,1,28769,3,2021-01-17,1610838000.0
20004,93,0,2021-01-18,7165,22,35934,25,2021-01-18,1610924400.0
20005,93,0,2021-01-19,13542,14,49476,39,2021-01-19,1611010800.0
20006,93,0,2021-01-20,12287,13,61763,52,2021-01-20,1611097200.0
20007,93,0,2021-01-21,12322,19,74085,71,2021-01-21,1611183600.0
20008,93,0,2021-01-22,10239,8,84324,79,2021-01-22,1611270000.0
20009,93,0,2021-01-23,3330,1,87654,80,2021-01-23,1611356400.0
20010,93,0,2021-01-24,537,0,88191,80,2021-01-24,1611442800.0
20011,93,0,2021-01-25,7263,17,95454,97,2021-01-25,1611529200.0
20012,93,0,2021-01-26,10080,114,105534,211,2021-01-26,1611615600.0
20013,93,0,2021-01-27,9696,267,115230,478,2021-01-27,1611702000.0
20014,93,0,2021-01-28,13683,776,128913,1254,2021-01-28,1611788400.0
20015,93,0,2021-01-29,9850,942,138763,2196,2021-01-29,1611874800.0
20016,93,0,2021-01-30,2240,151,141003,2347,2021-01-30,1611961200.0
20017,93,0,2021-01-31,304,5,141307,2352,2021-01-31,1612047600.0
20018,93,0,2021-02-01,5173,1505,146480,3857,2021-02-01,1612134000.0
20019,93,0,2021-02-02,6650,2356,153130,6213,2021-02-02,1612220400.0
20020,93,0,2021-02-03,5027,1803,158157,8016,2021-02-03,1612306800.0
20021,93,0,2021-02-04,5535,3150,163692,11166,2021-02-04,1612393200.0
20022,93,0,2021-02-05,6116,4107,169808,15273,2021-02-05,1612479600.0
20023,93,0,2021-02-06,1249,969,171057,16242,2021-02-06,1612566000.0
20024,93,0,2021-02-07,280,81,171337,16323,2021-02-07,1612652400.0
20025,93,0,2021-02-08,4310,3727,175647,20050,2021-02-08,1612738800.0
20026,93,0,2021-02-09,5888,7079,181535,27129,2021-02-09,1612825200.0
20027,93,0,2021-02-10,5958,5858,187493,32987,2021-02-10,1612911600.0
20028,93,0,2021-02-11,6604,6674,194097,39661,2021-02-11,1612998000.0
20029,93,0,2021-02-12,5731,6448,199828,46109,2021-02-12,1613084400.0
20030,93,0,2021-02-13,1129,1444,200957,47553,2021-02-13,1613170800.0
20031,93,0,2021-02-14,73,384,201030,47937,2021-02-14,1613257200.0
20032,93,0,2021-02-15,2417,5622,203447,53559,2021-02-15,1613343600.0
20033,93,0,2021-02-16,3195,7665,206642,61224,2021-02-16,1613430000.0
20034,93,0,2021-02-17,3605,8475,210247,69699,2021-02-17,1613516400.0
20035,93,0,2021-02-18,6008,11347,216255,81046,2021-02-18,1613602800.0
20036,93,0,2021-02-19,5652,8605,221907,89651,2021-02-19,1613689200.0
20037,93,0,2021-02-20,882,1790,222789,91441,2021-02-20,1613775600.0
20038,93,0,2021-02-21,70,416,222859,91857,2021-02-21,1613862000.0
20039,93,0,2021-02-22,3030,6967,225889,98824,2021-02-22,1613948400.0
20040,93,0,2021-02-23,3969,7204,229858,106028,2021-02-23,1614034800.0
20041,93,0,2021-02-24,4751,6764,234609,112792,2021-02-24,1614121200.0
20042,93,0,2021-02-25,8259,6542,242868,119334,2021-02-25,1614207600.0
20043,93,0,2021-02-26,8284,6084,251152,125418,2021-02-26,1614294000.0
20044,93,0,2021-02-27,3296,1453,254448,126871,2021-02-27,1614380400.0
20045,93,0,2021-02-28,306,236,254754,127107,2021-02-28,1614466800.0
20046,93,0,2021-03-01,5661,4426,260415,131533,2021-03-01,1614553200.0
20047,93,0,2021-03-02,7241,5833,267656,137366,2021-03-02,1614639600.0
20048,93,0,2021-03-03,8994,6409,276650,143775,2021-03-03,1614726000.0
20049,93,0,2021-03-04,12108,6281,288758,150056,2021-03-04,1614812400.0
20050,93,0,2021-03-05,12216,5964,300974,156020,2021-03-05,1614898800.0
20051,93,0,2021-03-06,22976,1099,323950,157119,2021-03-06,1614985200.0
20052,93,0,2021-03-07,18041,434,341991,157553,2021-03-07,1615071600.0
20053,93,0,2021-03-08,10255,5125,352246,162678,2021-03-08,1615158000.0
20054,93,0,2021-03-09,13976,5374,366222,168052,2021-03-09,1615244400.0
20055,93,0,2021-03-10,14501,5116,380723,173168,2021-03-10,1615330800.0
20056,93,0,2021-03-11,20438,5845,401161,179013,2021-03-11,1615417200.0
20057,93,0,2021-03-12,21941,4970,423102,183983,2021-03-12,1615503600.0
20058,93,0,2021-03-13,24646,1010,447748,184993,2021-03-13,1615590000.0
20059,93,0,2021-03-14,6477,204,454225,185197,2021-03-14,1615676400.0
20060,93,0,2021-03-15,15958,2892,470183,188089,2021-03-15,1615762800.0
20061,93,0,2021-03-16,12727,3481,482910,191570,2021-03-16,1615849200.0
20062,93,0,2021-03-17,16002,4446,498912,196016,2021-03-17,1615935600.0
20063,93,0,2021-03-18,17050,4573,515962,200589,2021-03-18,1616022000.0
20064,93,0,2021-03-19,21036,4325,536998,204914,2021-03-19,1616108400.0
20065,93,0,2021-03-20,10993,1149,547991,206063,2021-03-20,1616194800.0
20066,93,0,2021-03-21,3258,81,551249,206144,2021-03-21,1616281200.0
20067,93,0,2021-03-22,17116,3244,568365,209388,2021-03-22,1616367600.0
20068,93,0,2021-03-23,22682,3480,591047,212868,2021-03-23,1616454000.0
20069,93,0,2021-03-24,21993,6190,613040,219058,2021-03-24,1616540400.0
20070,93,0,2021-03-25,29054,5964,642094,225022,2021-03-25,1616626800.0
20071,93,0,2021-03-26,29934,4479,672028,229501,2021-03-26,1616713200.0
20072,93,0,2021-03-27,12462,1384,684490,230885,2021-03-27,1616799600.0
20073,93,0,2021-03-28,3578,49,688068,230934,2021-03-28,1616886000.0
20074,93,0,2021-03-29,18544,4930,706612,235864,2021-03-29,1616972400.0
20075,93,0,2021-03-30,28537,5985,735149,241849,2021-03-30,1617058800.0
20076,93,0,2021-03-31,28816,5980,763965,247829,2021-03-31,1617145200.0
20077,93,0,2021-04-01,30785,6641,794750,254470,2021-04-01,1617231600.0
20078,93,0,2021-04-02,26957,7738,821707,262208,2021-04-02,1617318000.0
20079,93,0,2021-04-03,9780,4746,831487,266954,2021-04-03,1617404400.0
20080,93,0,2021-04-04,2126,1206,833613,268160,2021-04-04,1617490800.0
20081,93,0,2021-04-05,6068,1331,839681,269491,2021-04-05,1617577200.0
20082,93,0,2021-04-06,23460,9352,863141,278843,2021-04-06,1617663600.0
20083,93,0,2021-04-07,26100,10953,889241,289796,2021-04-07,1617750000.0
20084,93,0,2021-04-08,28888,13933,918129,303729,2021-04-08,1617836400.0
20085,93,0,2021-04-09,33685,13500,951814,317229,2021-04-09,1617922800.0
20086,93,0,2021-04-10,14841,7674,966655,324903,2021-04-10,1618009200.0
20087,93,0,2021-04-11,3637,2864,970292,327767,2021-04-11,1618095600.0
20088,93,0,2021-04-12,20630,11525,990922,339292,2021-04-12,1618185600.0
20089,93,0,2021-04-13,25666,14346,1016588,353638,2021-04-13,1618272000.0
20090,93,0,2021-04-14,25236,14339,1041824,367977,2021-04-14,1618358400.0
20091,93,0,2021-04-15,27038,14625,1068862,382602,2021-04-15,1618444800.0
20092,93,0,2021-04-16,27951,15449,1096813,398051,2021-04-16,1618531200.0
20093,93,0,2021-04-17,12853,7279,1109666,405330,2021-04-17,1618617600.0
20094,93,0,2021-04-18,5264,2737,1114930,408067,2021-04-18,1618704000.0
20095,93,0,2021-04-19,19123,15176,1134053,423243,2021-04-19,1618790400.0
20096,93,0,2021-04-20,21378,17717,1155431,440960,2021-04-20,1618876800.0
20097,93,0,2021-04-21,23986,17350,1179417,458310,2021-04-21,1618963200.0
20098,93,0,2021-04-22,25925,18160,1205342,476470,2021-04-22,1619049600.0
20099,93,0,2021-04-23,25515,17049,1230857,493519,2021-04-23,1619136000.0
20100,93,0,2021-04-24,11559,8134,1242416,501653,2021-04-24,1619222400.0
20101,93,0,2021-04-25,3212,2032,1245628,503685,2021-04-25,1619308800.0
20102,93,0,2021-04-26,16484,15013,1262112,518698,2021-04-26,1619395200.0
20103,93,0,2021-04-27,19476,18636,1281588,537334,2021-04-27,1619481600.0
20104,93,0,2021-04-28,21527,18404,1303115,555738,2021-04-28,1619568000.0
20105,93,0,2021-04-29,27935,19257,1331050,574995,2021-04-29,1619654400.0
20106,93,0,2021-04-30,27364,17918,1358414,592913,2021-04-30,1619740800.0
20107,93,0,2021-05-01,11788,4618,1370202,597531,2021-05-01,1619827200.0
20108,93,0,2021-05-02,4076,1647,1374278,599178,2021-05-02,1619913600.0
20109,93,0,2021-05-03,20557,16667,1394835,615845,2021-05-03,1620000000.0
20110,93,0,2021-05-04,20840,21090,1415675,636935,2021-05-04,1620086400.0
20111,93,0,2021-05-05,19582,19990,1435257,656925,2021-05-05,1620172800.0
20112,93,0,2021-05-06,24879,19444,1460136,676369,2021-05-06,1620259200.0
20113,93,0,2021-05-07,22474,22441,1482610,698810,2021-05-07,1620345600.0
20114,93,0,2021-05-08,13715,6053,1496325,704863,2021-05-08,1620432000.0
20115,93,0,2021-05-09,3473,2127,1499798,706990,2021-05-09,1620518400.0
20116,93,0,2021-05-10,18718,20863,1518516,727853,2021-05-10,1620604800.0
20117,93,0,2021-05-11,25455,22969,1543971,750822,2021-05-11,1620691200.0
20118,93,0,2021-05-12,32704,19941,1576675,770763,2021-05-12,1620777600.0
20119,93,0,2021-05-13,28420,6336,1605095,777099,2021-05-13,1620864000.0
20120,93,0,2021-05-14,35564,13539,1640659,790638,2021-05-14,1620950400.0
20121,93,0,2021-05-15,29967,8084,1670626,798722,2021-05-15,1621036800.0
20122,93,0,2021-05-16,12794,1729,1683420,800451,2021-05-16,1621123200.0
20123,93,0,2021-05-17,25906,15130,1709326,815581,2021-05-17,1621206000.0
20124,93,0,2021-05-18,30636,13853,1739962,829434,2021-05-18,1621292400.0
20125,93,0,2021-05-19,30493,12453,1770455,841887,2021-05-19,1621378800.0
20126,93,0,2021-05-20,33173,13587,1803628,855474,2021-05-20,1621465200.0
20127,93,0,2021-05-21,34309,14489,1837937,869963,2021-05-21,1621551600.0
20128,93,0,2021-05-22,18869,5986,1856806,875949,2021-05-22,1621638000.0
20129,93,0,2021-05-23,5933,1593,1862739,877542,2021-05-23,1621724400.0
20130,93,0,2021-05-24,17936,3501,1880675,881043,2021-05-24,1621810800.0
20131,93,0,2021-05-25,23818,17841,1904493,898884,2021-05-25,1621897200.0
20132,93,0,2021-05-26,25065,19154,1929558,918038,2021-05-26,1621983600.0
20133,93,0,2021-05-27,26739,19965,1956297,938003,2021-05-27,1622070000.0
20134,93,0,2021-05-28,23093,23144,1979390,961147,2021-05-28,1622156400.0
20135,93,0,2021-05-29,13194,12637,1992584,973784,2021-05-29,1622242800.0
20136,93,0,2021-05-30,2605,2931,1995189,976715,2021-05-30,1622329200.0
20137,93,0,2021-05-31,21003,18726,2016192,995441,2021-05-31,1622415600.0
20138,93,0,2021-06-01,24645,22399,2040837,1017840,2021-06-01,1622502000.0
20139,93,0,2021-06-02,22401,22827,2063238,1040667,2021-06-02,1622588400.0
20140,93,0,2021-06-03,27805,23123,2091043,1063790,2021-06-03,1622674800.0
20141,93,0,2021-06-04,28087,23998,2119130,1087788,2021-06-04,1622761200.0
20142,93,0,2021-06-05,16400,12241,2135530,1100029,2021-06-05,1622847600.0
20143,93,0,2021-06-06,4904,2344,2140434,1102373,2021-06-06,1622934000.0
20144,93,0,2021-06-07,17826,21741,2158260,1124114,2021-06-07,1623020400.0
20145,93,0,2021-06-08,21151,20977,2179411,1145091,2021-06-08,1623106800.0
20146,93,0,2021-06-09,20762,22522,2200173,1167613,2021-06-09,1623193200.0
20147,93,0,2021-06-10,21781,21287,2221954,1188900,2021-06-10,1623279600.0
20148,93,0,2021-06-11,19808,27308,2241762,1216208,2021-06-11,1623366000.0
20149,93,0,2021-06-12,12991,13426,2254753,1229634,2021-06-12,1623452400.0
20150,93,0,2021-06-13,2558,3003,2257311,1232637,2021-06-13,1623538800.0
20151,93,0,2021-06-14,13884,27230,2271195,1259867,2021-06-14,1623625200.0
20152,93,0,2021-06-15,16604,28095,2287799,1287962,2021-06-15,1623711600.0
20153,93,0,2021-06-16,17124,23015,2304923,1310977,2021-06-16,1623798000.0
20154,93,0,2021-06-17,17186,25252,2322109,1336229,2021-06-17,1623884400.0
20155,93,0,2021-06-18,16251,24910,2338360,1361139,2021-06-18,1623970800.0
20156,93,0,2021-06-19,9694,13979,2348054,1375118,2021-06-19,1624057200.0
20157,93,0,2021-06-20,2391,3387,2350445,1378505,2021-06-20,1624143600.0
20158,93,0,2021-06-21,9957,28683,2360402,1407188,2021-06-21,1624230000.0
20159,93,0,2021-06-22,11572,32128,2371974,1439316,2021-06-22,1624316400.0
20160,93,0,2021-06-23,11482,30033,2383456,1469349,2021-06-23,1624402800.0
20161,93,0,2021-06-24,12235,31504,2395691,1500853,2021-06-24,1624489200.0
20162,93,0,2021-06-25,11536,35229,2407227,1536082,2021-06-25,1624575600.0
20163,93,0,2021-06-26,6697,20404,2413924,1556486,2021-06-26,1624662000.0
20164,93,0,2021-06-27,1993,5474,2415917,1561960,2021-06-27,1624748400.0
20165,93,0,2021-06-28,8241,30900,2424158,1592860,2021-06-28,1624834800.0
20166,93,0,2021-06-29,9934,31646,2434092,1624506,2021-06-29,1624921200.0
20167,93,0,2021-06-30,10656,30931,2444748,1655437,2021-06-30,1625007600.0
20168,93,0,2021-07-01,12492,28267,2457240,1683704,2021-07-01,1625094000.0
20169,93,0,2021-07-02,12605,30827,2469845,1714531,2021-07-02,1625180400.0
20170,93,0,2021-07-03,7428,20480,2477273,1735011,2021-07-03,1625266800.0
20171,93,0,2021-07-04,1845,4220,2479118,1739231,2021-07-04,1625353200.0
20172,93,0,2021-07-05,9381,26392,2488499,1765623,2021-07-05,1625439600.0
20173,93,0,2021-07-06,12053,26921,2500552,1792544,2021-07-06,1625526000.0
20174,93,0,2021-07-07,12795,23514,2513347,1816058,2021-07-07,1625612400.0
20175,93,0,2021-07-08,14888,23368,2528235,1839426,2021-07-08,1625698800.0
20176,94,0,2020-12-27,0,0,0,0,2020-12-27,1609023600.0
20177,94,0,2020-12-28,0,0,0,0,2020-12-28,1609110000.0
20178,94,0,2020-12-29,0,0,0,0,2020-12-29,1609196400.0
20179,94,0,2020-12-30,0,0,0,0,2020-12-30,1609282800.0
20180,94,0,2020-12-31,0,0,0,0,2020-12-31,1609369200.0
20181,94,0,2021-01-01,0,0,0,0,2021-01-01,1609455600.0
20182,94,0,2021-01-02,0,0,0,0,2021-01-02,1609542000.0
20183,94,0,2021-01-03,0,0,0,0,2021-01-03,1609628400.0
20184,94,0,2021-01-04,2,0,2,0,2021-01-04,1609714800.0
20185,94,0,2021-01-05,0,0,2,0,2021-01-05,1609801200.0
20186,94,0,2021-01-06,53,0,55,0,2021-01-06,1609887600.0
20187,94,0,2021-01-07,333,0,388,0,2021-01-07,1609974000.0
20188,94,0,2021-01-08,310,0,698,0,2021-01-08,1610060400.0
20189,94,0,2021-01-09,78,0,776,0,2021-01-09,1610146800.0
20190,94,0,2021-01-10,34,0,810,0,2021-01-10,1610233200.0
20191,94,0,2021-01-11,151,0,961,0,2021-01-11,1610319600.0
20192,94,0,2021-01-12,211,0,1172,0,2021-01-12,1610406000.0
20193,94,0,2021-01-13,203,0,1375,0,2021-01-13,1610492400.0
20194,94,0,2021-01-14,264,0,1639,0,2021-01-14,1610578800.0
20195,94,0,2021-01-15,406,0,2045,0,2021-01-15,1610665200.0
20196,94,0,2021-01-16,200,1,2245,1,2021-01-16,1610751600.0
20197,94,0,2021-01-17,91,1,2336,2,2021-01-17,1610838000.0
20198,94,0,2021-01-18,471,2,2807,4,2021-01-18,1610924400.0
20199,94,0,2021-01-19,982,0,3789,4,2021-01-19,1611010800.0
20200,94,0,2021-01-20,812,0,4601,4,2021-01-20,1611097200.0
20201,94,0,2021-01-21,808,1,5409,5,2021-01-21,1611183600.0
20202,94,0,2021-01-22,728,0,6137,5,2021-01-22,1611270000.0
20203,94,0,2021-01-23,243,0,6380,5,2021-01-23,1611356400.0
20204,94,0,2021-01-24,147,0,6527,5,2021-01-24,1611442800.0
20205,94,0,2021-01-25,422,2,6949,7,2021-01-25,1611529200.0
20206,94,0,2021-01-26,790,7,7739,14,2021-01-26,1611615600.0
20207,94,0,2021-01-27,663,55,8402,69,2021-01-27,1611702000.0
20208,94,0,2021-01-28,699,230,9101,299,2021-01-28,1611788400.0
20209,94,0,2021-01-29,627,229,9728,528,2021-01-29,1611874800.0
20210,94,0,2021-01-30,204,74,9932,602,2021-01-30,1611961200.0
20211,94,0,2021-01-31,150,11,10082,613,2021-01-31,1612047600.0
20212,94,0,2021-02-01,458,147,10540,760,2021-02-01,1612134000.0
20213,94,0,2021-02-02,643,195,11183,955,2021-02-02,1612220400.0
20214,94,0,2021-02-03,783,166,11966,1121,2021-02-03,1612306800.0
20215,94,0,2021-02-04,714,298,12680,1419,2021-02-04,1612393200.0
20216,94,0,2021-02-05,659,201,13339,1620,2021-02-05,1612479600.0
20217,94,0,2021-02-06,207,75,13546,1695,2021-02-06,1612566000.0
20218,94,0,2021-02-07,126,58,13672,1753,2021-02-07,1612652400.0
20219,94,0,2021-02-08,322,366,13994,2119,2021-02-08,1612738800.0
20220,94,0,2021-02-09,712,612,14706,2731,2021-02-09,1612825200.0
20221,94,0,2021-02-10,643,429,15349,3160,2021-02-10,1612911600.0
20222,94,0,2021-02-11,678,496,16027,3656,2021-02-11,1612998000.0
20223,94,0,2021-02-12,641,428,16668,4084,2021-02-12,1613084400.0
20224,94,0,2021-02-13,301,72,16969,4156,2021-02-13,1613170800.0
20225,94,0,2021-02-14,195,78,17164,4234,2021-02-14,1613257200.0
20226,94,0,2021-02-15,380,308,17544,4542,2021-02-15,1613343600.0
20227,94,0,2021-02-16,634,602,18178,5144,2021-02-16,1613430000.0
20228,94,0,2021-02-17,592,482,18770,5626,2021-02-17,1613516400.0
20229,94,0,2021-02-18,550,544,19320,6170,2021-02-18,1613602800.0
20230,94,0,2021-02-19,309,609,19629,6779,2021-02-19,1613689200.0
20231,94,0,2021-02-20,275,199,19904,6978,2021-02-20,1613775600.0
20232,94,0,2021-02-21,84,84,19988,7062,2021-02-21,1613862000.0
20233,94,0,2021-02-22,211,404,20199,7466,2021-02-22,1613948400.0
20234,94,0,2021-02-23,352,646,20551,8112,2021-02-23,1614034800.0
20235,94,0,2021-02-24,299,608,20850,8720,2021-02-24,1614121200.0
20236,94,0,2021-02-25,348,605,21198,9325,2021-02-25,1614207600.0
20237,94,0,2021-02-26,420,554,21618,9879,2021-02-26,1614294000.0
20238,94,0,2021-02-27,368,151,21986,10030,2021-02-27,1614380400.0
20239,94,0,2021-02-28,70,123,22056,10153,2021-02-28,1614466800.0
20240,94,0,2021-03-01,361,410,22417,10563,2021-03-01,1614553200.0
20241,94,0,2021-03-02,549,651,22966,11214,2021-03-02,1614639600.0
20242,94,0,2021-03-03,532,687,23498,11901,2021-03-03,1614726000.0
20243,94,0,2021-03-04,952,626,24450,12527,2021-03-04,1614812400.0
20244,94,0,2021-03-05,1584,663,26034,13190,2021-03-05,1614898800.0
20245,94,0,2021-03-06,1844,159,27878,13349,2021-03-06,1614985200.0
20246,94,0,2021-03-07,1381,97,29259,13446,2021-03-07,1615071600.0
20247,94,0,2021-03-08,1228,318,30487,13764,2021-03-08,1615158000.0
20248,94,0,2021-03-09,1313,649,31800,14413,2021-03-09,1615244400.0
20249,94,0,2021-03-10,1259,566,33059,14979,2021-03-10,1615330800.0
20250,94,0,2021-03-11,1307,623,34366,15602,2021-03-11,1615417200.0
20251,94,0,2021-03-12,1518,529,35884,16131,2021-03-12,1615503600.0
20252,94,0,2021-03-13,1118,296,37002,16427,2021-03-13,1615590000.0
20253,94,0,2021-03-14,537,183,37539,16610,2021-03-14,1615676400.0
20254,94,0,2021-03-15,886,392,38425,17002,2021-03-15,1615762800.0
20255,94,0,2021-03-16,1065,629,39490,17631,2021-03-16,1615849200.0
20256,94,0,2021-03-17,1225,516,40715,18147,2021-03-17,1615935600.0
20257,94,0,2021-03-18,995,522,41710,18669,2021-03-18,1616022000.0
20258,94,0,2021-03-19,1286,326,42996,18995,2021-03-19,1616108400.0
20259,94,0,2021-03-20,1732,283,44728,19278,2021-03-20,1616194800.0
20260,94,0,2021-03-21,1126,74,45854,19352,2021-03-21,1616281200.0
20261,94,0,2021-03-22,889,181,46743,19533,2021-03-22,1616367600.0
20262,94,0,2021-03-23,1302,310,48045,19843,2021-03-23,1616454000.0
20263,94,0,2021-03-24,1688,292,49733,20135,2021-03-24,1616540400.0
20264,94,0,2021-03-25,1753,263,51486,20398,2021-03-25,1616626800.0
20265,94,0,2021-03-26,2031,321,53517,20719,2021-03-26,1616713200.0
20266,94,0,2021-03-27,2273,206,55790,20925,2021-03-27,1616799600.0
20267,94,0,2021-03-28,1070,208,56860,21133,2021-03-28,1616886000.0
20268,94,0,2021-03-29,1025,295,57885,21428,2021-03-29,1616972400.0
20269,94,0,2021-03-30,1352,543,59237,21971,2021-03-30,1617058800.0
20270,94,0,2021-03-31,1427,465,60664,22436,2021-03-31,1617145200.0
20271,94,0,2021-04-01,1638,661,62302,23097,2021-04-01,1617231600.0
20272,94,0,2021-04-02,1865,1172,64167,24269,2021-04-02,1617318000.0
20273,94,0,2021-04-03,1890,1109,66057,25378,2021-04-03,1617404400.0
20274,94,0,2021-04-04,771,833,66828,26211,2021-04-04,1617490800.0
20275,94,0,2021-04-05,629,797,67457,27008,2021-04-05,1617577200.0
20276,94,0,2021-04-06,1579,876,69036,27884,2021-04-06,1617663600.0
20277,94,0,2021-04-07,2010,827,71046,28711,2021-04-07,1617750000.0
20278,94,0,2021-04-08,2174,723,73220,29434,2021-04-08,1617836400.0
20279,94,0,2021-04-09,2102,900,75322,30334,2021-04-09,1617922800.0
20280,94,0,2021-04-10,2402,580,77724,30914,2021-04-10,1618009200.0
20281,94,0,2021-04-11,1173,297,78897,31211,2021-04-11,1618095600.0
20282,94,0,2021-04-12,1517,871,80414,32082,2021-04-12,1618185600.0
20283,94,0,2021-04-13,1384,985,81798,33067,2021-04-13,1618272000.0
20284,94,0,2021-04-14,2088,1045,83886,34112,2021-04-14,1618358400.0
20285,94,0,2021-04-15,1922,990,85808,35102,2021-04-15,1618444800.0
20286,94,0,2021-04-16,1777,992,87585,36094,2021-04-16,1618531200.0
20287,94,0,2021-04-17,1750,1344,89335,37438,2021-04-17,1618617600.0
20288,94,0,2021-04-18,1234,1268,90569,38706,2021-04-18,1618704000.0
20289,94,0,2021-04-19,1091,744,91660,39450,2021-04-19,1618790400.0
20290,94,0,2021-04-20,1250,1150,92910,40600,2021-04-20,1618876800.0
20291,94,0,2021-04-21,1781,1293,94691,41893,2021-04-21,1618963200.0
20292,94,0,2021-04-22,1832,1339,96523,43232,2021-04-22,1619049600.0
20293,94,0,2021-04-23,1647,1361,98170,44593,2021-04-23,1619136000.0
20294,94,0,2021-04-24,2030,1709,100200,46302,2021-04-24,1619222400.0
20295,94,0,2021-04-25,1261,759,101461,47061,2021-04-25,1619308800.0
20296,94,0,2021-04-26,1015,1120,102476,48181,2021-04-26,1619395200.0
20297,94,0,2021-04-27,1308,1186,103784,49367,2021-04-27,1619481600.0
20298,94,0,2021-04-28,2588,1199,106372,50566,2021-04-28,1619568000.0
20299,94,0,2021-04-29,1969,1142,108341,51708,2021-04-29,1619654400.0
20300,94,0,2021-04-30,2262,1776,110603,53484,2021-04-30,1619740800.0
20301,94,0,2021-05-01,1423,1658,112026,55142,2021-05-01,1619827200.0
20302,94,0,2021-05-02,1009,923,113035,56065,2021-05-02,1619913600.0
20303,94,0,2021-05-03,1600,1017,114635,57082,2021-05-03,1620000000.0
20304,94,0,2021-05-04,1557,1622,116192,58704,2021-05-04,1620086400.0
20305,94,0,2021-05-05,1810,2275,118002,60979,2021-05-05,1620172800.0
20306,94,0,2021-05-06,2187,1741,120189,62720,2021-05-06,1620259200.0
20307,94,0,2021-05-07,2214,1728,122403,64448,2021-05-07,1620345600.0
20308,94,0,2021-05-08,876,1331,123279,65779,2021-05-08,1620432000.0
20309,94,0,2021-05-09,1175,1289,124454,67068,2021-05-09,1620518400.0
20310,94,0,2021-05-10,1373,1479,125827,68547,2021-05-10,1620604800.0
20311,94,0,2021-05-11,1581,1482,127408,70029,2021-05-11,1620691200.0
20312,94,0,2021-05-12,1770,1298,129178,71327,2021-05-12,1620777600.0
20313,94,0,2021-05-13,1940,436,131118,71763,2021-05-13,1620864000.0
20314,94,0,2021-05-14,1513,1172,132631,72935,2021-05-14,1620950400.0
20315,94,0,2021-05-15,1479,945,134110,73880,2021-05-15,1621036800.0
20316,94,0,2021-05-16,1032,624,135142,74504,2021-05-16,1621123200.0
20317,94,0,2021-05-17,1582,912,136724,75416,2021-05-17,1621206000.0
20318,94,0,2021-05-18,1602,784,138326,76200,2021-05-18,1621292400.0
20319,94,0,2021-05-19,1551,835,139877,77035,2021-05-19,1621378800.0
20320,94,0,2021-05-20,1355,829,141232,77864,2021-05-20,1621465200.0
20321,94,0,2021-05-21,1236,902,142468,78766,2021-05-21,1621551600.0
20322,94,0,2021-05-22,1015,637,143483,79403,2021-05-22,1621638000.0
20323,94,0,2021-05-23,698,306,144181,79709,2021-05-23,1621724400.0
20324,94,0,2021-05-24,165,127,144346,79836,2021-05-24,1621810800.0
20325,94,0,2021-05-25,961,777,145307,80613,2021-05-25,1621897200.0
20326,94,0,2021-05-26,968,1890,146275,82503,2021-05-26,1621983600.0
20327,94,0,2021-05-27,841,2186,147116,84689,2021-05-27,1622070000.0
20328,94,0,2021-05-28,844,1745,147960,86434,2021-05-28,1622156400.0
20329,94,0,2021-05-29,648,1213,148608,87647,2021-05-29,1622242800.0
20330,94,0,2021-05-30,228,540,148836,88187,2021-05-30,1622329200.0
20331,94,0,2021-05-31,560,1202,149396,89389,2021-05-31,1622415600.0
20332,94,0,2021-06-01,745,1692,150141,91081,2021-06-01,1622502000.0
20333,94,0,2021-06-02,639,1866,150780,92947,2021-06-02,1622588400.0
20334,94,0,2021-06-03,791,1595,151571,94542,2021-06-03,1622674800.0
20335,94,0,2021-06-04,611,2290,152182,96832,2021-06-04,1622761200.0
20336,94,0,2021-06-05,566,1865,152748,98697,2021-06-05,1622847600.0
20337,94,0,2021-06-06,221,1025,152969,99722,2021-06-06,1622934000.0
20338,94,0,2021-06-07,438,1556,153407,101278,2021-06-07,1623020400.0
20339,94,0,2021-06-08,704,1804,154111,103082,2021-06-08,1623106800.0
20340,94,0,2021-06-09,801,2410,154912,105492,2021-06-09,1623193200.0
20341,94,0,2021-06-10,676,1705,155588,107197,2021-06-10,1623279600.0
20342,94,0,2021-06-11,694,2213,156282,109410,2021-06-11,1623366000.0
20343,94,0,2021-06-12,355,1150,156637,110560,2021-06-12,1623452400.0
20344,94,0,2021-06-13,204,838,156841,111398,2021-06-13,1623538800.0
20345,94,0,2021-06-14,421,1986,157262,113384,2021-06-14,1623625200.0
20346,94,0,2021-06-15,549,1641,157811,115025,2021-06-15,1623711600.0
20347,94,0,2021-06-16,577,1628,158388,116653,2021-06-16,1623798000.0
20348,94,0,2021-06-17,616,1557,159004,118210,2021-06-17,1623884400.0
20349,94,0,2021-06-18,575,1814,159579,120024,2021-06-18,1623970800.0
20350,94,0,2021-06-19,341,976,159920,121000,2021-06-19,1624057200.0
20351,94,0,2021-06-20,188,870,160108,121870,2021-06-20,1624143600.0
20352,94,0,2021-06-21,435,1715,160543,123585,2021-06-21,1624230000.0
20353,94,0,2021-06-22,542,1897,161085,125482,2021-06-22,1624316400.0
20354,94,0,2021-06-23,402,1395,161487,126877,2021-06-23,1624402800.0
20355,94,0,2021-06-24,463,1077,161950,127954,2021-06-24,1624489200.0
20356,94,0,2021-06-25,368,1486,162318,129440,2021-06-25,1624575600.0
20357,94,0,2021-06-26,300,1381,162618,130821,2021-06-26,1624662000.0
20358,94,0,2021-06-27,202,984,162820,131805,2021-06-27,1624748400.0
20359,94,0,2021-06-28,511,1588,163331,133393,2021-06-28,1624834800.0
20360,94,0,2021-06-29,471,1617,163802,135010,2021-06-29,1624921200.0
20361,94,0,2021-06-30,604,1358,164406,136368,2021-06-30,1625007600.0
20362,94,0,2021-07-01,410,916,164816,137284,2021-07-01,1625094000.0
20363,94,0,2021-07-02,359,847,165175,138131,2021-07-02,1625180400.0
20364,94,0,2021-07-03,292,965,165467,139096,2021-07-03,1625266800.0
20365,94,0,2021-07-04,168,656,165635,139752,2021-07-04,1625353200.0
20366,94,0,2021-07-05,422,845,166057,140597,2021-07-05,1625439600.0
20367,94,0,2021-07-06,689,987,166746,141584,2021-07-06,1625526000.0
20368,94,0,2021-07-07,790,1414,167536,142998,2021-07-07,1625612400.0
20369,94,0,2021-07-08,733,951,168269,143949,2021-07-08,1625698800.0
